label,isCode,wordsLen,ZeroLen,OneLen,WordsWithSameSizeLen,TotalWordsSize,TotalDiffRatio,TotalDistancedeLevenshtein,TotalSimilarityendstart
"['01', '011110', '110', '1001111', '101111']",1,5,7,17,2,24,5.881196581196582,33,28
"['10001', '010', '011']",1,3,6,5,2,11,1.6666666666666665,7,5
"['11001', '1']",1,2,2,4,0,6,0.3333333333333333,4,4
"['1001101', '0000010', '1111']",1,3,9,9,2,18,1.2987012987012987,13,4
['111'],1,1,0,3,0,3,0,0,0
"['1100011', '101011', '001110', '1']",1,4,8,12,2,20,2.8727106227106227,25,15
"['01', '1']",1,2,1,2,0,3,0.6666666666666666,1,2
['011'],1,1,1,2,0,3,0,0,0
"['001', '0101101', '1010', '001110', '100111', '0101']",1,6,14,16,4,30,9.470712620712622,41,39
"['010', '001', '0101110', '01010']",1,4,10,8,2,18,3.75,16,29
"['101', '0110', '000']",1,3,6,4,2,10,1.476190476190476,7,4
"['01', '01010']",1,2,4,3,0,7,0.5714285714285714,3,3
['1001'],1,1,2,2,0,4,0,0,0
['1'],1,1,0,1,0,1,0,0,0
"['010', '10']",1,2,3,2,0,5,0.8,1,3
"['101011', '110']",1,2,3,6,0,9,0.4444444444444444,3,3
"['0', '11']",1,2,1,2,0,3,0.0,2,0
['1100101'],1,1,3,4,0,7,0,0,0
['11'],1,1,0,2,0,2,0,0,0
"['010100', '01101', '0011', '0001', '0110', '0100']",1,6,16,11,4,27,9.743939393939394,31,54
"['100', '000101', '10', '0111', '01001']",1,5,11,9,0,20,5.678860028860028,27,24
"['1000100', '01', '01101', '0011', '10001', '1100']",1,6,15,12,4,27,8.578210678210677,44,43
"['100', '00101']",1,2,5,3,0,8,0.5,3,3
"['11110', '00101']",1,2,4,6,2,10,0.4,4,2
"['001111', '11', '00111', '1100001', '10110']",1,5,10,15,2,25,5.603385503385503,34,36
"['0100001', '1110101', '10']",1,3,8,8,2,16,1.4603174603174602,13,7
['01'],1,1,1,1,0,2,0,0,0
"['0011101', '1', '001010', '000', '1000011', '0101']",1,6,16,12,2,28,7.652580752580753,54,34
['110'],1,1,1,2,0,3,0,0,0
"['0011', '110', '111011']",1,3,4,9,0,13,1.838095238095238,9,12
"['11', '00', '100000', '0111', '0100']",1,5,11,7,4,18,4.05,31,26
['0'],1,1,1,0,0,1,0,0,0
"['1011', '000100', '1', '1010101']",1,4,9,9,0,18,2.6783716283716283,24,14
['00101'],1,1,3,2,0,5,0,0,0
['10'],1,1,1,1,0,2,0,0,0
['0111011'],1,1,2,5,0,7,0,0,0
"['101', '0010', '1000', '1']",1,4,7,5,2,12,3.192857142857143,14,12
"['0', '01001', '00010']",1,3,8,3,2,11,1.2666666666666666,10,8
"['11110', '000001']",1,2,6,5,0,11,0.18181818181818182,5,2
['0110100'],1,1,4,3,0,7,0,0,0
"['100', '11100', '00001']",1,3,8,5,2,13,1.65,9,10
"['001111', '001011', '1']",1,3,5,8,2,13,1.4047619047619047,11,9
"['0110101', '01', '1110', '1100111']",1,4,7,13,2,20,2.8845598845598843,23,17
['00'],1,1,2,0,0,2,0,0,0
"['0100000', '1000101', '011', '0011', '1101100', '100010', '000001', '000000', '11111']",1,9,31,20,6,51,19.047263847263846,121,114
"['000110', '0010', '010101', '00']",1,4,12,6,2,18,3.7333333333333334,17,24
['111011'],1,1,1,5,0,6,0,0,0
"['0', '0100000', '101010', '0110', '1111010', '0110110']",1,6,17,15,3,32,7.368181818181818,57,57
"['1011', '1', '101101']",1,3,3,8,0,11,1.4857142857142858,10,15
['000010'],1,1,5,1,0,6,0,0,0
"['011', '00011']",1,2,4,4,0,8,0.75,2,4
"['011001', '000', '11']",1,3,6,5,0,11,0.9444444444444444,10,4
['0110000'],1,1,5,2,0,7,0,0,0
"['0111010', '1111011', '11']",1,3,4,12,2,16,1.6031746031746033,12,8
"['11', '101', '0001', '101000', '1010101', '1011101', '0001000']",1,7,19,17,3,36,11.648074148074148,71,81
['01111'],1,1,1,4,0,5,0,0,0
"['010', '1100', '1']",1,3,4,4,0,8,1.4714285714285715,7,4
"['0000111', '100000', '11']",1,3,9,6,0,15,1.3098290598290598,14,11
"['11000', '100', '100010', '1101100', '0000', '0111101']",1,6,18,14,2,32,8.57047952047952,48,46
"['1000', '110', '1']",1,3,4,4,0,8,1.4714285714285715,7,6
"['1111100', '111011']",1,2,3,10,0,13,0.6153846153846154,3,5
"['1011', '1010', '1100', '011']",1,4,6,9,3,15,4.0,12,18
"['01101', '11110', '1001', '1011000']",1,4,9,12,2,21,3.3676767676767674,18,14
['1101'],1,1,1,3,0,4,0,0,0
"['1010', '1']",1,2,2,3,0,5,0.4,3,2
"['100101', '010111', '1000001']",1,3,10,9,2,19,1.7435897435897436,9,11
"['10111', '00000']",1,2,6,4,2,10,0.2,4,0
['1111011'],1,1,1,6,0,7,0,0,0
"['11', '10100', '010111', '0101100', '110']",1,5,10,13,0,23,6.008336108336108,30,29
"['1110111', '0101111', '11', '101010', '1111000', '110101']",1,6,11,24,5,35,8.86996336996337,54,61
"['0001', '001', '1100', '01011']",1,4,9,7,2,16,3.317460317460317,14,18
"['1110011', '01110']",1,2,4,8,0,12,0.6666666666666666,4,0
"['0011', '01', '1']",1,3,3,4,0,7,1.7333333333333334,6,6
"['0', '111']",1,2,1,3,0,4,0.0,3,0
"['1010001', '010', '010101', '10011']",1,4,11,10,0,21,3.7480186480186477,18,14
"['1', '000']",1,2,3,1,0,4,0.0,3,0
"['00', '011']",1,2,3,2,0,5,0.4,2,2
"['010100', '0', '1011001', '10011', '01011']",1,5,12,12,2,24,5.377672327672328,36,22
"['101010', '00', '100000', '1']",1,4,10,5,2,15,2.238095238095238,22,13
"['0011', '0001', '100001', '001000']",1,4,14,6,4,20,4.016666666666667,15,20
"['0011001', '011']",1,2,5,5,0,10,0.6,4,2
"['1000011', '01000', '0111100']",1,3,11,8,2,19,1.7619047619047619,13,6
"['0111111', '001', '010111', '11']",1,4,5,13,0,18,2.804273504273504,21,19
"['0111010', '1', '0000100', '110100', '01010']",1,5,15,11,2,26,5.302364302364302,38,28
"['110', '1001111', '11']",1,3,3,9,0,12,1.6444444444444444,11,13
"['0101', '110011', '00', '10', '0111101']",1,5,9,12,2,21,5.6648795648795645,33,21
"['0001', '0101110', '1']",1,3,6,6,0,12,1.0136363636363637,13,4
"['01', '011100']",1,2,4,4,0,8,0.5,4,3
"['11001', '110001']",1,2,5,6,0,11,0.9090909090909091,1,9
"['0001111', '011010', '011', '0000']",1,4,11,9,0,20,3.313220113220113,21,21
"['1001', '1', '110111']",1,3,3,8,0,11,1.2857142857142856,11,12
['0110'],1,1,2,2,0,4,0,0,0
"['11001', '01', '1', '0100010', '0000']",1,5,12,7,0,19,4.437590187590187,35,18
"['0001011', '00', '0101110']",1,3,9,7,2,16,1.6031746031746033,13,10
"['0110000', '11000', '1', '0100']",1,4,11,6,0,17,3.2106060606060605,20,15
"['0101110', '0101', '0100111']",1,3,8,10,2,18,2.311688311688312,8,13
"['0', '1111111']",1,2,1,7,0,8,0.0,7,0
"['11001', '010011', '001']",1,3,7,7,0,14,2.143939393939394,7,9
"['00100', '11010', '0011111', '11']",1,4,8,11,2,19,2.9015873015873015,23,18
"['1000000', '111000', '01100', '1110']",1,4,13,9,0,22,3.672960372960373,18,19
"['01', '0111001', '1100111', '011010', '11100']",1,5,11,16,2,27,6.000777000777001,37,26
"['0', '11011']",1,2,2,4,0,6,0.3333333333333333,4,0
"['101', '1110011', '10011']",1,3,5,10,0,15,2.1833333333333336,8,18
['001000'],1,1,5,1,0,6,0,0,0
"['0', '01', '1111']",1,3,2,5,0,7,1.0,8,4
"['010100', '0110111', '011', '11101', '001010']",1,5,12,15,2,27,6.255011655011655,30,27
['0010'],1,1,3,1,0,4,0,0,0
"['011101', '0010', '1001010', '0']",1,4,10,8,0,18,2.8783716283716285,24,16
"['011', '101010', '1001100', '100010', '1000', '11101', '0100001', '0000111']",1,8,25,20,5,45,17.165512265512266,90,78
"['01101', '1000101', '1101110', '10100', '11111', '001001']",1,6,15,20,5,35,8.720379620379621,47,40
"['1', '1011111']",1,2,1,7,0,8,0.25,6,4
"['1010000', '010000', '110']",1,3,11,5,0,16,1.7675213675213675,9,11
['0101001'],1,1,4,3,0,7,0,0,0
"['00111', '101']",1,2,3,5,0,8,0.5,3,2
"['1010110', '10010']",1,2,6,6,0,12,0.6666666666666666,2,4
"['111', '110100']",1,2,3,6,0,9,0.6666666666666666,3,4
['0100100'],1,1,5,2,0,7,0,0,0
"['110110', '10', '0100']",1,3,6,6,0,12,1.7666666666666666,9,7
"['11110', '010', '101101', '11000', '10000', '10']",1,6,13,13,3,26,8.7991341991342,40,37
"['00', '001110', '11']",1,3,5,5,2,10,1.0,10,6
"['010', '100', '001']",1,3,6,3,3,9,2.0,6,7
"['0', '101', '11']",1,3,2,4,0,6,1.3,5,4
"['0110001', '0111']",1,2,5,6,0,11,0.7272727272727273,3,4
"['001', '00001']",1,2,6,2,0,8,0.75,2,5
['1100001'],1,1,4,3,0,7,0,0,0
"['0000', '00100', '1111110', '0100']",1,4,12,8,2,20,3.1565656565656566,19,28
"['0111010', '1110000', '101', '0011', '00']",1,5,12,11,2,23,5.1503607503607505,37,24
"['0010', '110', '11']",1,3,4,5,0,9,1.7047619047619047,6,7
"['01', '100000', '01100']",1,3,9,4,0,13,1.3668831168831168,11,8
"['110011', '00100', '1100011']",1,3,9,9,0,18,1.9685314685314685,10,12
"['0010', '0011101', '00', '0101', '0110110']",1,5,13,11,4,24,6.413780663780663,31,36
"['00', '11100', '11']",1,3,4,5,2,9,1.1428571428571428,8,8
"['0001', '0010']",1,2,6,2,2,8,0.75,2,3
"['1111100', '11110']",1,2,3,9,0,12,0.8333333333333334,2,5
"['001100', '100', '0001110']",1,3,10,6,0,16,1.835897435897436,10,14
"['00100', '0101']",1,2,6,3,0,9,0.6666666666666666,2,2
['0111100'],1,1,3,4,0,7,0,0,0
"['110110', '001000', '100', '10', '10011', '1011', '111000', '101111']",1,8,17,21,4,38,16.97164502164502,84,89
"['101010', '110001']",1,2,6,6,2,12,0.6666666666666666,3,2
"['101100', '11110', '1110000', '0011000', '1010101', '001110', '10011', '1100']",1,8,23,24,7,47,18.066233766233765,81,85
['11101'],1,1,1,4,0,5,0,0,0
"['0', '11110', '000011']",1,3,6,6,0,12,0.9826839826839826,14,7
"['1000', '0110001']",1,2,7,4,0,11,0.7272727272727273,3,2
"['110111', '1000', '011', '10']",1,4,6,9,0,15,2.919047619047619,18,15
"['11110', '00101', '0111']",1,3,5,9,2,14,1.7333333333333334,8,8
"['101010', '110']",1,2,4,5,0,9,0.4444444444444444,3,3
"['110000', '111111', '1011000', '0']",1,4,9,11,2,20,1.945970695970696,27,14
"['110', '0001000', '11']",1,3,7,5,0,12,1.4222222222222223,12,6
"['01', '00', '0110']",1,3,5,3,2,8,1.8333333333333333,5,9
"['01', '111', '100', '110100', '000', '00010']",1,6,13,9,3,22,7.094660894660895,40,42
"['01', '00', '100']",1,3,5,2,2,7,1.7000000000000002,4,8
"['00', '11101', '0100111', '11']",1,4,6,10,2,16,2.246031746031746,23,16
['000000'],1,1,6,0,0,6,0,0,0
"['000110', '11010', '001', '101010', '11000', '111001']",1,6,16,15,5,31,9.411111111111111,42,43
"['011', '1100010', '01000', '111111', '00', '101111']",1,6,12,17,2,29,6.478848928848929,57,42
['1101010'],1,1,3,4,0,7,0,0,0
"['0', '011', '011101', '111110', '0111']",1,5,6,14,2,20,5.506349206349206,31,31
"['0010110', '1', '01111', '001010', '0000', '1011011']",1,6,15,15,2,30,7.363714063714064,54,36
"['0110100', '00000', '101011', '0001', '100', '101110']",1,6,18,13,2,31,7.9469530469530465,48,44
"['101', '001', '110']",1,3,4,5,3,9,1.6666666666666665,6,7
"['0110111', '001000', '101', '1110100', '110', '0111110']",1,6,14,19,5,33,8.208302808302808,54,38
"['11000', '10001', '10']",1,3,7,5,2,12,1.9428571428571428,8,7
['0000011'],1,1,5,2,0,7,0,0,0
"['01100', '101', '00', '1110']",1,4,7,7,0,14,3.0428571428571427,15,12
"['1000111', '1', '0001000']",1,3,9,6,2,15,1.0714285714285714,16,4
"['00', '110', '10', '0010000']",1,4,10,4,2,14,2.988888888888889,19,19
"['01101', '001', '00', '10', '1110']",1,5,8,8,2,16,5.295238095238095,22,24
"['100110', '00101']",1,2,6,5,0,11,0.7272727272727273,3,2
"['011', '00000', '1111', '10100', '11101', '11100']",1,6,12,15,4,27,7.521428571428571,39,49
"['11011', '1111101', '011', '0100110', '00111', '1000', '10010', '01000']",1,8,19,22,6,41,16.348051948051946,86,76
"['00110', '111101']",1,2,4,7,0,11,0.5454545454545454,3,0
"['00100', '1', '0000']",1,3,8,2,0,10,1.222222222222222,9,8
"['00101', '1101100']",1,2,6,6,0,12,0.5,4,3
"['0101110', '011101', '1010', '00', '011001']",1,5,12,13,2,25,6.074514374514375,33,28
['10111'],1,1,1,4,0,5,0,0,0
['00110'],1,1,3,2,0,5,0,0,0
"['101', '1100', '10']",1,3,4,5,0,9,2.038095238095238,5,7
"['110010', '11', '00111', '00001', '00110', '10011', '000']",1,7,17,14,4,31,12.23030303030303,57,61
"['01111', '0010010', '0110']",1,3,8,8,0,16,1.893939393939394,9,11
"['0110', '1000', '000', '0100011', '110', '1001011']",1,6,16,12,6,28,8.95021645021645,44,41
"['001101', '101101', '10111', '1001', '011110']",1,5,10,17,3,27,6.996969696969697,24,31
"['01', '0010', '1010', '10010', '000111']",1,5,12,9,2,21,6.477994227994228,24,29
"['110101', '0101000', '001', '1111']",1,4,9,11,0,20,2.909179709179709,20,14
"['1', '101111']",1,2,1,6,0,7,0.2857142857142857,5,4
['11111'],1,1,0,5,0,5,0,0,0
"['011', '00100', '00110', '0000011', '11111', '0101', '01110']",1,7,17,17,4,34,12.347041847041847,59,60
"['011111', '000111', '0100']",1,3,7,9,2,16,1.4666666666666668,10,10
['11110'],1,1,1,4,0,5,0,0,0
"['010001', '1']",1,2,4,3,0,7,0.2857142857142857,5,2
"['00110', '11111', '110001', '1101110']",1,4,8,15,2,23,3.272960372960373,18,18
"['0010', '0101111', '0001110', '10', '101110']",1,5,12,14,2,26,6.181030081030081,32,33
"['11011', '010', '1001', '1111011']",1,4,6,13,0,19,3.516883116883117,19,19
"['01', '10011']",1,2,3,4,0,7,0.5714285714285714,3,2
"['001', '0011101', '0100111', '01111', '000', '0101', '1110']",1,7,15,18,6,33,12.105844155844157,60,62
"['1', '0100']",1,2,3,2,0,5,0.4,3,0
"['0110', '0100110']",1,2,6,5,0,11,0.7272727272727273,3,8
['11010'],1,1,2,3,0,5,0,0,0
['0000001'],1,1,6,1,0,7,0,0,0
"['00100', '111111', '1100']",1,3,6,9,0,15,1.2484848484848485,11,9
"['1011010', '0010', '001101', '0011', '0001101', '1010', '1110110']",1,7,19,20,6,39,14.325874125874126,58,70
"['110', '1000101', '000000', '11']",1,4,11,7,0,18,2.482051282051282,24,12
"['0010', '0101111', '001111', '010001', '0111011', '011011', '01010', '000', '1100', '01100']",1,10,26,27,9,53,28.23046398046398,124,160
['00100'],1,1,4,1,0,5,0,0,0
['100'],1,1,2,1,0,3,0,0,0
"['1', '10']",1,2,1,2,0,3,0.6666666666666666,1,2
"['01', '11011', '00', '0000110', '001011']",1,5,12,10,2,22,5.0886890886890885,34,27
"['011', '100101', '10', '110', '1110']",1,5,7,11,2,18,5.973015873015873,23,28
['10101'],1,1,2,3,0,5,0,0,0
"['101100', '100', '1']",1,3,5,5,0,10,1.4523809523809523,10,9
"['1011', '100']",1,2,3,4,0,7,0.5714285714285714,2,3
"['1001', '000010']",1,2,7,3,0,10,0.6,3,0
"['1001110', '11001', '101000', '100', '1011100']",1,5,14,14,2,28,6.919030969030969,30,32
"['0111001', '0101000', '00101', '1', '1000010', '111101']",1,6,17,16,3,33,7.297286047286047,58,34
['10100'],1,1,3,2,0,5,0,0,0
"['1000011', '110', '0111', '0101001']",1,4,10,11,2,21,3.2155844155844155,21,16
"['011', '00011', '100', '111111', '0111110']",1,5,8,16,2,24,4.8828671328671325,36,27
['0001100'],1,1,5,2,0,7,0,0,0
"['0', '1011110', '01010', '11']",1,4,6,9,0,15,2.265873015873016,23,11
"['101100', '11', '100', '1101', '0101']",1,5,8,11,2,19,5.992857142857143,24,29
['1000'],1,1,3,1,0,4,0,0,0
"['10100', '0111111', '1001']",1,3,6,10,0,16,1.3636363636363635,12,7
"['1110000', '11100', '010110', '1111']",1,4,9,13,0,22,3.7881118881118883,18,23
"['0010', '100']",1,2,5,2,0,7,0.5714285714285714,2,3
"['01', '110001', '0011010', '0000000', '10', '1110']",1,6,17,11,4,28,6.808957708957709,60,35
"['0', '1001111', '11001']",1,3,5,8,0,13,1.25,14,5
"['110000', '11110', '00101', '101', '10001', '101011', '1000110', '1101110', '0001010']",1,9,25,26,8,51,22.22902652902653,109,107
"['01', '0011110', '11101']",1,3,5,9,0,14,1.6825396825396823,12,5
['0110001'],1,1,4,3,0,7,0,0,0
"['1111100', '1011001', '111', '000010', '0101']",1,5,12,15,2,27,5.14010434010434,38,24
"['10000', '10110', '011']",1,3,7,6,2,13,1.6,8,7
['101'],1,1,1,2,0,3,0,0,0
"['1', '1110000', '0001', '1101101', '0011010', '10011']",1,6,15,16,3,31,7.295021645021645,60,38
"['0001', '001', '11']",1,3,5,4,0,9,1.5904761904761904,6,9
"['0011', '010', '0000110', '0000']",1,4,13,5,2,18,3.6974025974025975,16,28
"['01', '110010', '010', '0010000', '1111', '10011']",1,6,14,13,0,27,7.77050727050727,49,34
"['0011', '1100001', '0101', '11']",1,4,8,9,2,17,3.6186868686868685,19,20
['0100111'],1,1,3,4,0,7,0,0,0
"['0100110', '011', '1111']",1,3,5,9,0,14,1.535064935064935,10,7
"['100100', '1100', '0110', '11']",1,4,8,8,2,16,3.583333333333333,15,14
"['10100', '000', '01100']",1,3,9,4,2,13,1.8,6,14
"['1101001', '111111', '0111', '0100']",1,4,7,14,2,21,3.188111888111888,20,18
"['0010', '0010111', '100', '0001100', '001110']",1,5,16,11,2,27,6.38030858030858,30,46
"['011111', '010101', '1001']",1,3,6,10,2,16,1.4666666666666668,8,8
"['000100', '100', '010110']",1,3,10,5,2,15,2.0,8,11
"['0001', '0111010', '1100', '011']",1,4,9,9,2,18,3.3337662337662337,19,16
['001001'],1,1,4,2,0,6,0,0,0
['010101'],1,1,3,3,0,6,0,0,0
"['001001', '1']",1,2,4,3,0,7,0.2857142857142857,5,2
"['0', '001001', '101110']",1,3,7,6,2,13,1.0714285714285714,14,6
"['11', '0011', '0110', '1010111', '11101']",1,5,7,15,2,22,5.983044733044733,29,30
"['0010010', '1', '10']",1,3,6,4,0,10,1.3611111111111112,12,5
"['01', '1', '000']",1,3,4,2,0,6,1.0666666666666667,6,4
"['0010001', '01', '1000110', '100111', '1101010']",1,5,15,14,3,29,5.5476190476190474,39,25
"['010100', '011', '100010', '00', '00010', '110', '111001']",1,7,18,13,5,31,11.482539682539683,63,57
"['000110', '11011', '101', '10']",1,4,7,9,0,16,3.6113275613275615,17,12
"['1000001', '01', '1']",1,3,6,4,0,10,1.3611111111111112,12,9
"['01', '00', '1111101', '1101']",1,4,5,10,2,15,2.893939393939394,20,16
"['0100111', '10111', '0011110', '100', '10000', '0111']",1,6,14,17,4,31,8.715656565656566,48,45
['1101000'],1,1,4,3,0,7,0,0,0
"['0', '01']",1,2,2,1,0,3,0.6666666666666666,1,2
"['101100', '01', '001', '1110']",1,4,7,8,0,15,3.1634920634920634,17,14
"['0101010', '000000', '111001']",1,3,12,7,2,19,1.2564102564102564,11,4
['0001'],1,1,3,1,0,4,0,0,0
"['10101', '0100']",1,2,5,4,0,9,0.6666666666666666,2,0
"['1001101', '00', '011001', '0111101', '1100']",1,5,12,14,2,26,6.0453657453657454,34,27
"['001', '1', '10101', '100000', '0111']",1,5,10,9,0,19,4.447041847041847,32,25
['101110'],1,1,2,4,0,6,0,0,0
"['011', '011101', '100110', '00', '011111', '010011', '111000']",1,7,15,20,5,35,11.927777777777777,69,62
"['111010', '0111']",1,2,3,7,0,10,0.6,3,4
"['1110111', '01', '1000111', '1000000', '000', '0011011', '1100']",1,7,19,18,4,37,10.327849927849927,83,66
"['101100', '111', '00001', '00110', '10100', '10', '01100']",1,7,17,14,4,31,11.403535353535354,58,60
"['011100', '11', '101011', '10101', '01000']",1,5,11,13,4,24,5.684415584415584,31,24
"['1', '01011', '1110']",1,3,3,7,0,10,1.1777777777777778,10,7
['10000'],1,1,4,1,0,5,0,0,0
"['0', '0100011', '01110', '00011']",1,4,10,8,2,18,2.85,23,19
"['110000', '00101', '111', '10000', '010010', '0000011', '110111']",1,7,21,17,5,38,11.634226884226884,68,69
"['110011', '1011', '11001', '0']",1,4,6,10,0,16,3.394805194805195,17,21
"['0111111', '010', '1']",1,3,3,8,0,11,1.15,13,5
"['1011010', '01', '0101010', '11']",1,4,8,10,4,18,2.992063492063492,23,14
"['1011', '1', '01100']",1,3,4,6,0,10,1.4,10,4
['010'],1,1,2,1,0,3,0,0,0
"['0010', '01101', '100001', '1000', '1011', '000100']",1,6,18,11,5,29,8.903535353535354,40,38
"['11', '1101', '01110', '0000']",1,4,7,8,2,15,2.599206349206349,18,10
"['01', '111', '100100', '0010011', '1000010']",1,5,14,11,2,25,5.143223443223444,37,25
"['11000', '0100000', '101', '10']",1,4,11,6,0,17,3.3825396825396825,20,13
"['00111', '1100001', '0101100']",1,3,10,9,2,19,1.7380952380952381,11,6
"['001101', '01000']",1,2,7,4,0,11,0.5454545454545454,3,3
"['1011', '01001', '0111']",1,3,5,8,2,13,2.083333333333333,6,8
"['00110', '1', '0010100']",1,3,8,5,0,13,1.4166666666666667,12,7
"['1011011', '01110']",1,2,4,8,0,12,0.6666666666666666,3,0
"['0001011', '0111110']",1,2,6,8,2,14,0.42857142857142855,4,2
"['111011', '100', '000', '0111100']",1,4,9,10,2,19,2.948717948717949,22,16
"['0101101', '010100', '11']",1,3,7,8,0,15,1.7136752136752138,11,7
"['1', '0001110', '101011', '01010', '0110011']",1,5,12,14,2,26,4.970862470862471,40,20
"['11001', '010', '100001', '01111', '00', '10011', '011110', '0001011', '000111', '101001']",1,10,25,26,7,51,26.777289377289378,139,121
"['00101', '10011']",1,2,5,5,2,10,0.8,2,2
"['00', '0110', '11010']",1,3,6,5,0,11,1.9047619047619047,7,9
"['00011', '1000111', '000', '01001', '01000']",1,5,16,9,3,25,6.966666666666667,26,32
"['00010', '00', '1111']",1,3,6,5,0,11,0.7936507936507936,11,6
"['101010', '0011']",1,2,5,5,0,10,0.6,3,2
"['001', '11', '101010', '11000', '1000']",1,5,11,9,0,20,5.736796536796537,25,28
['100110'],1,1,3,3,0,6,0,0,0
"['11001', '11', '1010100', '0111111', '010110', '000', '000001', '01100', '0111100']",1,9,24,24,7,48,18.50104895104895,125,108
"['1000001', '1101110', '1010111', '1010', '1011100', '0111110']",1,6,16,23,5,39,9.233766233766234,50,44
"['0', '11010', '100']",1,3,5,4,0,9,1.5833333333333333,8,6
['1111'],1,1,0,4,0,4,0,0,0
"['110', '10']",1,2,2,3,0,5,0.8,1,3
"['01', '00110', '01110', '110011']",1,4,8,10,2,18,3.7155844155844155,18,13
"['001', '010101', '1', '0111100']",1,4,8,9,0,17,2.4955433455433456,24,13
"['0110101', '011001', '111', '0']",1,4,7,10,0,17,2.7254578754578755,22,14
"['10100', '00110', '0011111']",1,3,8,9,2,17,1.4,10,11
"['10', '11']",1,2,1,3,2,4,0.5,1,2
['010001'],1,1,4,2,0,6,0,0,0
"['0', '10', '00011']",1,3,5,3,0,8,1.2857142857142856,9,6
['11100'],1,1,2,3,0,5,0,0,0
"['110100', '10', '000', '0111', '110', '01100']",1,6,12,11,2,23,8.1502886002886,38,45
"['0', '101000', '01011', '11']",1,4,7,7,0,14,2.2359307359307357,21,12
"['101', '10']",1,2,2,3,0,5,0.8,1,3
['01101'],1,1,2,3,0,5,0,0,0
"['110110', '11110', '101']",1,3,4,10,0,14,1.712121212121212,7,9
"['01', '0001', '01010']",1,3,7,4,0,11,1.6825396825396823,7,8
['0111'],1,1,1,3,0,4,0,0,0
['1001101'],1,1,3,4,0,7,0,0,0
"['1110101', '10001', '0010010', '0']",1,4,11,9,2,20,2.738095238095238,26,9
"['1', '0011110', '100100', '0110', '1110100']",1,5,12,13,2,25,4.814485514485515,40,25
"['00011', '100', '110', '0100']",1,4,9,6,2,15,3.5396825396825395,14,17
"['100', '010', '11100', '111001']",1,4,8,9,2,17,3.936868686868687,15,16
"['001', '11111']",1,2,2,6,0,8,0.25,4,2
"['01', '11010', '1100110']",1,3,6,8,0,14,1.8492063492063493,10,9
"['101', '00', '1']",1,3,3,3,0,6,0.9,6,4
"['01', '001', '1', '0001', '0000']",1,5,10,4,2,14,5.545238095238095,20,29
"['0', '0010101']",1,2,5,3,0,8,0.25,6,2
"['1001110', '11011', '101011', '0011110', '000111']",1,5,12,19,4,31,7.068098568098568,26,30
"['1101000', '111100']",1,2,6,7,0,13,0.6153846153846154,2,4
"['01110', '11']",1,2,2,5,0,7,0.5714285714285714,3,0
"['010', '110001']",1,2,5,4,0,9,0.4444444444444444,4,0
"['1111100', '111100']",1,2,4,9,0,13,0.9230769230769231,1,10
"['0111010', '0011', '0001', '1101110', '1111010', '100111', '10', '000001']",1,8,20,23,7,43,14.4003996003996,101,79
"['010100', '001', '010000', '011100', '10011', '01000']",1,6,20,11,5,31,9.35,38,57
"['01', '000001']",1,2,6,2,0,8,0.5,4,3
"['0110001', '00001', '110011', '01010', '011010', '1110', '0100']",1,7,20,17,6,37,12.641491841491842,53,62
"['01', '1010', '0111']",1,3,4,6,2,10,1.8333333333333333,7,7
"['0010110', '110100', '0000']",1,3,11,6,0,17,1.7426573426573428,9,13
"['11010', '011', '110011', '000', '1011', '010011', '0101']",1,7,14,17,6,31,13.316378066378066,49,67
"['0', '1110101', '110', '10']",1,4,5,8,0,13,3.261111111111111,19,12
"['00101', '00011', '0101101', '101011', '111011', '010101', '00010']",1,7,19,21,6,40,14.147086247086246,48,64
"['0001110', '10000', '10100', '01011', '1110']",1,5,14,12,3,26,5.327272727272727,30,29
"['0', '0110001']",1,2,5,3,0,8,0.25,6,2
['111110'],1,1,1,5,0,6,0,0,0
"['0010', '11', '101', '1010101', '00110', '01000']",1,6,14,12,2,26,8.307359307359308,43,33
"['01', '001', '11', '10001', '000']",1,5,9,6,4,15,5.40952380952381,20,24
"['1111001', '1000', '011', '0000']",1,4,10,8,2,18,2.6305194805194807,21,15
"['0', '10010', '011110']",1,3,6,6,0,12,0.9826839826839826,12,9
"['0001', '00', '11']",1,3,5,3,2,8,1.0,7,6
"['11101', '011', '0111']",1,3,3,9,0,12,2.0238095238095237,6,12
"['0', '0011', '01111']",1,3,4,6,0,10,1.4,9,7
"['01', '111']",1,2,1,4,0,5,0.4,2,2
"['0010001', '10', '000']",1,3,9,3,0,12,1.4444444444444444,11,8
"['110', '110111']",1,2,2,7,0,9,0.6666666666666666,3,5
"['00111', '11000', '01010', '0110010', '01011']",1,5,14,13,4,27,5.933333333333334,27,33
"['0010110', '111', '00011', '10001', '00', '01010', '0111']",1,7,16,15,3,31,11.572438672438672,59,52
"['11000', '110001', '1101011', '1001', '100000']",1,5,15,13,2,28,6.9944055944055945,24,42
"['0', '0001', '11101']",1,3,5,5,0,10,1.1777777777777778,10,5
"['11001', '00101', '11', '100101', '01010']",1,5,11,12,3,23,6.577922077922078,27,28
"['00100', '011001', '00001']",1,3,11,5,2,16,1.8727272727272726,6,10
"['1000001', '0010', '0101000', '0111011', '11', '0001', '000', '011110']",1,8,23,17,5,40,14.545193695193694,100,79
"['0', '010']",1,2,3,1,0,4,0.5,2,4
"['10100', '0001010', '00', '0100']",1,4,13,5,0,18,3.965367965367965,17,29
"['001', '0010011']",1,2,6,4,0,10,0.6,4,4
"['0', '10', '10011']",1,3,4,4,0,8,1.5714285714285714,8,5
"['10', '000001', '01010']",1,3,9,4,0,13,1.185064935064935,11,7
"['110000', '010000', '1110000', '10001', '0101011', '0001101', '0111']",1,7,24,18,5,42,12.328527028527029,70,71
"['0101', '10']",1,2,3,3,0,6,0.6666666666666666,2,2
"['101000', '1']",1,2,4,3,0,7,0.2857142857142857,5,2
"['110110', '01', '1111', '10', '1000011']",1,5,8,13,2,21,4.834576534576534,36,29
"['1001', '1100']",1,2,4,4,2,8,0.75,2,2
"['1011000', '111001', '1111']",1,3,6,11,0,17,1.932867132867133,8,12
"['11011', '10', '0011100', '110101']",1,4,8,12,0,20,3.5403485403485404,22,14
"['101', '110', '0001000']",1,3,8,5,2,13,1.4666666666666668,12,4
"['10011', '1110']",1,2,3,6,0,9,0.4444444444444444,3,3
"['0101', '1110010', '0111', '101101']",1,4,8,13,2,21,4.01013986013986,16,17
"['11010', '00111', '1000', '01010', '101111']",1,5,11,14,3,25,5.9959595959595955,28,27
"['00', '1010010']",1,2,6,3,0,9,0.4444444444444444,5,2
"['0', '001100', '0001001', '1110']",1,4,11,7,0,18,2.6685814185814185,24,16
"['0110101', '00', '001', '0100']",1,4,10,6,0,16,3.427994227994228,17,21
['0111010'],1,1,3,4,0,7,0,0,0
"['1', '0111', '00000']",1,3,6,4,0,10,0.6222222222222222,12,4
"['11', '10', '000', '110', '0100']",1,5,8,6,4,14,4.976190476190476,18,23
"['00', '1011001']",1,2,5,4,0,9,0.4444444444444444,5,0
"['100110', '0010', '1', '0000']",1,4,10,5,2,15,2.835714285714286,18,13
['1000000'],1,1,6,1,0,7,0,0,0
"['1010110', '1110000', '01111', '0110000', '10', '0111']",1,6,15,17,3,32,7.977633477633478,55,50
"['11001', '110', '10', '0111']",1,4,5,9,0,14,3.6928571428571426,14,17
"['1', '00011']",1,2,3,3,0,6,0.3333333333333333,4,2
"['1000010', '011000']",1,2,9,4,0,13,0.6153846153846154,4,2
"['0000100', '00011', '01100', '0101011', '100111', '0011011', '01001', '1100', '01000']",1,9,29,22,7,51,23.68181818181818,105,123
"['0101', '1101011', '011', '01100']",1,4,8,11,0,19,4.267748917748918,16,17
"['0011', '01111', '111111', '000', '101001']",1,5,9,15,2,24,4.705266955266955,32,29
"['0', '1101', '101001', '11']",1,4,5,8,0,13,2.4523809523809526,18,15
['110111'],1,1,1,5,0,6,0,0,0
['111100'],1,1,2,4,0,6,0,0,0
['001'],1,1,2,1,0,3,0,0,0
"['110110', '1001', '1110000']",1,3,8,9,0,17,1.760839160839161,10,7
"['11110', '001', '1111110', '000', '11111', '011111', '01100']",1,7,11,23,5,34,10.401048951048951,66,83
['10001'],1,1,3,2,0,5,0,0,0
['001011'],1,1,3,3,0,6,0,0,0
"['01', '001111', '11']",1,3,3,7,2,10,1.5,9,8
"['0001001', '11110', '1000', '10', '0010010']",1,5,15,10,2,25,5.367965367965367,36,28
"['1000', '1101']",1,2,4,4,2,8,0.5,2,2
"['010100', '00011', '11', '1100001', '1001', '01001', '0101001', '1011111']",1,8,21,22,5,43,17.41875901875902,88,96
"['100', '0100110', '01000', '11']",1,4,10,7,0,17,3.3134920634920633,19,14
"['1001100', '111100', '0110']",1,3,8,9,0,17,2.0965034965034963,8,9
"['1110011', '000']",1,2,5,5,0,10,0.4,5,0
"['110', '1111000']",1,2,4,6,0,10,0.6,4,3
"['10001', '000100']",1,2,8,3,0,11,0.7272727272727273,3,0
"['00010', '111110', '0011000']",1,3,10,8,0,18,1.3251748251748252,11,12
"['1000', '010', '001000']",1,3,10,3,0,13,2.038095238095238,7,12
"['1011', '100', '000']",1,3,6,4,2,10,1.5238095238095237,6,7
"['11110', '1111101', '0111111', '10011', '01100']",1,5,8,21,5,29,5.79047619047619,32,33
"['101', '0000']",1,2,5,2,0,7,0.2857142857142857,3,0
"['1000101', '10', '111101']",1,3,6,9,0,15,1.5598290598290598,12,11
"['010010', '00', '11111', '1001001', '1100']",1,5,12,12,0,24,4.833877233877233,36,20
"['10101', '1000111', '00110', '00', '10']",1,5,11,10,4,21,5.407936507936507,32,22
"['1011010', '111100', '001101', '11', '10101', '010101']",1,6,13,19,3,32,9.156898656898656,43,45
"['101010', '0111110', '0111']",1,3,6,11,0,17,1.634965034965035,9,10
"['1011', '00', '11']",1,3,3,5,2,8,1.0,7,6
['11000'],1,1,3,2,0,5,0,0,0
"['0101', '0010100']",1,2,7,4,0,11,0.7272727272727273,3,2
"['11110', '01', '1101']",1,3,3,8,0,11,1.619047619047619,8,8
"['01', '10101', '011110']",1,3,5,8,0,13,1.435064935064935,11,6
"['1111110', '10', '000', '001000']",1,4,10,8,0,18,2.5188034188034187,25,21
"['01', '001', '0011000']",1,3,8,4,0,12,1.8444444444444446,10,10
"['00', '001110']",1,2,5,3,0,8,0.5,4,6
"['00111', '10111', '100011', '010110', '10', '11111', '0100']",1,7,13,20,5,33,11.623665223665224,58,60
"['11000', '110001', '1000101', '101101']",1,4,12,12,2,24,4.018648018648019,14,27
"['0101101', '1111010', '11']",1,3,5,11,2,16,1.6031746031746033,13,8
"['0100000', '011', '0001', '1111110', '0111', '1011000', '001100']",1,7,20,18,5,38,11.340093240093239,75,64
"['1101', '011010', '1']",1,3,4,7,0,11,1.4857142857142858,10,4
"['101', '00', '111']",1,3,3,5,2,8,1.0666666666666667,6,4
"['111', '0111']",1,2,1,6,0,7,0.8571428571428571,1,6
"['010101', '11']",1,2,3,5,0,8,0.5,4,2
['011111'],1,1,1,5,0,6,0,0,0
['00111'],1,1,2,3,0,5,0,0,0
"['0111000', '110010', '0010111', '101010', '00100', '10010', '000']",1,7,23,16,6,39,14.444388944388944,61,75
['1110100'],1,1,3,4,0,7,0,0,0
"['00', '111000']",1,2,5,3,0,8,0.5,4,4
"['00111', '00010', '0']",1,3,7,4,2,11,1.2666666666666666,10,9
"['010100', '010', '00101', '101010', '110001', '1111110', '0000']",1,7,20,17,3,37,11.524614274614274,66,55
"['11010', '11', '01111', '111011', '110011']",1,5,6,18,4,24,6.121645021645022,27,54
"['0', '1000110', '0111111']",1,3,6,9,2,15,0.9285714285714286,17,6
"['101010', '11010', '11']",1,3,5,8,0,13,1.7987012987012987,8,11
"['01', '100', '10']",1,3,4,3,2,7,1.7000000000000002,5,7
"['00', '1100']",1,2,4,2,0,6,0.6666666666666666,2,4
"['111010', '11']",1,2,2,6,0,8,0.5,4,4
['1011001'],1,1,3,4,0,7,0,0,0
"['0', '001100']",1,2,5,2,0,7,0.2857142857142857,5,4
"['00000', '10000', '100010', '1110110', '001011']",1,5,18,11,4,29,6.0762237762237765,29,34
"['101010', '110001', '1', '10011']",1,4,8,10,2,18,3.0259740259740258,21,20
"['0011', '110', '1011111', '111011']",1,4,5,15,0,20,3.398934398934399,20,25
"['11100', '0000']",1,2,6,3,0,9,0.4444444444444444,3,4
"['101000', '01101', '1', '0100']",1,4,9,7,0,16,3.031168831168831,19,12
"['01', '01011', '111111', '00001']",1,4,7,11,2,18,2.338311688311688,21,16
"['111111', '0000100']",1,2,6,7,0,13,0.15384615384615385,6,0
"['011101', '10010', '1110']",1,3,6,9,0,15,1.7898989898989899,8,7
"['1010', '0001000']",1,2,8,3,0,11,0.5454545454545454,4,2
"['01101', '111000', '101001']",1,3,8,9,2,17,1.7575757575757573,7,7
"['0', '010111', '111']",1,3,3,7,0,10,0.9523809523809523,11,8
"['0001101', '0101010', '01001', '1011']",1,4,12,11,2,23,4.010822510822511,17,13
"['00', '110', '1001010']",1,3,7,5,0,12,1.2444444444444445,11,7
"['101100', '0011110', '10010', '000', '0001010']",1,5,17,11,2,28,6.218287268287268,30,42
['10010'],1,1,3,2,0,5,0,0,0
"['111', '0001101', '0111111', '010101', '011001']",1,5,11,18,4,29,6.386813186813187,30,32
"['101', '00', '0101111', '011']",1,4,6,9,2,15,3.111111111111111,19,12
['110001'],1,1,3,3,0,6,0,0,0
"['01', '1101']",1,2,2,4,0,6,0.6666666666666666,2,3
"['0011', '100100', '111010']",1,3,8,8,2,16,1.6666666666666665,10,8
"['0011001', '0110000', '1', '0100']",1,4,12,7,2,19,3.068831168831169,24,14
"['1000100', '1001101', '10011', '1100', '111101']",1,5,13,16,2,29,6.348085248085248,29,42
"['1011100', '10011', '00011']",1,3,8,9,2,17,1.9666666666666668,8,11
['0100001'],1,1,5,2,0,7,0,0,0
"['01', '00']",1,2,3,1,2,4,0.5,1,2
"['11100', '10', '001011', '000']",1,4,9,7,0,16,3.001731601731602,19,18
"['010000', '011', '111111', '010111', '10']",1,5,9,14,3,23,4.372222222222222,36,29
"['010', '011']",1,2,3,3,2,6,0.6666666666666666,1,3
['01010'],1,1,3,2,0,5,0,0,0
"['1000', '01101']",1,2,5,4,0,9,0.4444444444444444,3,2
['111010'],1,1,2,4,0,6,0,0,0
"['0000', '0100000', '10', '011000']",1,4,15,4,0,19,3.3742812742812744,19,31
"['0', '0001', '00111', '111010']",1,4,8,8,0,16,2.6311688311688313,22,15
"['0011011', '01', '111100', '1110']",1,4,7,12,0,19,2.8347707847707846,23,17
"['1', '1001', '111011', '1010', '1000']",1,5,8,11,3,19,5.335714285714285,28,30
"['0', '010110', '001000']",1,3,9,4,2,13,1.2380952380952381,13,12
"['001', '001111', '0110', '10000', '110101']",1,5,12,12,2,24,5.236075036075036,32,24
"['110000', '01', '110', '1111', '001010', '1101', '0000110']",1,7,16,16,4,32,11.277833277833277,69,60
"['0000101', '01', '0110']",1,3,8,5,0,13,1.6565656565656566,11,8
"['011011', '101', '1101']",1,3,4,9,0,13,2.3238095238095235,6,11
"['1010', '0101', '00011']",1,3,7,6,2,13,1.8611111111111112,7,6
"['001', '111', '000010']",1,3,7,5,2,12,1.222222222222222,10,5
"['11', '100', '1101110', '001100', '1001011']",1,5,11,14,2,25,5.6006105006105,37,28
"['1011', '1001', '100111']",1,3,5,9,2,14,2.35,5,18
"['0', '0110010']",1,2,5,3,0,8,0.25,6,4
"['01', '1100', '11']",1,3,3,5,2,8,1.5,6,8
"['0010', '1101', '11111']",1,3,4,9,2,13,1.3888888888888888,9,6
"['00', '110', '001011', '11']",1,4,6,7,2,13,2.6444444444444444,17,17
"['0', '010', '0011', '0101010', '110111']",1,5,10,11,0,21,4.812426462426462,35,26
"['100', '100011', '10']",1,3,6,5,0,11,1.9666666666666668,8,10
"['001111', '100001', '111011', '10100', '001001']",1,5,14,15,4,29,5.515151515151515,28,32
"['000100', '01010', '111110']",1,3,9,8,2,17,1.4242424242424243,9,9
"['0001', '000111', '01110']",1,3,8,7,0,15,1.9717171717171718,8,9
"['1101', '100111', '0010', '100010']",1,4,10,10,4,20,3.7666666666666666,16,16
"['0', '0010001', '110010', '101000', '00110', '111111']",1,6,16,15,3,31,6.453130203130203,59,35
"['01', '001', '0100010', '11000', '0110', '00110', '11100']",1,7,18,13,3,31,12.758225108225108,61,65
"['111', '101', '0011', '1111001', '1101010']",1,5,8,16,4,24,6.014718614718614,33,38
"['11010', '1110101', '1000000', '00', '10010', '1100110', '0111101', '110', '0111100']",1,9,24,26,7,50,21.13888888888889,124,101
"['1011110', '00100', '1111001']",1,3,8,11,2,19,1.7142857142857144,11,4
"['1000011', '0010', '111110', '1']",1,4,8,10,0,18,2.1888611388611388,27,12
"['10000', '1110']",1,2,5,4,0,9,0.4444444444444444,3,2
['01001'],1,1,3,2,0,5,0,0,0
"['101', '10100']",1,2,4,4,0,8,0.75,2,4
"['001', '101000', '11000', '10101', '10', '0100001']",1,6,17,11,2,28,8.87067377067377,45,44
"['101011', '001', '11']",1,3,4,7,0,11,1.3444444444444446,9,10
"['11001', '00101', '01110', '0101', '101111']",1,5,10,15,3,25,6.44040404040404,25,25
"['101', '1011', '010111', '001100']",1,4,8,11,2,19,4.034920634920635,16,13
['1011'],1,1,1,3,0,4,0,0,0
['010010'],1,1,4,2,0,6,0,0,0
"['1110001', '11100', '101110']",1,3,7,11,0,18,2.175990675990676,8,10
"['1010', '001', '000']",1,3,7,3,2,10,1.8095238095238093,5,8
"['110000', '100', '0110', '1000111', '111011', '11111', '0100011']",1,7,16,22,4,38,11.792635142635142,69,71
"['0111101', '1111000', '00000']",1,3,10,9,2,19,1.5476190476190477,12,10
"['00', '01011']",1,2,4,3,0,7,0.5714285714285714,3,2
"['11001', '001']",1,2,4,4,0,8,0.75,2,4
"['101', '00', '111', '110100']",1,4,6,8,2,14,2.9,16,14
"['01', '101101', '11111']",1,3,3,10,0,13,1.331168831168831,10,9
"['100', '11']",1,2,2,3,0,5,0.4,2,2
"['101000', '01000']",1,2,8,3,0,11,0.9090909090909091,1,6
['0011'],1,1,2,2,0,4,0,0,0
"['00', '1001', '1111']",1,3,4,6,2,10,1.1666666666666665,8,4
['1110000'],1,1,4,3,0,7,0,0,0
"['01', '0010', '1000101', '0101110', '00011', '1111', '010110']",1,7,17,18,4,35,12.022227772227772,64,52
"['1010111', '0001', '11100']",1,3,7,9,0,16,1.308080808080808,12,9
"['0', '001', '101', '0110', '010111', '011111']",1,6,9,14,4,23,7.647619047619047,44,35
"['01', '1100001', '0000001', '1111001', '010010', '1100']",1,6,19,14,3,33,8.288145188145188,54,46
"['11', '01111', '0110011']",1,3,4,10,0,14,1.8492063492063493,10,13
"['1100111', '0100011', '1000101']",1,3,10,11,3,21,2.2857142857142856,6,10
"['11110', '0010', '111', '1101', '1100']",1,5,7,13,3,20,5.992063492063492,22,32
"['010', '10', '11']",1,3,3,4,2,7,1.7000000000000002,4,5
"['0', '0010']",1,2,4,1,0,5,0.4,3,4
"['010100', '001', '11', '0011', '1010111', '0101010', '1101', '111000']",1,8,18,21,6,39,15.7996558996559,88,79
"['0', '100110', '1100101']",1,3,7,7,0,14,1.304945054945055,14,4
"['000111', '10', '01010']",1,3,7,6,0,13,1.3668831168831168,11,7
['11001'],1,1,2,3,0,5,0,0,0
"['11001', '0111011', '1000', '111111', '10']",1,5,8,16,0,24,5.144194694194694,35,28
"['11011', '1010010']",1,2,5,7,0,12,0.6666666666666666,3,2
"['0011', '101000', '0100', '11']",1,4,9,7,2,16,3.2,18,15
"['010', '011', '00111', '10001', '1001', '0100001', '0101']",1,7,17,14,6,31,14.000577200577201,52,62
"['01101', '11']",1,2,2,5,0,7,0.5714285714285714,3,2
['1011010'],1,1,3,4,0,7,0,0,0
"['011', '0001', '100100', '0110', '1000']",1,5,13,8,3,21,5.708730158730159,26,28
"['0010110', '01', '1000']",1,3,8,5,0,13,1.323232323232323,12,7
"['10', '000', '1101', '1100', '01000']",1,5,11,7,2,18,5.773015873015873,22,27
"['111100', '00100', '10100', '010011', '110']",1,5,13,12,4,25,6.138383838383838,29,32
"['11', '101000', '00110', '01001', '0101', '1001011']",1,6,15,14,2,29,9.122577422577422,44,35
"['0100111', '101', '111011', '0001101', '00', '1100011']",1,6,14,18,3,32,8.535714285714286,54,44
['000'],1,1,3,0,0,3,0,0,0
"['11001', '101000', '100', '10011']",1,4,10,9,2,19,4.239393939393939,14,20
"['111', '0011001', '10111', '1001001', '0010010', '101111']",1,6,15,20,3,35,9.737112887112886,45,55
"['0', '0010000', '0011', '1010111', '11100']",1,5,13,11,2,24,4.379076479076479,42,28
"['11101', '100100', '00101']",1,3,8,8,2,16,1.8727272727272726,7,9
"['00110', '110', '11100', '00001']",1,4,10,8,3,18,3.35,18,18
"['010011', '1011011', '1100', '010000']",1,4,12,11,2,23,3.4890442890442888,18,18
"['01', '00110']",1,2,4,3,0,7,0.5714285714285714,3,2
"['010', '1']",1,2,2,2,0,4,0.5,2,0
"['11001', '010', '11']",1,3,4,6,0,10,1.4714285714285715,8,6
"['0001', '0111111', '110']",1,3,5,9,0,14,1.0493506493506493,13,7
"['0101011', '111011']",1,2,4,9,0,13,0.7692307692307693,2,6
"['10100', '01', '00010']",1,3,8,4,2,12,1.7428571428571429,9,7
"['010001', '0100']",1,2,7,3,0,10,0.8,2,5
"['1100', '0000']",1,2,6,2,2,8,0.5,2,4
"['1', '110101']",1,2,2,5,0,7,0.2857142857142857,5,4
"['001', '100', '000']",1,3,7,2,3,9,2.0,4,11
"['100101', '11111']",1,2,3,8,0,11,0.5454545454545454,3,4
"['1010', '010010', '111']",1,3,6,7,0,13,1.615873015873016,8,6
"['0100100', '011001']",1,2,8,5,0,13,0.7692307692307693,3,3
"['0', '10000']",1,2,5,1,0,6,0.3333333333333333,4,2
['1110111'],1,1,1,6,0,7,0,0,0
"['0000110', '0110', '10', '1111101']",1,4,9,11,2,20,3.2568542568542567,24,15
"['1111100', '111', '1111000', '1101', '00010', '0000110']",1,6,15,18,3,33,8.168903318903318,58,51
"['11', '000101', '111011', '010101', '100101', '11101', '1100011', '000111', '011000']",1,9,22,28,6,50,22.308413808413807,109,137
"['000100', '1100', '1']",1,3,7,4,0,11,1.2857142857142856,11,7
"['0', '1110001', '01', '1011111']",1,4,6,11,2,17,2.626984126984127,27,13
"['0', '010011', '011']",1,3,5,5,0,10,1.4523809523809523,10,9
"['0011', '100001']",1,2,6,4,0,10,0.6,3,2
"['1001', '01000', '1000', '00', '010111', '1110']",1,6,14,11,3,25,8.633549783549784,39,41
"['010', '000', '1110', '01110']",1,4,8,7,2,15,3.6626984126984126,12,24
"['0', '110110', '1010111', '1111010', '00110', '1000']",1,6,13,17,2,30,7.88045288045288,55,39
"['110011', '010', '000100']",1,3,9,6,2,15,1.6111111111111112,11,4
['000111'],1,1,3,3,0,6,0,0,0
"['11001', '0010110', '10111', '1111', '00', '1011']",1,6,10,17,4,27,7.659163059163059,43,44
"['101', '00', '01100']",1,3,6,4,0,10,1.4714285714285715,8,6
"['0000101', '0011']",1,2,7,4,0,11,0.7272727272727273,3,3
"['01', '0111111', '1010011']",1,3,5,11,2,16,1.3174603174603174,14,8
"['01', '001111', '10001', '1111', '10']",1,5,7,12,2,19,4.8494227994228,32,30
"['001', '10']",1,2,3,2,0,5,0.4,2,2
"['1000001', '01', '0010111', '00000', '1010', '111111', '100101']",1,7,19,18,4,37,10.24167499167499,77,55
"['100110', '10110']",1,2,5,6,0,11,0.9090909090909091,1,6
"['0', '101100', '110']",1,3,5,5,0,10,1.4523809523809523,10,6
"['01', '011', '100', '0010011', '0111', '1110']",1,6,10,13,4,23,8.122582972582972,42,43
"['11100', '0010', '000101']",1,3,9,6,0,15,1.6080808080808082,9,9
"['0111010', '001']",1,2,5,5,0,10,0.4,4,2
"['0101111', '111', '110001', '1100011', '0100']",1,5,11,16,2,27,5.645487845487845,33,41
"['1', '001010', '000', '1100111', '1110']",1,5,10,11,0,21,3.848934398934399,39,22
"['110', '00011']",1,2,4,4,0,8,0.5,4,3
"['0001', '111100', '111', '01100']",1,4,8,10,0,18,3.024098124098124,19,19
"['0110000', '110', '0100']",1,3,9,5,0,14,1.8987012987012988,9,10
"['0111000', '1', '101000', '10010', '1100111', '0100']",1,6,16,14,2,30,8.275091575091576,56,33
"['011011', '001111', '00101', '1010011']",1,4,10,14,2,24,4.031468531468532,14,18
['1110011'],1,1,2,5,0,7,0,0,0
"['101', '10001', '1111']",1,3,4,8,0,12,1.7658730158730158,7,14
"['1110', '1111']",1,2,1,7,2,8,0.75,1,6
"['1110011', '1110', '011001']",1,3,6,11,0,17,2.0965034965034963,8,10
"['01', '00', '11']",1,3,3,3,3,6,1.0,4,4
"['011', '111', '01110', '00011']",1,4,6,10,4,16,4.016666666666667,13,18
['00011'],1,1,3,2,0,5,0,0,0
"['0011001', '01', '10010']",1,3,8,6,0,14,1.6825396825396823,12,7
"['0', '0110', '10']",1,3,4,3,0,7,1.7333333333333334,6,9
"['0010', '11101', '00011']",1,3,7,7,2,14,1.511111111111111,9,6
"['0110010', '10', '111010']",1,3,7,8,0,15,1.7136752136752138,11,10
"['1010111', '00']",1,2,4,5,0,9,0.4444444444444444,5,0
"['00', '100', '000001', '11']",1,4,9,4,2,13,2.3944444444444444,18,15
"['11', '10100', '1101', '110', '111001']",1,5,7,13,0,20,6.755844155844156,22,37
"['010000', '1', '1011011', '0101001', '1011111']",1,5,12,16,3,28,4.563186813186813,42,26
"['00100', '111']",1,2,4,4,0,8,0.25,4,0
"['1100101', '100001', '1001011', '0010011']",1,4,14,13,3,27,4.43956043956044,14,25
"['100001', '0011000', '010111', '10', '110', '01100']",1,6,16,13,2,29,8.70977355977356,52,34
['1001100'],1,1,4,3,0,7,0,0,0
"['00000', '111001']",1,2,7,4,0,11,0.36363636363636365,4,0
"['111', '1001', '0011011', '101001', '0100']",1,5,11,13,2,24,5.844438894438895,29,27
"['0', '1000110', '01', '1111']",1,4,6,8,0,14,2.058080808080808,23,10
"['011', '100', '010101', '101111', '1111111']",1,5,7,18,4,25,5.121367521367521,36,33
"['101000', '10', '110111']",1,3,6,8,2,14,1.5,12,7
"['101', '1']",1,2,1,3,0,4,0.5,2,4
['10110'],1,1,2,3,0,5,0,0,0
"['00111', '001111', '0000']",1,3,8,7,0,15,1.7535353535353535,8,16
"['101010', '1110011', '000']",1,3,8,8,0,16,1.682051282051282,11,4
"['100', '10']",1,2,3,2,0,5,0.8,1,3
"['01', '00100', '1101', '1010000']",1,4,11,7,0,18,3.339105339105339,20,13
"['1110111', '010', '1', '001010', '0110001']",1,5,11,13,2,24,4.446886446886447,41,19
"['1000001', '110001', '1111', '110011', '000', '01110']",1,6,15,16,2,31,8.283605283605283,49,41
"['0', '110010']",1,2,4,3,0,7,0.2857142857142857,5,2
"['10111', '100', '1', '1111000']",1,4,6,10,0,16,2.683333333333333,23,18
"['0010', '010', '0111010']",1,3,8,6,0,14,2.1844155844155844,8,19
"['1011', '1000', '1']",1,3,4,5,2,9,1.3,8,9
"['001', '111', '00', '110111', '1011', '01000']",1,6,10,13,2,23,6.9001443001443,43,41
"['00110', '010']",1,2,5,3,0,8,0.75,2,5
"['01100', '001111', '111', '10']",1,4,6,10,0,16,2.9335497835497835,19,15
"['10100', '011010']",1,2,6,5,0,11,0.7272727272727273,3,2
"['1111', '111110', '0000', '000100', '110', '1101010']",1,6,14,16,4,30,7.251237651237651,50,52
['1001000'],1,1,5,2,0,7,0,0,0
"['0', '0111110']",1,2,3,5,0,8,0.25,6,4
"['01101', '10']",1,2,3,4,0,7,0.5714285714285714,3,2
"['0', '01', '11110', '11000', '110011']",1,5,8,11,2,19,4.563203463203463,33,25
"['11', '01', '001111', '00011']",1,4,6,9,2,15,3.37012987012987,17,18
['001110'],1,1,3,3,0,6,0,0,0
"['1100010', '1101110']",1,2,6,8,2,14,0.7142857142857143,2,5
"['0001', '001001']",1,2,7,3,0,10,0.6,2,5
"['0001', '010000']",1,2,8,2,0,10,0.6,3,4
"['11000', '01', '11']",1,3,4,5,2,9,1.3571428571428572,8,8
"['0010110', '0100010', '000101', '010101', '1101', '1011111']",1,6,18,19,5,37,9.046486846486847,47,38
"['0100101', '101001']",1,2,7,6,0,13,0.7692307692307693,3,3
"['001010', '10']",1,2,5,3,0,8,0.5,4,3
"['1000', '1', '0110']",1,3,5,4,2,9,1.3,9,4
"['00101', '111', '100100', '10000', '0010101', '110', '001011']",1,7,19,16,6,35,12.395843045843046,60,71
"['1', '1001111']",1,2,2,6,0,8,0.25,6,4
"['111', '000']",1,2,3,3,2,6,0.0,3,0
"['011101', '1', '0110110']",1,3,5,9,0,14,1.304945054945055,14,6
"['1011110', '1000']",1,2,5,6,0,11,0.5454545454545454,4,3
"['0011', '1000101', '1000111', '0000']",1,4,13,9,4,22,4.084415584415584,16,17
"['100011', '111']",1,2,3,6,0,9,0.4444444444444444,3,6
"['0001', '1', '0000000']",1,3,10,2,0,12,0.9454545454545454,14,8
"['001101', '0001', '1001', '00110', '00', '0101', '01000']",1,7,19,11,5,30,13.697402597402597,48,70
"['0010110', '01100', '0100101', '1001101']",1,4,14,12,3,26,4.285714285714286,17,14
['1010010'],1,1,4,3,0,7,0,0,0
"['0', '1000', '1011000']",1,3,8,4,0,12,1.3772727272727274,12,10
"['010100', '11', '100', '0110', '00', '1011000']",1,6,14,10,2,24,8.556820956820957,44,42
"['100', '011', '0110110']",1,3,6,7,2,13,1.5333333333333332,11,8
"['11010', '1001', '11']",1,3,4,7,0,11,1.9047619047619047,7,10
"['110011', '00101', '11']",1,3,5,8,0,13,1.7987012987012987,10,12
"['101', '110010', '1110']",1,3,5,8,0,13,1.838095238095238,7,8
"['0011', '010', '11101']",1,3,5,7,0,12,1.5158730158730158,8,5
"['0', '1001', '110', '010101']",1,4,7,7,0,14,3.0015873015873016,17,11
"['0', '01', '11011', '1010111']",1,4,5,10,0,15,3.0992063492063493,21,12
"['0001101', '01000']",1,2,8,4,0,12,0.5,4,4
"['000110', '11101', '0010100', '11']",1,4,10,10,0,20,3.3305583305583304,22,12
"['011111', '0000110', '0110']",1,3,8,9,0,17,1.7888111888111888,10,13
"['11110', '1111101', '011', '1001010', '0011000', '1000', '00']",1,7,17,18,3,35,10.34992784992785,77,58
"['11000', '101', '011110', '11']",1,4,6,10,0,16,3.3613275613275615,18,12
"['10', '0111', '00001']",1,3,6,5,0,11,1.0634920634920635,10,6
"['110110', '1101000', '1001', '1100']",1,4,10,11,2,21,4.191958041958042,16,20
"['10101', '11110', '010001', '1']",1,4,7,10,2,17,2.4432900432900433,22,15
"['1011', '1']",1,2,1,4,0,5,0.4,3,4
"['110', '0011111']",1,2,3,7,0,10,0.4,5,3
['0000110'],1,1,5,2,0,7,0,0,0
"['0111100', '1110', '1111']",1,3,4,11,2,15,2.2045454545454546,7,8
"['010', '1', '1001', '0000010', '0111101']",1,5,12,10,2,22,4.6909090909090905,41,20
['00001'],1,1,4,1,0,5,0,0,0
"['0010', '110', '101101']",1,3,6,7,0,13,1.838095238095238,8,5
"['10', '010010', '1']",1,3,5,4,0,9,1.4523809523809523,10,5
"['1101', '0001', '101111']",1,3,5,9,2,14,1.5,9,10
"['01', '0101110', '1101100', '1000', '0011111']",1,5,12,15,3,27,4.978354978354978,41,25
"['10', '111', '00011']",1,3,4,6,0,10,1.1857142857142857,9,8
['0011101'],1,1,3,4,0,7,0,0,0
"['01', '00010', '00', '0111']",1,4,8,5,2,13,3.087301587301587,15,17
"['00', '10']",1,2,3,1,2,4,0.5,1,2
"['0100001', '1101111', '10', '11']",1,4,7,11,4,18,2.706349206349206,25,18
"['1000', '1001']",1,2,5,3,2,8,0.75,1,4
"['10000', '0000011', '011001']",1,3,12,6,0,18,1.8275058275058274,9,9
"['01', '001', '11010', '1111', '00']",1,5,7,9,2,16,5.0285714285714285,24,23
['0100'],1,1,3,1,0,4,0,0,0
"['0001011', '000']",1,2,7,3,0,10,0.6,4,6
"['001', '010', '0011000', '0110', '1101110', '0011111', '1011', '110']",1,8,17,21,8,38,16.749134199134197,89,82
"['01', '01101', '000']",1,3,6,4,0,10,1.4714285714285715,8,8
"['11000', '1']",1,2,3,3,0,6,0.3333333333333333,4,2
['1010'],1,1,2,2,0,4,0,0,0
"['10100', '101100', '1000']",1,3,9,6,0,15,2.175757575757576,4,14
"['1011010', '11011', '10', '000111']",1,4,8,12,0,20,3.093378843378843,23,16
"['0101', '100100']",1,2,6,4,0,10,0.6,3,2
"['00100', '00110', '011', '11']",1,4,8,7,2,15,3.7071428571428573,14,15
"['11', '0010101', '0000']",1,3,8,5,0,13,1.1717171717171717,12,6
"['0001010', '1111111']",1,2,5,9,2,14,0.2857142857142857,5,0
"['000100', '10001', '01001', '10']",1,4,12,6,2,18,3.897402597402597,18,13
"['1100', '1111']",1,2,2,6,2,8,0.5,2,4
"['010', '0100110', '110001', '100011', '001110', '1010000']",1,6,20,15,5,35,9.46984126984127,49,35
"['0010110', '0011101', '101010', '0110', '0000001', '0011010', '1111', '000', '011110']",1,9,27,24,8,51,20.209179709179708,113,121
"['1110111', '0011101', '100000', '010010']",1,4,13,13,4,26,3.227106227106227,25,11
"['0100000', '11010', '100', '1010', '0100001', '1011']",1,6,18,12,4,30,9.541269841269841,43,42
"['011101', '0011', '1110011', '1010101']",1,4,9,15,2,24,3.817782217782218,17,20
"['0', '11000']",1,2,4,2,0,6,0.3333333333333333,4,2
"['00011', '00001', '0010011', '10', '0111', '0000']",1,6,17,10,4,27,8.005266955266954,41,51
"['0', '10010', '11001']",1,3,6,5,2,11,1.4666666666666668,10,4
"['101', '001001', '0000100']",1,3,11,5,0,16,1.835897435897436,11,7
"['01', '10001', '1101101', '10', '000010']",1,5,12,10,2,22,5.233377733377734,35,23
"['110110', '0100000', '010', '111', '1010', '001100', '101110']",1,7,18,17,5,35,12.568043068043067,63,58
"['0101', '0111010', '011', '111', '1101', '100011', '110111', '01001', '00010']",1,9,18,25,8,43,22.13154068154068,95,108
"['0111', '110', '1001011', '000']",1,4,8,9,2,17,2.7359307359307357,18,13
"['11101', '1', '0010011']",1,3,5,8,0,13,0.9166666666666666,14,9
"['101', '1000', '100000', '011']",1,4,10,6,2,16,2.9904761904761905,18,19
"['0111111', '1']",1,2,1,7,0,8,0.25,6,2
"['1111101', '011011', '100010', '1010', '11101', '001110', '0111111', '0000', '111000']",1,9,21,30,8,51,20.674236874236875,116,105
"['11010', '010', '11100', '10110']",1,4,8,10,3,18,4.2,13,17
['0010100'],1,1,5,2,0,7,0,0,0
"['0', '1000110', '0001101', '10', '0111']",1,5,11,10,2,21,4.918759018759019,38,22
['0110110'],1,1,3,4,0,7,0,0,0
"['00111', '1110']",1,2,3,6,0,9,0.6666666666666666,3,4
"['10101', '1001']",1,2,4,5,0,9,0.8888888888888888,1,6
"['0100010', '1100010', '10100', '00', '011110', '011001', '01000']",1,7,23,15,6,38,13.167909867909868,64,76
"['11110', '00', '10']",1,3,4,5,2,9,1.3571428571428572,8,7
"['0000', '100100', '1111110', '00001']",1,4,13,9,0,22,2.8905205905205906,22,21
"['0010001', '100', '0110', '0000010', '1010000']",1,5,20,8,3,28,5.664935064935065,34,32
"['11001', '0001001', '01001', '0110000']",1,4,15,9,4,24,4.204761904761905,16,23
"['11011', '0001100', '000', '1101', '0000110', '0101001']",1,6,19,14,3,33,8.47049062049062,52,44
"['0101010', '1111101']",1,2,5,9,2,14,0.42857142857142855,4,0
"['001111', '10']",1,2,3,5,0,8,0.25,5,2
"['0001', '00', '01010']",1,3,8,3,0,11,1.6825396825396823,7,10
"['11010', '1001010', '101101', '101011', '0110', '11101', '000100']",1,7,18,21,5,39,13.635664335664336,52,53
"['00', '11011', '1110100', '0111']",1,4,7,11,0,18,2.942279942279942,21,18
"['00111', '1', '01011', '0110001']",1,4,8,10,2,18,2.716666666666667,23,14
"['0', '0001000', '1011111']",1,3,8,7,2,15,0.7857142857142857,17,4
"['10001', '1111']",1,2,3,6,0,9,0.4444444444444444,3,4
"['0', '100101', '0110']",1,3,6,5,0,11,1.0857142857142859,11,4
"['0101101', '1110101', '01011', '1110']",1,4,8,15,2,23,3.9704184704184704,17,23
"['00001', '1010100', '100000', '10', '1010001', '1110']",1,6,19,12,2,31,7.375912975912976,49,47
"['10111', '11']",1,2,1,6,0,7,0.5714285714285714,3,6
"['0110010', '001', '0010000']",1,3,12,5,2,17,1.7714285714285714,10,11
"['10110', '011110']",1,2,4,7,0,11,0.7272727272727273,2,4
"['011011', '1', '000']",1,3,5,5,0,10,0.7301587301587301,12,4
"['010', '1', '100100', '10100', '01100']",1,5,12,8,2,20,5.8735930735930735,27,27
"['1001110', '110', '10010']",1,3,7,8,0,15,1.9333333333333333,8,13
"['111111', '010110']",1,2,3,9,2,12,0.3333333333333333,3,0
"['10111', '0001000']",1,2,7,5,0,12,0.3333333333333333,5,0
"['001', '100', '010010']",1,3,8,4,2,12,2.0,8,7
"['100001', '11', '10100', '11101', '10011', '0000010', '1011', '01001']",1,8,20,19,4,39,16.641813741813742,80,89
['100100'],1,1,4,2,0,6,0,0,0
"['0010001', '10']",1,2,6,3,0,9,0.4444444444444444,5,2
"['0', '0110010', '010001', '1111001']",1,4,11,10,2,21,2.8846153846153846,25,13
"['01', '0111001', '1', '0010000', '100010']",1,5,14,9,2,23,4.643467643467643,42,20
"['0101011', '000']",1,2,6,4,0,10,0.6,4,2
"['1', '011', '001110', '000', '0101001']",1,5,11,9,2,20,4.163919413919414,36,21
"['1101', '00', '0000011']",1,3,8,5,0,13,1.1414141414141414,13,7
['100000'],1,1,5,1,0,6,0,0,0
"['11010', '001', '101', '00', '101110']",1,5,9,10,2,19,5.844660894660895,25,24
"['0', '1010001']",1,2,5,3,0,8,0.25,6,0
"['0', '1011100']",1,2,4,4,0,8,0.25,6,2
"['110110', '0001110', '011', '001111', '00000', '0101101', '0001', '000101']",1,8,24,20,5,44,16.735014985014985,83,94
"['1011', '100', '11101', '0100']",1,4,7,9,2,16,3.5396825396825395,14,14
"['10101', '1']",1,2,2,4,0,6,0.3333333333333333,4,4
"['111101', '010', '000011', '11']",1,4,7,10,2,17,2.6222222222222222,23,15
"['0001', '1001', '011', '11']",1,4,6,7,2,13,3.6928571428571426,11,18
"['0', '1110']",1,2,2,3,0,5,0.4,3,2
"['1101001', '011', '01111', '00', '1110']",1,5,8,13,0,21,5.063708513708513,31,27
"['0', '000111']",1,2,4,3,0,7,0.2857142857142857,5,2
"['010000', '10', '010011', '110', '101001']",1,5,13,10,3,23,5.8,31,24
"['0011101', '0110', '001111', '0101001']",1,4,11,13,2,24,3.8677322677322676,16,18
"['10111', '11010', '0100', '00001']",1,4,10,9,3,19,2.9555555555555557,17,12
"['00100', '0001', '00', '1110']",1,4,10,5,2,15,2.9325396825396823,17,22
"['100', '110', '000000', '1101110']",1,4,11,8,2,19,2.8410256410256407,23,18
"['010', '001', '111001']",1,3,6,6,2,12,1.7777777777777777,9,6
"['101', '1111', '001100', '011010', '110', '1001011']",1,6,12,17,4,29,8.527861027861027,46,33
"['0101110', '11100', '101010']",1,3,8,10,0,18,1.9813519813519813,7,7
"['10111', '10001', '1']",1,3,4,7,2,11,1.2666666666666666,10,13
"['010', '11', '101', '0010100', '01100']",1,5,11,9,2,20,6.165873015873016,28,20
"['0000000', '1110']",1,2,8,3,0,11,0.18181818181818182,6,2
"['0', '10001', '00011']",1,3,7,4,2,11,1.4666666666666668,10,4
"['00', '10', '01010']",1,3,6,3,2,9,1.6428571428571428,7,9
"['0110', '10']",1,2,3,3,0,6,0.6666666666666666,2,3
"['0', '101', '0011110', '111101']",1,4,6,11,0,17,2.8716117216117216,24,10
"['01010', '1101010']",1,2,6,6,0,12,0.8333333333333334,2,6
['1111101'],1,1,1,6,0,7,0,0,0
"['1000', '01000']",1,2,7,2,0,9,0.8888888888888888,1,5
"['00110', '11']",1,2,3,4,0,7,0.5714285714285714,3,0
"['1101', '1001']",1,2,3,5,2,8,0.75,1,5
"['00010', '11101', '1', '0000']",1,4,9,6,2,15,2.1777777777777776,21,12
"['101', '1001', '0010101', '11101', '1110']",1,5,9,14,2,23,6.243217893217893,25,39
"['0', '01', '10011', '11111']",1,4,4,9,2,13,2.257142857142857,19,12
"['010011', '0100111', '000011', '0000']",1,4,14,9,2,23,4.08927738927739,13,28
"['010000', '100001', '101111']",1,3,10,8,3,18,1.6666666666666667,10,5
"['0', '0110000', '1010', '001']",1,4,10,5,0,15,2.666883116883117,22,15
"['001111', '1110', '1010', '10011', '101001', '0100']",1,6,13,16,5,29,8.882323232323232,39,39
"['00', '100', '0100110', '110']",1,4,9,6,2,15,3.511111111111111,17,18
"['01101', '001111', '0011', '01111', '1000000', '0111']",1,6,14,17,4,31,9.250621600621601,42,53
"['000', '11']",1,2,3,2,0,5,0.0,3,0
"['100111', '011110', '00011']",1,3,7,10,2,17,1.9393939393939394,8,5
"['011111', '110110']",1,2,3,9,2,12,0.5,3,3
"['1000011', '1100010', '1000', '11']",1,4,11,9,2,20,3.391053391053391,21,22
"['001110', '0111', '11']",1,3,4,8,0,12,1.9666666666666668,8,6
"['011000', '0000']",1,2,8,2,0,10,0.6,2,8
"['10', '000011', '011001']",1,3,8,6,2,14,1.4166666666666665,12,6
"['1111010', '001', '10011', '111011']",1,4,7,14,0,21,3.4242812742812743,19,21
"['1011', '00', '11011', '111001']",1,4,6,11,0,17,3.335209235209235,17,19
"['01', '1', '100111']",1,3,3,6,0,9,1.4523809523809523,10,8
"['00', '1100110']",1,2,5,4,0,9,0.4444444444444444,5,2
"['011010', '1101111', '1111000']",1,3,7,13,2,20,1.8021978021978022,11,8
"['101100', '01', '0001110', '0011000', '01111']",1,5,14,13,2,27,5.771339771339771,35,29
"['100', '01110']",1,2,4,4,0,8,0.5,3,2
"['1000', '00', '1']",1,3,5,2,0,7,1.0666666666666667,7,6
"['0110101', '100', '0']",1,3,6,5,0,11,1.35,12,6
"['010000', '100', '11']",1,3,7,4,0,11,1.3166666666666667,10,5
"['1100011', '10', '111']",1,3,4,8,0,12,1.4444444444444444,11,12
"['10101', '10001', '100', '0000001', '1000', '11101', '1100011']",1,7,20,16,5,36,13.2012987012987,57,79
"['10', '0111', '0000', '1100', '111001']",1,5,10,10,3,20,4.883333333333333,29,24
"['111111', '010111']",1,2,2,10,2,12,0.5,2,6
['1001001'],1,1,4,3,0,7,0,0,0
"['10001', '00110', '010111', '0111', '011010']",1,5,12,14,4,26,6.356565656565657,26,26
"['010010', '00110', '1010', '10010', '010111']",1,5,14,12,4,26,7.1313131313131315,20,36
"['0100111', '0010111', '100', '10', '000']",1,5,12,10,4,22,5.612698412698412,33,29
"['1', '0110100', '10001', '1010', '0000010']",1,5,15,9,2,24,4.910822510822511,39,20
"['00', '100000', '101111']",1,3,8,6,2,14,1.0833333333333333,13,7
"['101100', '011']",1,2,4,5,0,9,0.6666666666666666,3,2
"['0010111', '101', '000101', '100110', '111111']",1,5,11,17,3,28,5.557264957264957,32,30
"['010000', '11', '1101100', '100101', '01000']",1,5,15,11,2,26,5.513958263958264,34,26
"['001', '0101100', '1001']",1,3,8,6,0,14,1.8025974025974025,9,7
"['0010001', '0001', '101110', '1111']",1,4,10,11,2,21,2.8024475524475525,21,16
"['01', '1001']",1,2,3,3,0,6,0.6666666666666666,2,3
"['1010100', '001', '000']",1,3,9,4,2,13,1.4666666666666668,9,11
"['1', '001111']",1,2,2,5,0,7,0.2857142857142857,5,2
"['101', '00011']",1,2,4,4,0,8,0.5,3,2
"['01', '00000']",1,2,6,1,0,7,0.2857142857142857,4,2
"['100', '00011']",1,2,5,3,0,8,0.5,3,3
"['10111', '01011', '101111']",1,3,4,12,2,16,2.4363636363636365,5,16
"['110000', '111', '0011', '10010', '0001011', '111001']",1,6,15,16,2,31,8.84128094128094,48,53
"['010111', '1110']",1,2,3,7,0,10,0.6,3,4
"['0110', '1000111']",1,2,5,6,0,11,0.5454545454545454,4,0
"['0', '10001', '00001']",1,3,8,3,2,11,1.4666666666666668,9,7
"['110010', '1001', '00']",1,3,7,5,0,12,1.9666666666666668,8,4
"['0011110', '1']",1,2,3,5,0,8,0.25,6,0
"['0', '1101', '010', '1110']",1,4,5,7,2,12,3.192857142857143,14,12
['1100'],1,1,2,2,0,4,0,0,0
"['0', '101', '1001']",1,3,4,4,0,8,1.7571428571428571,6,6
"['01', '11010', '01111', '000010', '1000011', '001001', '101001']",1,7,20,17,5,37,11.96002886002886,67,54
['100111'],1,1,2,4,0,6,0,0,0
"['1010111', '101', '0110110', '11']",1,4,6,13,2,19,3.6031746031746033,22,16
"['1010100', '11']",1,2,4,5,0,9,0.4444444444444444,5,2
"['11110', '0101000', '001', '00101', '111', '1000111', '0010011', '11101']",1,8,19,23,8,42,15.3,95,93
['011011'],1,1,2,4,0,6,0,0,0
"['10101', '0110']",1,2,4,5,0,9,0.4444444444444444,3,0
"['0010', '011101', '1111010', '1100', '110101']",1,5,11,16,4,27,6.577855477855477,27,27
"['0111000', '00101', '11', '00100', '00']",1,5,13,8,4,21,4.855555555555555,33,35
"['101', '01001', '000100', '1111']",1,4,9,9,0,18,3.1375901875901877,19,11
"['11110', '001000', '01111', '1100011', '110', '0100']",1,6,14,16,2,30,8.242873792873793,49,45
"['101', '1110']",1,2,2,5,0,7,0.5714285714285714,2,2
"['1', '0100100', '011001']",1,3,8,6,0,14,1.304945054945055,14,5
"['01', '100', '010000']",1,3,8,3,0,11,1.5666666666666667,9,8
"['0', '001', '00101', '0111']",1,4,7,6,0,13,3.2214285714285715,15,15
"['00111', '101', '1101011']",1,3,5,10,0,15,1.7666666666666666,10,10
"['01', '110', '000']",1,3,5,3,2,8,1.1333333333333333,6,6
"['0010', '1']",1,2,3,2,0,5,0.4,3,0
"['00111', '010', '1110']",1,3,5,7,0,12,1.7380952380952381,8,9
"['1111101', '1']",1,2,1,7,0,8,0.25,6,4
"['01', '001', '0000']",1,3,7,2,0,9,1.7047619047619047,6,9
"['11001', '00101', '101111']",1,3,6,10,2,16,1.690909090909091,9,10
"['01', '101', '1000', '0011100']",1,4,9,7,0,16,3.0946608946608944,20,14
"['1110110', '1']",1,2,2,6,0,8,0.25,6,2
"['0110111', '0000']",1,2,6,5,0,11,0.36363636363636365,5,2
"['10111', '1100000', '1010101']",1,3,9,10,2,19,1.7380952380952381,11,11
"['00110', '00011', '110101']",1,3,8,8,2,16,1.8909090909090909,9,6
"['1000100', '001101', '11', '1001', '00', '1011011']",1,6,14,14,4,28,8.121700521700522,52,42
"['10001', '10110', '011001', '1101', '01000', '0100']",1,6,16,13,5,29,10.281818181818181,35,37
"['0', '0001', '1010100']",1,3,8,4,0,12,1.0136363636363637,13,7
"['1010101', '0000']",1,2,7,4,0,11,0.5454545454545454,4,0
"['000100', '110', '111010', '111011']",1,4,9,12,3,21,3.444444444444444,20,19
"['101100', '11', '1000000', '1000', '01011', '01000']",1,6,18,11,2,29,8.08938838938839,47,47
"['110', '011001']",1,2,4,5,0,9,0.6666666666666666,3,2
"['00110', '1001', '0101100', '00000']",1,4,14,7,2,21,3.423232323232323,17,17
"['11110', '01101', '11011', '00001', '0001100', '01110', '110101']",1,7,17,21,5,38,12.306293706293706,59,57
"['101', '1100']",1,2,3,4,0,7,0.5714285714285714,2,2
['1010101'],1,1,3,4,0,7,0,0,0
['00000'],1,1,5,0,0,5,0,0,0
"['110000', '010', '0001', '011101', '011111', '1101', '101110']",1,7,15,20,6,35,11.731746031746031,64,57
"['0', '011001']",1,2,4,3,0,7,0.2857142857142857,5,2
"['1001110', '010', '011100', '10001', '11111', '000111']",1,6,14,18,4,32,8.396542346542347,49,35
"['010100', '000110', '0101111', '101101', '101010', '100', '1110101', '00', '0100']",1,9,24,23,6,47,22.483583083583085,112,104
"['11100', '01', '1101101', '1011001']",1,4,8,13,2,21,3.5317460317460316,21,18
"['0010001', '11010', '010010', '000010', '01010']",1,5,19,10,4,29,6.5762237762237765,23,43
"['111', '001101', '0110110', '100010']",1,4,10,12,2,22,3.6085470085470086,20,11
"['01', '0011001', '0101011', '10000', '111000']",1,5,15,12,2,27,4.80022755022755,39,27
"['011', '111', '10011']",1,3,3,8,2,11,1.9166666666666665,5,14
"['010', '1001', '011', '11']",1,4,5,7,2,12,3.676190476190476,11,13
"['001', '011100', '0110', '10', '111101']",1,5,9,12,2,21,5.593650793650793,29,23
"['0010001', '101', '0010010', '10', '000000', '1010011', '0110010']",1,7,25,14,4,39,11.678571428571429,71,57
"['11110', '110', '0000']",1,3,6,6,0,12,1.257936507936508,9,9
"['0100011', '0101', '100', '1001010']",1,4,12,9,2,21,3.7974025974025976,19,16
"['0101', '00011']",1,2,5,4,0,9,0.6666666666666666,2,2
"['11', '0101000', '101', '0111100']",1,4,9,10,2,19,3.403174603174603,22,10
"['110011', '100', '111']",1,3,4,8,2,12,1.6666666666666665,8,12
"['0010', '001000', '00100', '1100010', '111110', '000001', '01010', '01001', '011010', '0000110']",1,10,36,21,9,57,27.92019092019092,123,181
"['01101', '010', '100001', '011011', '00110']",1,5,13,12,4,25,6.456565656565656,28,26
"['10101', '1000', '1100', '111']",1,4,7,9,2,16,3.6904761904761902,12,18
"['101100', '01111']",1,2,4,7,0,11,0.5454545454545454,3,2
"['0001', '111101', '000']",1,3,7,6,0,13,1.4793650793650794,10,9
"['1011001', '111010', '0011', '100100', '1101', '0100']",1,6,15,16,5,31,9.015617715617715,43,38
"['111', '00011', '100', '0010011', '0100101', '0100']",1,6,16,13,4,29,9.098989898989899,43,45
"['01', '111111', '1011001', '10']",1,4,5,12,2,17,2.3504273504273505,25,16
"['0010110', '010', '111100', '11', '10010', '0110010']",1,6,15,15,2,30,8.602414252414253,50,45
"['11000', '010011']",1,2,6,5,0,11,0.5454545454545454,3,3
"['11', '0001', '0101011', '10010', '000', '001100']",1,6,16,11,0,27,8.014158064158064,46,40
"['00', '0111010']",1,2,5,4,0,9,0.4444444444444444,5,4
"['011011', '1110001']",1,2,5,8,0,13,0.6153846153846154,3,3
['011010'],1,1,3,3,0,6,0,0,0
"['1101000', '0110', '100011', '000001', '10']",1,5,15,10,2,25,5.1501554001554,38,23
"['10001', '11']",1,2,3,4,0,7,0.5714285714285714,3,4
"['1', '011', '1001', '1010', '1000']",1,5,8,8,3,16,5.378571428571428,22,26
['01100'],1,1,3,2,0,5,0,0,0
"['11010', '00111', '10111', '0110', '0000']",1,5,11,12,5,23,5.611111111111111,26,26
"['1011', '11']",1,2,1,5,0,6,0.6666666666666666,2,6
"['1', '10110']",1,2,2,4,0,6,0.3333333333333333,4,2
"['0', '101']",1,2,2,2,0,4,0.5,2,0
"['10100', '101', '0110010']",1,3,8,7,0,15,2.0166666666666666,10,6
"['10111', '01011', '11']",1,3,3,9,2,12,1.9428571428571428,8,13
"['00100', '001100']",1,2,8,3,0,11,0.9090909090909091,1,10
"['0', '0010', '0101110', '0111011', '1101000', '001001']",1,6,17,15,3,32,7.575374625374625,59,44
"['01001', '01010']",1,2,6,4,2,10,0.8,2,4
"['00', '01111', '0110']",1,3,5,6,0,11,1.619047619047619,8,10
"['0', '10111', '01001']",1,3,5,6,2,11,1.2666666666666666,11,4
"['000110', '01', '00101', '111', '11000', '0001111', '10', '000000', '00010', '001001']",1,10,29,18,8,47,24.20971805971806,150,150
['0010010'],1,1,5,2,0,7,0,0,0
"['0', '1011101', '010']",1,3,5,6,0,11,1.15,12,4
"['001', '1']",1,2,2,2,0,4,0.5,2,2
"['1', '01000']",1,2,4,2,0,6,0.3333333333333333,4,0
"['111', '110100', '111001']",1,3,5,10,2,15,2.0,8,15
['1101001'],1,1,3,4,0,7,0,0,0
"['010', '1101011', '011000', '0001101', '10', '0110011']",1,6,16,16,3,32,9.242857142857142,55,40
"['101', '110', '111101']",1,3,3,9,2,12,2.0,8,11
"['11', '1101110', '0111', '000', '1100']",1,5,8,12,2,20,4.98946608946609,31,30
"['001111', '1010111', '1010', '000', '110', '0110110']",1,6,13,17,4,30,8.472372072372073,48,41
"['11110', '01001', '01000']",1,3,8,7,3,15,1.6,8,9
"['101100', '100101', '100010']",1,3,10,8,3,18,1.8333333333333335,7,10
['1100100'],1,1,4,3,0,7,0,0,0
"['001100', '10']",1,2,5,3,0,8,0.5,4,2
"['101', '100']",1,2,3,3,2,6,0.6666666666666666,1,3
"['101', '010', '0100']",1,3,6,4,2,10,2.095238095238095,5,6
"['001', '1', '0100010', '101', '110001', '10000', '10010']",1,7,18,12,4,30,12.392823842823843,60,54
"['0010', '010']",1,2,5,2,0,7,0.8571428571428571,1,6
"['11011', '11']",1,2,1,6,0,7,0.5714285714285714,3,8
"['0011', '001', '1111000']",1,3,7,7,0,14,1.6207792207792209,11,11
"['10111', '1001000', '10100', '00', '100101', '111111']",1,6,14,17,4,31,7.311843711843712,50,49
"['01011', '111', '000']",1,3,5,6,2,11,1.0,8,6
"['01', '000000']",1,2,7,1,0,8,0.25,5,2
"['1111001', '0100']",1,2,5,6,0,11,0.5454545454545454,4,0
"['00110', '00000']",1,2,8,2,2,10,0.6,2,6
"['0110010', '1101', '1110', '11']",1,4,6,11,2,17,3.80050505050505,17,16
"['0', '0011', '001001']",1,3,7,4,0,11,1.4857142857142858,10,8
"['010', '11', '10111', '000', '1011000', '0101001']",1,6,14,13,4,27,7.5246031746031745,51,37
"['0000101', '11010', '10', '111']",1,4,8,9,0,17,3.0658730158730156,21,15
"['0000101', '110001', '10000', '00001']",1,4,16,7,2,23,4.36993006993007,14,27
"['101100', '11010', '01', '011', '100100', '110']",1,6,12,13,4,25,8.864862914862915,40,39
"['00111', '1111', '1110101', '1010', '000', '0101']",1,6,11,16,3,27,8.252453102453103,42,43
"['01000', '011', '0111', '11']",1,4,6,8,0,14,3.5539682539682538,14,19
"['11010', '001', '011001', '001000', '100', '0000', '0101']",1,7,20,11,6,31,12.81955266955267,51,65
"['111000', '001010']",1,2,7,5,2,12,0.5,3,3
['1111001'],1,1,2,5,0,7,0,0,0
"['011', '0010101']",1,2,5,5,0,10,0.6,4,2
"['0110010', '00', '0110', '1111']",1,4,8,9,2,17,2.8838383838383836,20,16
"['1110111', '11110', '0111010', '001', '00001', '1101100', '0011111']",1,7,16,25,6,41,10.857142857142858,77,65
"['110000', '1011', '00', '00110']",1,4,10,7,0,17,3.016883116883117,20,16
"['10101', '1111101', '0011100']",1,3,7,12,2,19,1.5714285714285714,10,6
"['0110101', '1000', '010101', '111110', '10']",1,5,11,14,2,25,5.374514374514375,34,27
"['01101', '0001110', '1001011', '11']",1,4,9,12,2,21,3.341269841269841,23,12
"['1000000', '11110']",1,2,7,5,0,12,0.3333333333333333,5,2
"['10000', '1100100', '00', '100111', '111000']",1,5,15,11,2,26,6.006549006549006,33,34
"['110011', '1']",1,2,2,5,0,7,0.2857142857142857,5,4
"['001', '11', '10101', '0010100', '00110']",1,5,12,10,2,22,5.737301587301587,29,25
"['11000', '01', '110']",1,3,5,5,0,10,1.4357142857142857,8,8
"['010', '0011010', '1111']",1,3,6,8,0,14,1.431168831168831,11,6
"['11101', '100000']",1,2,6,5,0,11,0.36363636363636365,4,2
"['000100', '10', '1100110']",1,3,9,6,0,15,1.5598290598290598,12,7
"['0101', '1', '011', '0000100']",1,4,9,6,0,15,2.9525974025974024,21,11
"['0001110', '11']",1,2,4,5,0,9,0.4444444444444444,5,0
"['0', '1101', '11']",1,3,2,5,0,7,1.0666666666666667,7,6
"['0111000', '10', '000']",1,3,8,4,0,12,1.4444444444444444,11,12
"['0001', '1', '1110100']",1,3,6,6,0,12,1.0136363636363637,14,7
"['10001', '0101100', '11']",1,3,7,7,0,14,1.5158730158730158,12,4
"['010', '111', '10000', '1001101', '0001111', '1010', '00']",1,7,16,15,4,31,11.095598845598845,68,54
"['001101', '11']",1,2,3,5,0,8,0.5,4,2
"['100011', '001010']",1,2,7,5,2,12,0.6666666666666666,3,0
"['00100', '10101', '01101']",1,3,8,7,3,15,1.7999999999999998,6,6
"['01101', '101', '100', '111001']",1,4,7,10,2,17,3.977272727272727,14,19
"['10101', '111']",1,2,2,6,0,8,0.75,2,4
"['0100001', '0101', '1101111', '1000001']",1,4,13,12,3,25,3.3506493506493507,21,22
"['1001', '0110']",1,2,4,4,2,8,0.5,3,0
"['10101', '010101', '01000', '11']",1,4,9,9,2,18,3.5935064935064935,17,16
"['0110000', '111110', '1']",1,3,6,8,0,14,0.9972527472527473,15,4
"['110000', '11011', '0111010', '011', '1000', '100111', '0011100']",1,7,18,20,4,38,12.694100344100343,70,59
"['1011', '00', '1100', '10010']",1,4,8,7,2,15,3.4047619047619047,15,14
"['00100', '1100', '1']",1,3,6,4,0,10,1.4,9,7
"['101', '1', '0101001']",1,3,5,6,0,11,1.35,12,9
"['010001', '10100', '100000', '011010', '110']",1,5,16,10,3,26,5.722222222222222,31,24
"['00100', '11']",1,2,4,3,0,7,0.2857142857142857,4,0
['1010011'],1,1,3,4,0,7,0,0,0
"['1000001', '0101010', '10']",1,3,10,6,2,16,1.4603174603174602,14,6
"['010100', '10111', '0']",1,3,6,6,0,12,1.1645021645021645,12,4
"['00111', '00', '110', '1011111']",1,4,6,11,0,17,2.7603174603174603,22,16
"['011', '101', '0001', '0101011', '11111']",1,5,8,14,2,22,4.928715728715728,30,30
"['10100', '00', '1']",1,3,5,3,0,8,0.9047619047619047,9,6
"['01', '010', '10000']",1,3,7,3,0,10,1.5857142857142859,8,7
"['01111', '110', '1111110']",1,3,3,12,0,15,1.7666666666666666,10,13
"['101100', '1', '1001', '0101', '0101001']",1,5,11,11,2,22,5.50949050949051,34,31
"['0110000', '1001', '000', '11']",1,4,10,6,0,16,2.827994227994228,20,12
"['0001100', '1']",1,2,5,3,0,8,0.25,6,0
['0011000'],1,1,5,2,0,7,0,0,0
"['01', '01111']",1,2,2,5,0,7,0.5714285714285714,3,3
"['100', '110', '10011']",1,3,5,6,2,11,1.9166666666666665,6,9
"['00', '100']",1,2,4,1,0,5,0.8,1,4
"['01101', '011', '111', '1010', '1100']",1,5,7,12,4,19,6.535714285714286,21,27
"['11011', '001', '11', '100', '000001']",1,5,10,9,2,19,4.762842712842713,31,31
['01000'],1,1,4,1,0,5,0,0,0
"['01', '011', '10001', '10010', '000001']",1,5,13,8,2,21,5.96002886002886,28,28
"['110010', '0010', '000', '00001']",1,4,13,5,0,18,4.2859307359307355,13,24
"['0', '0001', '1101011']",1,3,6,6,0,12,1.0136363636363637,13,4
"['1001110', '01', '010', '011', '0110000', '1111010', '0100']",1,7,17,16,5,33,12.57056277056277,70,66
"['1001110', '1000101', '0100010', '0110', '00', '001110', '01001', '000111', '110']",1,9,26,21,5,47,22.59066489066489,111,109
"['010', '00011']",1,2,5,3,0,8,0.5,3,2
"['1001100', '0011', '111', '01110']",1,4,8,11,0,19,3.782034632034632,16,13
"['10000', '011']",1,2,5,3,0,8,0.25,4,2
"['01', '011110']",1,2,3,5,0,8,0.5,4,3
['011001'],1,1,3,3,0,6,0,0,0
"['0110101', '111', '110001', '0011010', '010011', '111001']",1,6,15,20,5,35,9.693894993894993,42,46
"['001', '100001', '1000101', '0001', '011110', '1011']",1,6,16,14,4,30,8.876512376512377,45,46
"['0001', '1001', '001111']",1,3,7,7,2,14,1.95,8,9
"['0100010', '000110', '1']",1,3,9,5,0,14,1.304945054945055,13,5
"['00111', '0001', '11']",1,3,5,6,0,11,1.5714285714285714,8,9
"['1100', '010111', '01011', '11']",1,4,6,11,0,17,3.4916305916305914,17,25
"['0', '1']",1,2,1,1,2,2,0.0,1,0
['0101'],1,1,2,2,0,4,0,0,0
"['0', '0111001', '11011', '1111', '10']",1,5,6,13,0,19,4.715367965367966,33,22
"['1100001', '001', '1', '10']",1,4,7,6,0,13,2.861111111111111,20,16
"['1100000', '1000000', '00', '111110', '00010']",1,5,18,9,2,27,5.033660783660784,38,38
"['0011', '0101', '000']",1,3,7,4,2,11,1.8928571428571428,6,8
"['0011', '01001', '000101', '1010011']",1,4,12,10,0,22,4.523776223776224,14,17
"['0', '0010111', '1100100']",1,3,8,7,2,15,1.0714285714285714,17,8
"['010', '0110']",1,2,4,3,0,7,0.8571428571428571,1,6
"['010', '001101', '00101', '10110', '1111', '100011', '10011', '0100100', '1011']",1,9,21,24,7,45,22.97983127983128,94,101
"['1100011', '1001110', '1101100']",1,3,9,12,3,21,1.7142857142857142,9,9
"['1001', '000']",1,2,5,2,0,7,0.5714285714285714,2,0
"['0', '011011']",1,2,3,4,0,7,0.2857142857142857,5,2
['0101000'],1,1,5,2,0,7,0,0,0
"['0100', '10', '000', '1010001', '1101010']",1,5,14,9,2,23,5.895815295815296,32,22
"['110', '01011']",1,2,3,5,0,8,0.5,3,3
"['11', '0110', '10010', '000', '1100111', '1100']",1,6,12,13,2,25,8.664790764790764,42,39
"['011', '01100']",1,2,4,4,0,8,0.75,2,4
"['1011110', '1111000', '1000111']",1,3,8,13,3,21,2.0,12,9
"['0', '100']",1,2,3,1,0,4,0.5,2,2
['01011'],1,1,2,3,0,5,0,0,0
"['101', '01', '01110']",1,3,4,6,0,10,1.8714285714285714,7,6
"['000110', '0010', '010001', '000011', '10100']",1,5,18,9,3,27,6.454545454545455,27,30
"['00100', '0001100', '10', '000', '101111']",1,5,14,9,0,23,5.146603396603396,35,36
"['000110', '01', '0001001', '0110100', '00', '110', '111101']",1,7,18,15,6,33,10.683089133089133,76,60
"['1000', '0000001']",1,2,9,2,0,11,0.5454545454545454,4,4
"['1010000', '0100000', '010', '0001']",1,4,16,5,2,21,3.7194805194805194,20,23
"['0101', '1001']",1,2,4,4,2,8,0.5,2,3
"['00', '1001011']",1,2,5,4,0,9,0.4444444444444444,5,0
"['00100', '01', '001000', '1111']",1,4,10,7,0,17,2.736075036075036,20,17
"['1100001', '011', '000010']",1,3,10,6,0,16,1.6136752136752137,12,5
"['00', '001011', '1011000']",1,3,9,6,0,15,1.5598290598290598,13,11
"['0', '0000011']",1,2,6,2,0,8,0.25,6,2
"['00', '111']",1,2,2,3,0,5,0.0,3,0
"['01', '11110', '101000', '0001100', '10100', '100011', '1101010']",1,7,20,18,6,38,11.835175935175934,67,57
"['0011', '000011', '1111']",1,3,6,8,2,14,1.7000000000000002,8,14
"['11010', '10101']",1,2,4,6,2,10,0.8,2,2
['00010'],1,1,4,1,0,5,0,0,0
"['101100', '1', '1010', '0000', '0100101']",1,5,13,9,2,22,4.188161838161838,34,22
"['111', '00111', '0001', '01111', '10000', '10110', '10']",1,7,13,16,4,29,10.405555555555555,59,60
"['111', '00010', '000111', '01110', '011000']",1,5,13,12,4,25,5.938383838383839,30,34
"['10110', '01100']",1,2,5,5,2,10,0.8,2,2
"['01001', '1']",1,2,3,3,0,6,0.3333333333333333,4,2
"['0101', '01000']",1,2,6,3,0,9,0.6666666666666666,2,4
"['101', '10001', '100', '0000000', '1010', '01011']",1,6,17,10,4,27,8.861255411255412,44,39
"['0110100', '000', '1101', '000111', '01110']",1,5,13,12,0,25,6.0223110223110226,32,30
"['1110101', '10111', '00', '1100010']",1,4,9,12,2,21,2.888888888888889,24,14
"['0011', '1110011', '100001']",1,3,8,9,0,17,1.9426573426573426,9,12
"['00', '11100', '10011', '0111']",1,4,7,9,2,16,3.4095238095238094,18,16
"['1011', '00101', '1100100']",1,3,8,8,0,16,1.8787878787878787,9,8
"['001', '1', '101011', '1111000', '1000010', '10010', '0000', '011000']",1,8,23,16,4,39,14.541985791985791,99,76
"['101010', '111111']",1,2,3,9,2,12,0.5,3,2
"['010100', '01', '011100', '0111101', '0011100']",1,5,14,14,4,28,6.513431013431013,29,46
"['1100010', '1']",1,2,4,4,0,8,0.25,6,2
"['001', '11']",1,2,2,3,0,5,0.4,2,2
"['110', '1111011']",1,2,2,8,0,10,0.6,4,4
"['1010011', '0111', '00011']",1,3,7,9,0,16,2.0454545454545454,7,11
"['0111', '01000']",1,2,5,4,0,9,0.4444444444444444,3,3
"['0010100', '0101001']",1,2,9,5,2,14,0.8571428571428571,2,2
"['101', '1011101', '0100110', '00000']",1,4,12,10,2,22,2.9976190476190476,23,12
"['01', '100100', '1001000', '1111', '0000111']",1,5,14,12,2,26,4.844499944499945,40,33
"['0001100', '110', '1']",1,3,6,5,0,11,1.35,12,4
"['010000', '1', '000']",1,3,8,2,0,10,0.9523809523809523,11,8
"['01', '110']",1,2,2,3,0,5,0.4,2,2
"['1000000', '001001', '111', '00001']",1,4,14,7,0,21,2.568104118104118,21,19
"['0001', '1011', '110', '01100', '1110']",1,5,9,11,3,20,5.492063492063492,24,24
"['10100', '0111101', '010']",1,3,7,8,0,15,1.85,10,7
"['01101', '010', '1']",1,3,4,5,0,9,1.5833333333333333,8,5
"['0', '1100101', '00001']",1,3,8,5,0,13,1.0833333333333333,13,5
"['10111', '01', '01110', '100010']",1,4,8,10,2,18,3.533766233766234,18,13
"['101', '1', '1101100']",1,3,4,7,0,11,1.35,12,8
"['0001101', '0110']",1,2,6,5,0,11,0.7272727272727273,3,2
"['01', '0001']",1,2,4,2,0,6,0.6666666666666666,2,3
"['1010110', '1101']",1,2,4,7,0,11,0.5454545454545454,3,2
"['10', '000001', '001000']",1,3,11,3,2,14,1.25,11,9
"['0010', '111100', '10010', '01010', '1001100']",1,5,15,12,2,27,6.642968142968143,25,37
"['1', '000010']",1,2,5,2,0,7,0.2857142857142857,5,0
"['1110010', '10000', '0001000']",1,3,13,6,2,19,1.9047619047619047,10,10
"['1011011', '000']",1,2,5,5,0,10,0.4,5,0
"['11010', '010', '0011', '1010', '01010', '1000011']",1,6,15,13,4,28,9.623520923520923,37,51
"['11000', '01010']",1,2,6,4,2,10,0.6,2,2
"['110000', '0110100', '011', '1100001', '0110000']",1,5,18,12,3,30,7.088400488400488,28,39
"['0', '11110']",1,2,2,4,0,6,0.3333333333333333,4,2
"['011010', '001', '1101010']",1,3,8,8,0,16,1.6136752136752137,9,9
"['0010110', '111', '00', '10', '01010']",1,5,10,9,2,19,4.665079365079365,31,25
"['1110011', '0000100', '11']",1,3,8,8,2,16,1.0952380952380951,16,8
['000001'],1,1,5,1,0,6,0,0,0
"['111010', '01110']",1,2,4,7,0,11,0.7272727272727273,2,3
"['0001', '111101']",1,2,4,6,0,10,0.4,4,3
"['00', '11']",1,2,2,2,2,4,0.0,2,0
"['00010', '110001', '00101']",1,3,10,6,2,16,2.0727272727272728,8,6
"['100110', '01', '1110']",1,3,5,7,0,12,1.6333333333333333,9,8
"['0010', '0011100']",1,2,7,4,0,11,0.7272727272727273,3,7
"['1', '1010011']",1,2,3,5,0,8,0.25,6,4
"['1000', '010111']",1,2,5,5,0,10,0.4,4,2
"['01', '010', '0110100']",1,3,7,5,0,12,1.8444444444444446,10,11
"['00', '1']",1,2,2,1,0,3,0.0,2,0
"['1101', '100', '010101', '11']",1,4,6,9,0,15,3.4047619047619047,15,18
"['010100', '00001', '00000', '1111001', '011101', '0100001', '1101', '0100']",1,8,26,18,8,44,15.660550560550561,78,95
"['100101', '01', '1100000', '000101']",1,4,13,8,2,21,3.286324786324786,22,20
"['1101', '010', '10010']",1,3,6,6,0,12,1.9880952380952381,6,6
"['1010110', '100001', '000101', '00', '10', '1011100']",1,6,17,13,6,30,7.812576312576312,56,42
"['11001', '0', '011', '0111011', '101']",1,5,7,12,2,19,5.366666666666666,32,25
"['101011', '010']",1,2,4,5,0,9,0.6666666666666666,3,0
"['0010', '010', '1001101', '0111101', '111000', '110']",1,6,14,16,4,30,9.424131424131424,48,38
"['00110', '0010', '11']",1,3,6,5,0,11,1.7936507936507935,7,7
"['101011', '011001', '0001010', '110', '1111011']",1,5,12,17,4,29,5.501221001221001,33,26
"['110000', '0011000', '11', '00111', '101', '1001', '110']",1,7,15,15,2,30,12.6005439005439,64,62
"['01', '00', '0100011']",1,3,7,4,2,11,1.3888888888888888,11,7
['1101011'],1,1,2,5,0,7,0,0,0
"['110', '010110', '111011']",1,3,5,10,2,15,2.0,9,8
"['1110001', '001010', '000000', '1011111']",1,4,14,12,4,26,2.7765567765567765,24,12
"['01', '010', '01111', '000101', '011110']",1,5,10,12,2,22,6.159307359307359,29,33
"['1010000', '1000', '010', '011']",1,4,11,6,2,17,3.2510822510822512,18,16
"['01', '111', '0011', '1011111', '0100']",1,5,7,13,2,20,5.044011544011544,32,27
"['100', '1']",1,2,2,2,0,4,0.5,2,2
"['00', '111110']",1,2,3,5,0,8,0.25,5,2
"['10010', '000']",1,2,6,2,0,8,0.75,2,2
"['0', '0110001', '1000111']",1,3,8,7,2,15,1.2142857142857144,16,4
"['011101', '0010', '11']",1,3,5,7,0,12,1.4333333333333333,10,4
"['00', '0101', '0110111', '1110']",1,4,7,10,2,17,3.217171717171717,20,15
"['0000111', '1', '010100', '011110']",1,4,10,10,2,20,2.411172161172161,26,12
"['111', '0101011', '0110', '100000', '10', '01000']",1,6,15,12,0,27,7.493789543789544,49,38
"['0', '0101101', '110']",1,3,5,6,0,11,1.35,12,6
"['1010110', '1111000']",1,2,6,8,2,14,0.7142857142857143,4,2
"['000101', '11']",1,2,4,4,0,8,0.5,4,2
"['0', '1111010', '1111011']",1,3,4,11,2,15,1.3571428571428572,13,10
['110010'],1,1,3,3,0,6,0,0,0
"['1000110', '0001', '110011', '1011', '110101']",1,5,12,15,4,27,6.6186480186480185,26,35
"['0011011', '0001', '111']",1,3,6,8,0,14,1.431168831168831,10,9
"['1', '00000']",1,2,5,1,0,6,0.0,5,0
"['0', '10001', '0101000', '001110']",1,4,12,7,0,19,2.6965534465534464,25,13
"['11', '01100', '0000']",1,3,7,4,0,11,1.0158730158730158,9,6
"['010', '010001', '111', '00001', '100', '1001', '10011', '011111']",1,8,17,18,7,35,15.845454545454546,75,82
"['101100', '001101', '001110', '10', '0100001']",1,5,15,12,3,27,5.64957264957265,35,28
"['0', '001', '110']",1,3,4,3,2,7,1.3333333333333333,7,6
['101011'],1,1,2,4,0,6,0,0,0
"['110', '111']",1,2,1,5,2,6,0.6666666666666666,1,4
"['1001100', '0011']",1,2,6,5,0,11,0.7272727272727273,3,3
"['0110101', '00110', '00010', '0']",1,4,11,7,2,18,3.05,21,20
"['01', '011100', '11', '00001', '100', '10000']",1,6,14,9,4,23,7.354329004329005,45,41
"['0110010', '0111100']",1,2,7,7,2,14,0.7142857142857143,3,6
"['0011', '111111', '00010', '010010']",1,4,10,11,2,21,3.090909090909091,19,16
"['0000111', '101000', '01011', '0']",1,4,11,8,0,19,2.5427072927072927,26,15
"['11010', '11', '1000110', '000', '11100']",1,5,11,11,2,22,4.987301587301587,33,26
"['11110', '00', '000111', '110111']",1,4,7,12,2,19,2.7932900432900434,21,21
"['101010', '1001']",1,2,5,5,0,10,0.8,2,3
"['11100', '0110', '1']",1,3,4,6,0,10,1.4,9,4
"['101011', '00', '1110', '01110']",1,4,7,10,0,17,3.239105339105339,17,14
"['01', '0000000']",1,2,8,1,0,9,0.2222222222222222,6,2
"['00100', '110001', '001100']",1,3,11,6,2,17,2.121212121212121,9,10
"['110', '01100']",1,2,4,4,0,8,0.75,2,2
"['0111000', '11010', '100100', '1111010', '0111', '1101']",1,6,14,19,4,33,9.773337773337774,43,45
"['11001', '01', '10', '1111011']",1,4,5,11,2,16,3.198412698412698,21,17
"['00', '0110']",1,2,4,2,0,6,0.6666666666666666,2,4
"['0', '100', '110']",1,3,4,3,2,7,1.6666666666666665,5,6
"['0', '101101']",1,2,3,4,0,7,0.2857142857142857,5,0
['1001010'],1,1,4,3,0,7,0,0,0
"['101', '0100101', '01110']",1,3,7,8,0,15,1.7666666666666666,10,7
"['1001', '001111', '10', '011110']",1,4,7,11,2,18,3.25,21,12
"['0', '1011101', '000101', '011000']",1,4,11,9,2,20,2.3983516483516483,26,14
"['0101111', '110']",1,2,3,7,0,10,0.4,5,3
"['010', '100', '011']",1,3,5,4,3,9,1.6666666666666665,6,7
"['00111', '01', '00']",1,3,5,4,2,9,1.6428571428571428,7,8
"['100110', '10101', '000110']",1,3,9,8,2,17,1.9242424242424243,8,9
"['0', '0000010', '00011']",1,3,10,3,0,13,1.25,13,10
['0000010'],1,1,6,1,0,7,0,0,0
"['01101', '0001110', '1111000', '1000', '000']",1,5,15,11,2,26,6.012409812409812,35,41
"['1000110', '00', '0010010', '1101', '0111110', '0100']",1,6,17,14,5,31,7.963203463203463,55,44
"['0011', '01', '1010010', '0111']",1,4,8,9,2,17,3.6186868686868685,18,14
"['1011001', '0101', '100', '11111']",1,4,7,12,0,19,2.9113275613275613,19,16
"['0', '10001']",1,2,4,2,0,6,0.3333333333333333,4,0
"['1000110', '01', '010', '011']",1,4,8,7,2,15,3.7111111111111112,16,16
"['1', '100', '010111', '01110']",1,4,6,9,0,15,2.790764790764791,20,11
"['1110', '1001101']",1,2,4,7,0,11,0.7272727272727273,3,2
"['01', '100', '1001', '1010111', '000']",1,5,10,9,2,19,5.733621933621934,27,25
"['0010', '1110000', '00000', '101', '1111001']",1,5,15,11,2,26,5.293290043290043,36,28
"['0001010', '1011101', '10000']",1,3,11,8,2,19,1.7380952380952381,11,7
"['0011', '101', '1111001', '0010011', '100010', '100011', '1000011']",1,7,20,20,5,40,14.245787545787547,63,93
"['0', '1110010', '101', '01001', '01011']",1,5,10,11,2,21,5.483333333333333,32,22
"['00', '100', '01100', '11']",1,4,7,5,2,12,3.092857142857143,13,16
"['010', '100', '1001']",1,3,6,4,2,10,2.095238095238095,6,6
"['101', '001001', '001010']",1,3,9,6,2,15,2.1666666666666665,8,8
"['0011', '11111']",1,2,2,7,0,9,0.4444444444444444,3,4
"['1001110', '01110']",1,2,5,7,0,12,0.8333333333333334,2,6
"['0011', '001101', '1011000']",1,3,9,8,0,17,1.9608391608391609,9,11
"['00010', '0100100', '011001']",1,3,12,6,0,18,2.3298368298368297,8,10
"['10', '011110', '1101010']",1,3,6,9,0,15,1.4059829059829059,12,9
"['101011', '101']",1,2,3,6,0,9,0.6666666666666666,3,6
"['01', '001010']",1,2,5,3,0,8,0.5,4,2
"['010', '001111', '0110110']",1,3,7,9,0,16,1.8136752136752137,11,10
"['0010', '111010', '10110', '1000', '000']",1,5,13,9,2,22,6.669336219336219,23,34
"['001010', '10', '01110']",1,3,7,6,0,13,1.7987012987012987,9,11
"['1101', '001', '10010', '0111']",1,4,7,9,2,16,3.753968253968254,13,14
"['101101', '01000', '11']",1,3,6,7,0,13,1.331168831168831,11,4
"['1100010', '1', '000011']",1,3,8,6,0,14,1.151098901098901,14,7
"['01', '00000', '111111', '0011111', '0000111']",1,5,12,15,2,27,4.369658119658119,41,41
"['001011', '10000']",1,2,7,4,0,11,0.5454545454545454,4,3
"['1110000', '100', '1010111', '001110', '10']",1,5,12,13,2,25,5.646520146520147,39,27
"['01', '111010', '10110', '10']",1,4,6,9,2,15,3.37012987012987,18,16
"['0', '0011011', '0110']",1,3,6,6,0,12,1.3772727272727274,12,8
"['110011', '00110', '0010', '0001']",1,4,11,8,2,19,4.232828282828283,14,15
"['0001011', '0110000', '011', '000000']",1,4,16,7,2,23,3.2244200244200245,23,30
"['1010', '1001000']",1,2,7,4,0,11,0.7272727272727273,3,3
"['11011', '010', '111', '101010', '00010', '011010', '1110']",1,7,14,18,6,32,12.583621933621933,50,66
"['011101', '010', '1010011']",1,3,7,9,0,16,1.7282051282051283,11,5
"['001', '00111', '010101', '011110', '0011100']",1,5,13,14,2,27,6.578049728049728,27,34
"['001', '00000', '10111', '010111', '001100']",1,5,14,11,4,25,5.523232323232323,29,31
"['110000', '011', '0001111', '1111', '0000', '1000011', '1101']",1,7,17,18,5,35,11.09079809079809,71,80
"['010100', '11']",1,2,4,4,0,8,0.5,4,0
"['01', '110', '0110']",1,3,4,5,0,9,1.9238095238095236,5,9
"['00', '001']",1,2,4,1,0,5,0.8,1,4
['11011'],1,1,1,4,0,5,0,0,0
"['01011', '111']",1,2,2,6,0,8,0.5,2,4
"['011', '0011000', '00110', '01001', '10011', '0110010']",1,6,18,14,5,32,10.673809523809524,40,42
"['0', '0010110', '00010']",1,3,9,4,0,13,1.25,12,14
"['010', '100001', '010001', '0010111', '0001', '0001111']",1,6,19,14,4,33,9.553435453435453,47,46
"['00011', '11', '100', '0000001', '01010', '101001']",1,6,17,11,2,28,8.251676101676102,49,37
['011101'],1,1,2,4,0,6,0,0,0
"['10011', '0100']",1,2,5,4,0,9,0.6666666666666666,3,0
"['1010', '0101', '01111']",1,3,5,8,2,13,1.8611111111111112,7,7
"['0000111', '10']",1,2,5,4,0,9,0.2222222222222222,6,2
"['1000011', '100101']",1,2,7,6,0,13,0.7692307692307693,2,6
"['010000', '001', '0100010', '100', '01010', '1010010', '01000', '011000']",1,8,29,13,8,42,19.94952824952825,67,120
"['1011', '01', '0111111']",1,3,3,10,0,13,1.6565656565656566,11,8
"['000110', '0101110', '1111001', '00', '1100101']",1,5,14,15,3,29,5.67948717948718,41,22
"['1010', '110', '1000111']",1,3,6,8,0,14,1.516883116883117,10,9
"['10111', '10110', '000101', '1']",1,4,7,10,2,17,2.843290043290043,20,17
"['00', '01101', '0001']",1,3,7,4,0,11,1.6825396825396823,7,9
"['01', '0110']",1,2,3,3,0,6,0.6666666666666666,2,3
"['101010', '101', '01001', '1']",1,4,7,8,0,15,3.262987012987013,19,17
"['01101', '110', '000010', '010111']",1,4,10,10,2,20,3.4116161616161618,18,15
"['0010110', '1111100', '010000', '1', '1100011']",1,5,14,14,3,28,4.4423076923076925,46,21
"['1000', '1001010']",1,2,7,4,0,11,0.7272727272727273,3,4
"['001101', '001', '011', '0111']",1,4,7,9,2,16,4.228571428571429,12,18
"['00111', '0110', '10000', '010111', '1011']",1,5,11,13,4,24,6.044949494949495,26,26
"['1101', '010']",1,2,3,4,0,7,0.5714285714285714,2,0
"['0', '10']",1,2,2,1,0,3,0.6666666666666666,1,2
"['110010', '0011', '111110', '01010', '0100011']",1,5,13,15,2,28,5.392773892773893,30,34
"['001100', '1100110']",1,2,7,6,0,13,0.7692307692307693,3,2
"['101100', '1', '00011', '00', '0101']",1,5,10,8,0,18,4.569264069264069,32,23
"['0110101', '00010', '110']",1,3,8,7,0,15,1.7666666666666666,10,7
"['0', '1000100', '11110', '1001101', '0100011']",1,5,14,13,3,27,4.559523809523809,42,21
['100101'],1,1,3,3,0,6,0,0,0
"['1', '0001', '110011', '01110', '1011111']",1,5,8,15,0,23,4.504634254634254,39,22
"['10100', '1100']",1,2,5,4,0,9,0.8888888888888888,1,4
"['110', '011']",1,2,2,4,2,6,0.6666666666666666,2,3
"['0000111', '0111']",1,2,5,6,0,11,0.7272727272727273,3,5
"['11011', '010001', '111', '0001', '001100', '111101']",1,6,13,17,3,30,8.153896103896104,46,47
"['0101010', '001', '1100', '01100']",1,4,11,8,0,19,3.739105339105339,16,20
"['1010111', '111111', '10']",1,3,3,12,0,15,1.1559829059829059,12,13
"['1000100', '0010', '1111000', '0111', '010011', '01011']",1,6,17,16,4,33,8.605927405927405,50,45
"['101100', '0001', '1001', '0110', '000001', '000000']",1,6,21,9,6,30,8.25,44,54
"['1010100', '001110']",1,2,7,6,0,13,0.3076923076923077,3,3
"['110001', '1100', '10', '111110']",1,4,7,11,2,18,3.5666666666666664,19,18
"['111', '10000', '0001101', '1001111', '1101010']",1,5,13,16,3,29,5.7404761904761905,36,33
"['1', '1110100', '011001']",1,3,6,8,0,14,1.151098901098901,14,6
"['101', '11011', '0101110', '000101']",1,4,9,12,0,21,3.844172494172494,18,12
"['01', '1', '0000011', '1100', '0100']",1,5,11,7,2,18,4.638383838383838,33,24
"['101', '10001', '010', '001111']",1,4,8,9,2,17,3.3510101010101008,19,12
"['0101', '01101', '100111', '001011']",1,4,9,12,2,21,4.394949494949495,13,16
"['101', '10', '1101100']",1,3,5,7,0,12,1.8444444444444446,10,7
"['010100', '010', '111010', '000011', '00100', '01110']",1,6,18,13,5,31,9.377777777777778,42,58
"['0010', '111101', '11']",1,3,4,8,0,12,1.2333333333333334,11,6
"['11', '00100', '0010101', '10', '0101']",1,5,11,9,2,20,5.806637806637807,29,25
"['01', '001011', '11']",1,3,4,6,2,10,1.5,9,8
"['0', '1110101', '0001', '011111']",1,4,7,11,0,18,2.4685814185814188,25,13
"['1011', '01', '10']",1,3,3,5,2,8,1.8333333333333333,6,7
"['0', '100000']",1,2,6,1,0,7,0.2857142857142857,5,2
"['1011', '001']",1,2,3,4,0,7,0.5714285714285714,2,2
"['11010', '0010', '1111', '0001100', '010111', '1010011', '1011']",1,7,16,21,5,37,12.50041625041625,60,61
"['111', '1110']",1,2,1,6,0,7,0.8571428571428571,1,6
"['000111', '010111', '1001101']",1,3,8,11,2,19,2.217948717948718,6,9
"['1000', '01111', '100111', '1011000']",1,4,10,12,0,22,3.2383061383061382,20,21
"['010001', '001011']",1,2,7,5,2,12,0.6666666666666666,3,2
"['01', '001', '100101']",1,3,6,5,0,11,1.9666666666666668,8,9
"['0', '1010001', '1101', '1011100']",1,4,9,10,2,19,2.705194805194805,25,13
"['010001', '00101']",1,2,7,4,0,11,0.7272727272727273,2,3
"['010001', '11', '0101', '110', '01000']",1,5,11,9,0,20,6.144011544011544,25,29
"['0', '000011', '0000101', '11101', '100101']",1,5,14,11,2,25,5.1046453546453545,36,31
"['0011001', '100110', '111111', '1011000', '011010']",1,5,14,18,5,32,6.06043956043956,30,21
"['0011000', '101011', '00', '1111111', '1011111']",1,5,10,19,3,29,4.133699633699634,41,33
"['0010110', '0000010', '110', '10']",1,4,12,7,2,19,3.2603174603174603,22,22
"['0010', '001101', '111', '101000', '1000']",1,5,13,10,4,23,5.732539682539683,29,28
"['011', '11', '0001', '110100', '0001010', '01100']",1,6,15,12,0,27,8.262787212787213,46,44
"['0010110', '0111010', '11', '1010111', '0000010', '01001', '00010']",1,7,22,18,6,40,11.441269841269841,71,58
"['0001101', '10111', '010', '10']",1,4,8,9,0,17,3.5825396825396822,19,12
"['0', '1010001', '0111', '11']",1,4,6,8,0,14,2.3065656565656565,22,12
"['010100', '001111', '101', '110001', '100', '100110', '111111', '101111']",1,8,16,26,8,42,15.666666666666666,89,93
"['11000', '01001', '1']",1,3,6,5,2,11,1.2666666666666666,10,6
"['0', '01', '111111']",1,3,2,7,0,9,0.9166666666666666,12,4
"['0011', '100101']",1,2,5,5,0,10,0.8,2,2
"['1000100', '01']",1,2,6,3,0,9,0.4444444444444444,5,2
"['101010', '0011', '1000110', '0111', '0111101']",1,5,12,16,4,28,6.143806193806194,31,26
"['11000', '0100']",1,2,6,3,0,9,0.6666666666666666,2,3
"['010', '001', '101001']",1,3,7,5,2,12,2.0,8,6
['001100'],1,1,4,2,0,6,0,0,0
"['11000', '10100', '00', '0011']",1,4,10,6,2,16,3.4984126984126984,17,22
"['001', '0110111', '00001', '11', '000100']",1,5,13,10,0,23,4.718969918969919,35,28
"['10001', '0011110', '111000', '10']",1,4,10,10,0,20,3.3585303585303583,24,13
"['010', '000']",1,2,5,1,2,6,0.6666666666666666,1,4
"['01101', '1', '0011011', '110101', '0100']",1,5,10,13,0,23,5.2291874791874795,34,23
"['010', '100', '111', '000']",1,4,7,5,4,12,2.6666666666666665,11,12
"['000001', '111111', '10']",1,3,6,8,2,14,0.6666666666666666,15,6
"['01', '1001000', '0011010', '1111', '0101010', '00']",1,6,16,13,5,29,7.097402597402597,59,39
"['11001', '0', '0111010', '11000', '0011111']",1,5,11,14,4,25,4.847619047619047,39,24
"['110', '1', '01000']",1,3,5,4,0,9,1.3333333333333333,9,4
"['0001101', '111', '000']",1,3,7,6,2,13,1.2,11,8
"['000011', '0011', '10100', '101001', '1011111']",1,5,13,15,2,28,5.906216006216006,31,38
"['01111', '111100']",1,2,3,8,0,11,0.7272727272727273,3,5
"['011111', '01', '11011']",1,3,3,10,0,13,1.6168831168831168,9,9
"['1011', '11011', '10']",1,3,3,8,0,11,2.126984126984127,6,13
"['110000', '11110', '101101', '1100000', '1100100']",1,5,16,15,4,31,6.552947052947053,26,39
"['010100', '100001', '1101110', '10010', '0000', '01110']",1,6,19,14,4,33,8.515306915306915,44,41
"['0', '1100001', '111000']",1,3,8,6,0,14,1.304945054945055,13,5
"['0101111', '00101', '111', '1001010', '0000100', '10110', '010110', '000', '01110', '0111100']",1,10,28,27,9,55,26.505883005883007,139,143
"['0', '10000', '011111']",1,3,6,6,0,12,0.8008658008658008,14,6
"['010100', '110110', '00', '010011']",1,4,11,9,3,20,3.5,20,19
['0110011'],1,1,3,4,0,7,0,0,0
"['00010', '010']",1,2,6,2,0,8,0.75,2,6
"['01', '1110010', '0001', '10']",1,4,8,7,2,15,2.9343434343434343,21,14
"['011', '0011110', '1010101', '0001101', '0011111', '10', '1001001']",1,7,18,22,5,40,11.971428571428572,76,56
"['0001011', '10']",1,2,5,4,0,9,0.4444444444444444,5,2
"['100', '1110011', '0110']",1,3,6,8,0,14,1.7168831168831167,10,4
"['0001', '1']",1,2,3,2,0,5,0.4,3,2
"['101100', '111110']",1,2,4,8,2,12,0.6666666666666666,2,2
"['0', '0001010', '1011', '0101010']",1,4,11,8,2,19,2.8870129870129873,23,16
"['00100', '10010', '10']",1,3,8,4,2,12,1.9428571428571428,8,8
"['1011110', '1010000', '10']",1,3,8,8,2,16,1.4603174603174602,13,11
"['001', '110']",1,2,3,3,2,6,0.3333333333333333,3,2
"['0010110', '1111011', '100000', '0111', '1011', '011000']",1,6,16,18,6,34,8.333549783549783,54,41
"['000110', '11110', '0110111', '11000', '10011', '001100', '1110']",1,7,17,21,5,38,12.727738927738928,61,66
"['011', '0100010', '1011101', '010010', '111011', '00', '100101', '00010']",1,8,22,20,5,42,16.548412698412697,90,73
"['0100011', '10', '0011100']",1,3,9,7,2,16,1.4603174603174602,15,6
['1011101'],1,1,2,5,0,7,0,0,0
"['0010001', '00', '1']",1,3,7,3,0,10,0.6944444444444444,13,6
"['0001', '1010010', '11100', '10']",1,4,10,8,0,18,3.1875901875901875,21,15
"['1010110', '010000', '00', '10', '001100']",1,5,15,8,4,23,5.44017094017094,36,36
"['110001', '1', '0000']",1,3,7,4,0,11,0.8857142857142857,12,4
['0000'],1,1,4,0,0,4,0,0,0
"['00', '010']",1,2,4,1,0,5,0.8,1,4
"['0', '10001', '10110']",1,3,6,5,2,11,1.2666666666666666,11,5
"['00100', '010011', '1100', '110']",1,4,10,8,0,18,3.7955266955266955,16,19
"['0010', '100', '110', '00']",1,4,8,4,2,12,3.676190476190476,10,20
"['0001', '100']",1,2,5,2,0,7,0.5714285714285714,2,3
"['01', '000', '01110', '001100', '1110']",1,5,11,9,0,20,5.473304473304474,27,34
"['011', '0001101', '000010', '001001', '0011100']",1,5,18,11,4,29,6.615140415140415,29,34
"['0', '101', '1110110', '01001']",1,4,7,9,0,16,2.933333333333333,22,11
"['00', '110010', '11']",1,3,5,5,2,10,1.0,10,6
"['11000', '0100000', '000', '000011']",1,4,16,5,0,21,3.844172494172494,19,34
"['0011011', '110100']",1,2,6,7,0,13,0.6153846153846154,4,4
"['010', '1001101']",1,2,5,5,0,10,0.6,4,0
"['0010', '101', '0001', '0011', '01111', '111110', '100101', '000', '0111', '001001']",1,10,22,23,9,45,26.06976911976912,116,129
"['100100', '1']",1,2,4,3,0,7,0.2857142857142857,5,2
"['11010', '001101', '11000', '1010100', '01111', '00', '0111111', '01010', '1011', '101001']",1,10,23,29,8,52,26.44131424131424,136,125
"['1100', '010111', '0100']",1,3,7,7,2,14,1.75,8,11
"['101001', '1111010', '1100110', '01100']",1,4,11,14,2,25,4.159507159507159,19,12
"['1001110', '01', '1']",1,3,4,6,0,10,1.3611111111111112,12,6
"['010', '010001', '111', '0111']",1,4,7,9,2,16,3.4730158730158727,15,18
"['0111000', '0011', '0101010', '00010', '110']",1,5,15,11,2,26,5.543290043290043,31,36
"['11001', '000111', '10', '0011111']",1,4,8,12,0,20,2.8583361083361085,24,17
"['0', '1000000', '0111']",1,3,8,4,0,12,0.8318181818181818,15,6
"['01011', '00000']",1,2,7,3,2,10,0.4,3,2
"['1000', '100111']",1,2,5,5,0,10,0.6,3,4
"['01101', '011', '1001']",1,3,5,7,0,12,1.7658730158730158,6,9
['0011011'],1,1,3,4,0,7,0,0,0
"['001', '1', '10']",1,3,3,3,0,6,1.5666666666666667,5,6
"['1010101', '001010']",1,2,7,6,0,13,0.7692307692307693,2,0
"['1', '0100100']",1,2,5,3,0,8,0.25,6,0
"['101100', '001', '0010101', '10', '001011']",1,5,13,11,2,24,5.760683760683761,34,33
"['010', '1', '0110111', '10100', '0111101', '11100']",1,6,11,17,4,28,7.7976190476190474,53,36
"['011011', '001', '10011', '0111']",1,4,7,11,0,18,3.777994227994228,13,18
"['0', '1100010']",1,2,5,3,0,8,0.25,6,2
"['001', '1100', '10110', '01110']",1,4,8,9,2,17,3.704761904761905,15,15
"['111111', '10']",1,2,1,7,0,8,0.25,5,2
"['0100111', '0101000', '10000', '10', '1010001', '01100']",1,6,20,13,5,33,9.219047619047618,50,39
"['0', '101111']",1,2,2,5,0,7,0.2857142857142857,5,0
"['1101011', '11']",1,2,2,7,0,9,0.4444444444444444,5,8
"['1000', '1111000']",1,2,6,5,0,11,0.7272727272727273,3,5
"['0110011', '10', '111', '0100']",1,4,7,9,0,16,3.124098124098124,19,13
"['111100', '11']",1,2,2,6,0,8,0.5,4,4
"['0001100', '01', '01111', '0010011']",1,4,11,10,2,21,3.1746031746031744,24,16
"['0110010', '010']",1,2,6,4,0,10,0.6,4,7
"['111000', '001', '0100']",1,3,8,5,0,13,1.615873015873016,9,9
"['10', '1111110', '11']",1,3,2,9,2,11,1.3888888888888888,11,9
"['0', '11111']",1,2,1,5,0,6,0.0,5,0
['110100'],1,1,3,3,0,6,0,0,0
"['11101', '111100', '1111']",1,3,3,12,0,15,2.416161616161616,5,20
"['0', '101', '0001000']",1,3,8,3,0,11,1.15,13,4
"['01', '01101', '00101']",1,3,6,6,2,12,1.9428571428571428,7,11
"['1010', '1000101']",1,2,6,5,0,11,0.5454545454545454,3,3
"['0', '1011', '100011']",1,3,5,6,0,11,1.4857142857142858,10,7
"['00101', '00111', '0011001', '101', '100', '010011']",1,6,15,14,4,29,9.786596736596737,40,46
"['0010', '00100', '10010', '10', '1010000', '1110', '1101010']",1,7,20,14,6,34,12.712698412698412,59,69
['1001111'],1,1,2,5,0,7,0,0,0
"['010', '100001', '1011100', '000', '110', '1110']",1,6,14,12,3,26,8.125319125319125,44,36
"['01', '0110', '011']",1,3,4,5,0,9,2.3238095238095235,4,10
"['0', '00110', '01101', '01111']",1,4,7,9,3,16,3.2,17,16
"['0101', '100', '1', '1010000']",1,4,9,6,0,15,2.866883116883117,21,14
"['0001', '001']",1,2,5,2,0,7,0.8571428571428571,1,5
"['101', '011', '010010', '111']",1,4,6,9,3,15,3.7777777777777777,14,13
"['000101', '111']",1,2,4,5,0,9,0.4444444444444444,4,2
"['1', '0011000', '011011', '1001', '011110', '111000']",1,6,14,16,3,30,7.452597402597402,54,34
"['01', '1000', '001', '00000']",1,4,11,3,0,14,3.157142857142857,15,20
"['00011', '11', '1010', '100000', '010111', '0100']",1,6,15,12,4,27,7.966378066378066,47,40
"['00111', '0010110', '010', '11001']",1,4,10,10,2,20,3.533333333333333,20,14
['0010001'],1,1,5,2,0,7,0,0,0
['0011010'],1,1,4,3,0,7,0,0,0
"['0100110', '10000', '10011']",1,3,10,7,2,17,2.1,7,6
"['0', '01111']",1,2,2,4,0,6,0.3333333333333333,4,2
"['01', '101', '1101', '0000010']",1,4,9,7,0,16,3.531890331890332,19,14
"['010', '001', '00101', '00011', '0101101', '0110', '1011']",1,7,16,15,6,31,13.992640692640693,50,55
"['000110', '1001010', '0110', '0001111', '1000010', '0110011']",1,6,21,17,4,38,9.915884115884117,45,51
"['0', '1110111', '0010', '011', '100100']",1,5,10,11,0,21,4.676762126762127,37,21
"['0101', '01111', '000011', '010111']",1,4,9,12,2,21,4.006060606060606,13,21
"['1110001', '1', '0101100']",1,3,7,8,2,15,1.2142857142857144,16,4
"['11010', '010', '1001101', '00', '10']",1,5,10,9,2,19,6.148412698412699,28,23
"['10010', '10']",1,2,4,3,0,7,0.5714285714285714,3,4
"['000111', '1', '110101']",1,3,5,8,2,13,1.0714285714285714,13,9
"['100', '1', '10000', '000010']",1,4,11,4,0,15,3.040764790764791,19,17
"['01101', '1', '100', '1101011', '00010']",1,5,10,11,2,21,4.783333333333333,36,19
"['0010010', '01110']",1,2,7,5,0,12,0.6666666666666666,3,5
"['100', '001010']",1,2,6,3,0,9,0.6666666666666666,3,3
['0101101'],1,1,3,4,0,7,0,0,0
"['110000', '1100', '1001100', '1110100']",1,4,13,11,2,24,4.067732267732268,16,27
"['0', '011', '1111']",1,3,2,6,0,8,1.0714285714285714,8,6
"['11011', '010000', '001111', '0110', '1000', '010110', '10', '01001', '1100']",1,9,22,20,8,42,21.473665223665222,101,101
"['0', '00101', '011']",1,3,5,4,0,9,1.5833333333333333,8,6
"['00111', '1111011']",1,2,3,9,0,12,0.5,4,5
"['010', '110']",1,2,3,3,2,6,0.6666666666666666,1,3
"['11000', '0100000', '010', '110']",1,4,12,6,2,18,3.583333333333333,18,21
"['1000110', '110', '000']",1,3,8,5,2,13,1.5333333333333332,10,8
"['01', '11']",1,2,1,3,2,4,0.5,1,2
"['0100001', '01', '111110', '11']",1,4,7,10,2,17,2.4465811965811968,25,16
"['100001', '00000', '11', '1100100', '0000101']",1,5,18,9,2,27,5.726051726051726,34,30
"['1', '10111', '0110', '1010111', '00110']",1,5,8,14,2,22,5.517676767676767,31,25
"['001', '10111', '0110000', '10', '01011']",1,5,11,11,2,22,5.1873015873015875,34,22
"['0', '010110', '11']",1,3,4,5,0,9,0.7857142857142857,11,4
"['1000001', '000011', '1010011']",1,3,12,8,2,20,2.10989010989011,6,12
"['1000000', '01001', '10', '011']",1,4,11,6,0,17,2.865873015873016,22,14
"['1', '000', '0010011']",1,3,7,4,0,11,0.85,13,6
"['00101', '1111']",1,2,3,6,0,9,0.4444444444444444,3,2
"['0110010', '00101']",1,2,7,5,0,12,0.6666666666666666,3,2
"['00110', '0001', '11101', '01011']",1,4,9,10,3,19,3.5555555555555554,15,13
"['101', '01110']",1,2,3,5,0,8,0.5,3,0
"['101', '011']",1,2,2,4,2,6,0.6666666666666666,2,2
"['1110001', '01', '00', '001011']",1,4,9,8,2,17,2.8504273504273505,23,14
"['00111', '1', '10']",1,3,3,5,0,8,1.2857142857142856,9,6
"['01', '001', '110']",1,3,4,4,2,8,1.5333333333333334,6,7
"['0', '10111', '0011', '1000', '10010', '1001100']",1,6,14,12,4,26,8.437878787878788,44,42
"['01', '010', '00000', '011011', '1111110']",1,5,11,12,0,23,4.366444666444666,39,27
"['0101', '1011011', '0000']",1,3,8,7,2,15,1.4090909090909092,10,4
"['00110', '111']",1,2,3,5,0,8,0.5,3,0
"['1', '0001101', '00', '1011100', '010011']",1,5,12,11,2,23,4.13064713064713,43,23
"['0111001', '11']",1,2,3,6,0,9,0.4444444444444444,5,2
"['11101', '100', '00101', '01000']",1,4,10,8,3,18,3.35,16,15
"['1000', '111000']",1,2,6,4,0,10,0.8,2,5
"['110011', '101', '01001', '1001']",1,4,8,10,0,18,4.68997113997114,11,24
"['111', '10101', '111011', '1010', '1001100', '0100011', '01011', '1101010']",1,8,18,26,5,44,18.488672438672438,79,97
"['0', '001001', '00101', '111']",1,4,8,7,0,15,2.4725829725829724,20,14
"['0', '101', '01000']",1,3,6,3,0,9,1.3333333333333333,9,4
"['01', '1010', '0110100']",1,3,7,6,0,13,1.8383838383838382,10,7
"['101011', '10000']",1,2,6,5,0,11,0.5454545454545454,3,3
"['110', '111', '01000']",1,3,5,6,2,11,1.4166666666666665,8,6
"['10', '0111']",1,2,2,4,0,6,0.3333333333333333,3,2
"['10101', '10', '000']",1,3,6,4,0,10,1.4714285714285715,8,5
"['0011', '000100']",1,2,7,3,0,10,0.6,3,4
"['011101', '101100', '11100']",1,3,7,10,2,17,2.3030303030303028,6,9
"['0', '111110']",1,2,2,5,0,7,0.2857142857142857,5,2
"['110000', '010000', '1011111', '0001111']",1,4,13,13,4,26,3.086080586080586,24,23
"['11110', '00000', '101', '1010100', '100010', '1000000', '110111', '0111', '01011']",1,9,25,23,7,48,18.048096348096347,114,105
"['111', '0100']",1,2,3,4,0,7,0.2857142857142857,3,0
"['1', '0110100', '0111']",1,3,5,7,0,12,1.3772727272727274,12,6
"['0100001', '1', '10']",1,3,6,4,0,10,1.3611111111111112,12,6
"['0110101', '1000100', '011', '11', '000101', '001110', '0000']",1,7,20,15,4,35,12.141835941835941,70,58
"['00011', '0100010', '110011', '00', '110111', '110']",1,6,14,15,2,29,8.248856698856699,49,47
"['11001', '110', '0111', '1000011']",1,4,8,11,0,19,3.60021645021645,19,21
"['1001000', '100010', '0000', '0000110', '0100']",1,5,21,7,4,28,6.373526473526473,27,45
"['0010', '0000110', '1']",1,3,8,4,0,12,1.3772727272727274,12,6
"['0101', '10', '0111']",1,3,4,6,2,10,1.75,6,7
"['000101', '000']",1,2,7,2,0,9,0.6666666666666666,3,6
"['0', '01', '000111', '0000011']",1,4,10,6,0,16,2.916056166056166,23,15
"['00', '111010']",1,2,4,4,0,8,0.5,4,2
"['11000', '11110', '10']",1,3,5,7,2,12,1.7428571428571429,8,8
"['0', '0101111']",1,2,3,5,0,8,0.25,6,2
"['11', '110101', '111001']",1,3,4,10,2,14,1.8333333333333335,10,18
"['00111', '0101111', '001', '111']",1,4,6,12,2,18,3.6666666666666665,16,24
"['1100010', '10110']",1,2,6,6,0,12,0.5,3,3
"['0110101', '010000', '101010', '1100000', '000']",1,5,19,10,4,29,6.386813186813187,32,34
"['101100', '01', '001', '111', '100010']",1,5,10,10,4,20,5.033333333333333,30,23
"['0', '0010', '001001']",1,3,8,3,0,11,1.4857142857142858,10,11
"['0101', '01111', '10', '0100']",1,4,7,8,2,15,3.4801587301587302,14,16
"['1001000', '1', '011110']",1,3,7,7,0,14,0.8434065934065934,15,4
"['1001101', '0001100', '1000011', '001100', '0111110']",1,5,18,16,4,34,6.637362637362638,32,26
"['0', '111', '01100']",1,3,4,5,0,9,0.8333333333333333,10,4
"['0111010', '110', '111100', '011100', '00100', '101', '0011110', '011101', '1100']",1,9,21,26,7,47,24.255255855255854,96,124
"['1', '0110100', '000101', '1100100', '110011', '10']",1,6,15,14,4,29,7.612332112332112,58,38
"['100101', '0100']",1,2,6,4,0,10,0.6,3,0
"['0', '110010', '0011100', '111011']",1,4,9,11,2,20,2.718864468864469,26,12
"['0', '11110', '100', '1010', '0101100']",1,5,10,10,0,20,5.278860028860029,31,26
['10011'],1,1,2,3,0,5,0,0,0
"['110010', '101101']",1,2,5,7,2,12,0.6666666666666666,3,2
"['010', '0110100', '000']",1,3,9,4,2,13,1.6666666666666665,9,15
"['1101', '1100', '110']",1,3,4,7,2,11,2.4642857142857144,3,12
"['00001', '0101101', '1101000', '0001100', '00010', '101111']",1,6,21,16,5,37,8.41005661005661,47,46
"['1110001', '10']",1,2,4,5,0,9,0.4444444444444444,5,2
"['0101110', '1101011', '00001']",1,3,9,10,2,19,1.380952380952381,11,4
"['1001110', '010001', '101', '1111', '10', '000']",1,6,12,13,2,25,7.254489954489954,48,33
"['011111', '111', '000', '0100']",1,4,7,9,2,16,2.146031746031746,19,17
"['00111', '010', '010110', '000']",1,4,10,7,2,17,3.727272727272727,15,23
"['1010110', '0100011', '011001']",1,3,10,10,2,20,2.098901098901099,9,7
"['01', '001111']",1,2,3,5,0,8,0.5,4,2
"['11010', '1110010', '011100', '1111010', '1111111']",1,5,10,22,3,32,7.036796536796537,26,42
"['00', '101110', '00001']",1,3,8,5,0,13,1.435064935064935,11,8
"['010', '10101', '1111000', '100101', '000', '011110']",1,6,15,15,4,30,8.851787101787101,48,36
"['01', '1001', '1']",1,3,3,4,0,7,1.7333333333333334,6,9
"['0011', '01110']",1,2,4,5,0,9,0.6666666666666666,2,2
"['1010', '0100']",1,2,5,3,2,8,0.75,2,2
"['0011', '1', '0000']",1,3,6,3,2,9,0.9,9,6
"['11', '101', '1110101', '10010', '0001011', '110']",1,6,11,16,4,27,9.081746031746032,48,49
"['10', '1110']",1,2,2,4,0,6,0.6666666666666666,2,3
"['0011', '000100', '01111', '10']",1,4,9,8,0,17,2.7493506493506494,20,15
"['11001', '0011', '0101', '1011000']",1,4,10,10,2,20,3.840909090909091,18,15
"['111010', '100010', '0010011', '11101', '011110', '111000', '110']",1,7,17,22,4,39,12.67020202020202,62,66
"['1100', '011']",1,2,3,4,0,7,0.5714285714285714,3,3
"['1111001', '001101']",1,2,5,8,0,13,0.6153846153846154,3,3
"['0011011', '0010', '0001110']",1,3,10,8,2,18,2.168831168831169,9,13
"['0', '0010', '1101', '0101', '01100']",1,5,10,8,3,18,5.311111111111111,25,24
"['00', '1110']",1,2,3,3,0,6,0.3333333333333333,3,2
['100001'],1,1,4,2,0,6,0,0,0
"['0011', '1001000', '0110', '001010', '01100']",1,5,16,10,2,26,6.4475135975135975,25,37
"['01', '100']",1,2,3,2,0,5,0.4,2,2
"['0110100', '11000', '0110', '1111', '0101010', '000000', '01001', '000100', '01000']",1,9,31,18,9,49,21.50927960927961,98,140
"['01101', '1101011', '11111', '1011', '1010010', '1001011']",1,6,12,23,5,35,9.345310245310245,41,66
"['0', '101000', '10111', '0010']",1,4,9,7,0,16,2.6089466089466087,21,13
"['0', '0011', '0010111']",1,3,6,6,0,12,1.3772727272727274,12,9
"['1010110', '10111', '0011', '1111010', '0111']",1,5,9,18,4,27,6.225468975468975,27,33
"['11001', '00010', '0000011', '101111']",1,4,12,11,2,23,3.1372960372960375,21,15
"['00010', '0100110', '000', '1']",1,4,11,5,0,16,2.7666666666666666,21,17
"['011111', '000110', '0']",1,3,6,7,2,13,1.0714285714285714,13,8
"['01', '0010']",1,2,4,2,0,6,0.6666666666666666,2,2
"['1011101', '1000']",1,2,5,6,0,11,0.5454545454545454,4,3
"['011101', '100', '1']",1,3,4,6,0,10,1.2301587301587302,11,6
"['00111', '1010', '00', '1110']",1,4,7,8,2,15,3.1825396825396823,15,17
"['1100011', '0110100']",1,2,7,7,2,14,0.7142857142857143,4,0
"['0001101', '00', '100111', '1111110']",1,4,9,13,2,22,2.826007326007326,25,14
"['001', '0101', '1']",1,3,4,4,0,8,1.4714285714285715,6,7
"['0', '100100', '1111', '100111', '110111']",1,5,8,15,3,23,4.457142857142857,33,37
"['0101101', '11101', '1']",1,3,4,9,0,13,1.4166666666666667,12,11
"['011010', '1100', '110']",1,3,6,7,0,13,2.3238095238095235,6,9
['010100'],1,1,4,2,0,6,0,0,0
"['1000', '100001', '10', '1']",1,4,8,5,0,13,3.319047619047619,17,19
"['01', '0111010', '0010', '10001', '110']",1,5,11,10,0,21,5.4812409812409815,31,24
"['11000', '001010', '1001111']",1,3,9,9,0,18,1.6608391608391608,11,6
"['01', '100', '1']",1,3,3,3,0,6,1.5666666666666667,5,6
"['0100010', '101', '010000', '0010100']",1,4,16,7,2,23,3.554334554334554,18,18
"['110010', '1100', '1101']",1,3,6,8,2,14,2.35,5,13
"['000', '1001101']",1,2,6,4,0,10,0.6,4,0
"['1000000', '01', '001', '10']",1,4,10,4,2,14,2.7666666666666666,21,15
"['1010010', '1']",1,2,4,4,0,8,0.25,6,2
"['0011', '100']",1,2,4,3,0,7,0.5714285714285714,3,3
"['011111', '101100']",1,2,4,8,2,12,0.5,4,2
"['01', '0011000', '0001', '0010101', '1011', '01000']",1,6,18,11,4,29,8.982683982683982,46,46
"['000111', '10011', '0110110']",1,3,8,10,0,18,1.8426573426573427,8,5
"['101', '001111']",1,2,3,6,0,9,0.4444444444444444,4,2
"['0101000', '11', '00000', '001000', '1110']",1,5,16,8,0,24,4.315501165501166,33,37
"['0100010', '1', '1101110']",1,3,7,8,2,15,1.0714285714285714,15,5
"['0', '0111']",1,2,2,3,0,5,0.4,3,2
"['0110', '000010']",1,2,7,3,0,10,0.6,3,5
['111111'],1,1,0,6,0,6,0,0,0
"['001111', '101010', '1010111', '100111', '0000110']",1,5,14,18,5,32,6.571428571428571,25,33
"['0010', '001', '11']",1,3,5,4,0,9,1.5904761904761904,6,6
"['1001110', '1', '1001', '0110', '01010']",1,5,10,11,2,21,5.56010101010101,32,24
"['0', '01000']",1,2,5,1,0,6,0.3333333333333333,4,4
"['1110101', '0001', '110001', '0100111']",1,4,11,13,2,24,3.704095904095904,17,23
"['1000010', '11010', '10']",1,3,8,6,0,14,1.6825396825396823,11,11
"['01', '10']",1,2,2,2,2,4,0.5,2,2
"['101', '0010']",1,2,4,3,0,7,0.5714285714285714,2,0
['1100000'],1,1,5,2,0,7,0,0,0
"['0100111', '10101', '0001100', '0001011', '01011']",1,5,16,15,5,31,7.109523809523809,27,30
"['1010', '01', '0101110', '0100']",1,4,9,8,2,17,3.9823232323232323,17,19
"['010100', '001', '1001', '11001']",1,4,10,8,0,18,4.267748917748918,13,18
['1010110'],1,1,3,4,0,7,0,0,0
"['0', '000001']",1,2,6,1,0,7,0.2857142857142857,5,2
"['11011', '010010', '100101', '11111', '1100111']",1,5,10,19,4,29,6.5331002331002335,24,39
"['0', '1010', '00111']",1,3,5,5,0,10,1.1777777777777778,10,6
"['0011', '001', '0101110']",1,3,7,7,0,14,1.9844155844155844,8,8
"['1001110', '001', '10100', '000111', '110', '1001011', '0100']",1,7,18,17,4,35,11.926340326340327,64,58
"['11010', '1001000', '1000010', '100110', '00', '0111', '1101']",1,7,19,16,4,35,11.832256632256632,67,58
"['01', '111', '110100', '0000101', '1101']",1,5,10,12,0,22,5.741913641913642,32,34
"['0110001', '1101110']",1,2,6,8,2,14,0.5714285714285714,4,2
"['001', '1111101', '011', '1001101', '10010', '001010', '11100', '01100']",1,8,19,22,7,41,16.566267066267066,84,77
"['110000', '111', '0011001', '10', '1101', '0110001', '0100']",1,7,17,16,4,33,12.76037296037296,64,54
"['011011', '1101101', '0110']",1,3,6,11,0,17,2.2965034965034965,8,8
"['0', '01', '011101']",1,3,4,5,0,9,1.4523809523809523,10,8
"['1100010', '10110', '11']",1,3,6,8,0,14,1.5158730158730158,11,9
"['1101111', '111010', '000']",1,3,6,10,0,16,1.2598290598290598,13,7
"['0010', '10', '01100']",1,3,7,4,0,11,1.6825396825396823,7,10
"['1', '00100', '101', '110011', '100101']",1,5,10,11,2,21,5.344155844155844,33,27
"['1010001', '010', '111000', '0111']",1,4,10,10,0,20,3.5305583305583306,20,13
['011100'],1,1,3,3,0,6,0,0,0
"['0001', '0111', '00001']",1,3,8,5,2,13,1.8333333333333333,6,11
"['0', '10011', '0110001']",1,3,7,6,0,13,1.25,13,4
"['11000', '11100', '1']",1,3,5,6,2,11,1.4666666666666668,9,8
"['0110101', '0010001', '001', '001111', '100001', '10110', '0001111', '0000', '0100001', '0101']",1,10,32,24,8,56,27.42040182040182,140,145
"['010111', '00001']",1,2,6,5,0,11,0.36363636363636365,3,2
"['1000001', '11001', '111', '0100']",1,4,10,9,0,19,3.3145021645021644,19,16
"['11', '100', '011110', '0100']",1,4,7,8,0,15,3.134920634920635,17,13
"['111100', '101', '1000110', '1010111', '000', '1100']",1,6,14,16,4,30,8.247197247197247,51,43
"['0', '11110', '1101']",1,3,3,7,0,10,1.4,9,5
"['00101', '101000', '100010', '111011', '010101']",1,5,15,14,4,29,6.045454545454545,27,25
"['0110110', '00111', '110011', '1010111', '000010', '1101', '01100', '1110']",1,8,19,25,8,44,16.923182373182375,82,79
"['0001100', '1100', '011', '11111']",1,4,8,11,0,19,3.1764790764790765,21,19
"['0', '0110']",1,2,3,2,0,5,0.4,3,4
"['0', '10001', '0110010']",1,3,8,5,0,13,1.25,13,4
['010011'],1,1,3,3,0,6,0,0,0
"['011011', '00', '001', '111']",1,4,6,8,2,14,2.7444444444444445,16,14
['100010'],1,1,4,2,0,6,0,0,0
"['101010', '100', '11111']",1,3,5,9,0,14,1.462121212121212,10,7
"['11001', '011', '1110']",1,3,4,8,0,12,1.7380952380952381,7,9
['0011100'],1,1,4,3,0,7,0,0,0
"['1001010', '101111']",1,2,5,8,0,13,0.46153846153846156,3,3
"['11011', '0110001']",1,2,5,7,0,12,0.6666666666666666,3,2
"['0', '01001', '010011', '0101', '110101']",1,5,11,11,2,22,6.096681096681096,28,32
"['1', '1000101', '00011', '10', '1010010']",1,5,12,10,2,22,5.031746031746032,38,26
"['11110', '0100110', '1000000', '00', '001100']",1,5,17,10,2,27,5.022255522255522,39,36
"['1110010', '00101', '101', '00010', '01100']",1,5,14,11,3,25,5.95,29,26
"['1001', '000011']",1,2,6,4,0,10,0.6,3,2
"['0100000', '001011']",1,2,9,4,0,13,0.46153846153846156,4,3
"['0010110', '100', '100011']",1,3,9,7,0,16,1.682051282051282,10,7
"['0000110', '00101']",1,2,8,4,0,12,0.6666666666666666,3,3
"['110000', '00', '1111101', '0001000']",1,4,13,9,2,22,2.529304029304029,27,21
"['001', '010', '0001', '110001', '001011']",1,5,13,9,4,22,6.43968253968254,26,30
"['0001', '000010']",1,2,8,2,0,10,0.8,2,4
"['0111', '011000', '000', '1111']",1,4,8,9,2,17,2.7023809523809526,18,20
"['0', '1010111', '110']",1,3,4,7,0,11,1.15,12,5
"['1111010', '1', '1100100']",1,3,6,9,2,15,1.2142857142857144,15,7
"['01', '100', '10', '01110']",1,4,6,6,2,12,3.342857142857143,14,15
"['0010', '000', '11']",1,3,6,3,0,9,1.1904761904761905,7,6
"['011001', '000011', '0000']",1,3,11,5,2,16,1.7000000000000002,8,12
['1100011'],1,1,3,4,0,7,0,0,0
['110101'],1,1,2,4,0,6,0,0,0
"['001', '0000']",1,2,6,1,0,7,0.5714285714285714,2,4
"['0001', '110100', '001000']",1,3,11,5,2,16,1.6666666666666665,10,12
"['101001', '1001001', '1100', '000']",1,4,12,8,0,20,3.8844044844044845,15,17
"['01', '0100000', '010011', '111101']",1,4,11,10,2,21,2.700854700854701,25,17
"['0011', '1101100']",1,2,5,6,0,11,0.5454545454545454,4,4
"['0', '0010', '10101', '11101', '1011']",1,5,8,11,4,19,5.233333333333333,25,21
"['1', '00001', '1011110', '101000', '01010', '000010', '01100']",1,7,21,14,5,35,10.329353979353979,70,60
"['00', '1010101', '000001']",1,3,10,5,0,15,1.2521367521367521,12,7
"['1001011', '00', '10110', '1']",1,4,7,8,0,15,2.265873015873016,23,11
"['011', '0010000']",1,2,7,3,0,10,0.4,5,2
"['10111', '101101']",1,2,3,8,0,11,0.9090909090909091,1,7
"['0', '110100', '1111']",1,3,4,7,0,11,0.8857142857142857,12,6
"['0', '00101']",1,2,4,2,0,6,0.3333333333333333,4,2
"['0100111', '101', '0110', '0000000', '0101']",1,5,15,10,4,25,5.064285714285714,37,24
"['0', '001']",1,2,3,1,0,4,0.5,2,2
"['0001', '01101', '10000']",1,3,9,5,2,14,1.511111111111111,8,9
"['101010', '0100']",1,2,6,4,0,10,0.8,2,2
"['001', '1110000', '1011110', '000101', '1011']",1,5,13,14,2,27,5.377355977355977,39,29
"['10000', '110', '0110100']",1,3,9,6,0,15,1.6,10,7
"['1111', '0010', '00001']",1,3,7,6,2,13,1.1388888888888888,9,5
['000011'],1,1,4,2,0,6,0,0,0
"['10101', '011', '11']",1,3,3,7,0,10,2.1214285714285714,6,10
"['11110', '01101', '01011', '0100']",1,4,8,11,3,19,3.3777777777777778,15,17
"['01', '0100111', '11000', '1100101', '001100']",1,5,14,13,2,27,5.680264180264181,37,27
"['0010', '1001', '011']",1,3,6,5,2,11,1.8928571428571428,6,4
"['100110', '010']",1,2,5,4,0,9,0.4444444444444444,3,3
"['0011', '010', '10011', '11']",1,4,6,8,0,14,3.598412698412698,13,17
"['11101', '0111', '11']",1,3,2,9,0,11,1.9047619047619047,7,14
"['0', '01', '110']",1,3,3,3,0,6,1.5666666666666667,5,6
"['011101', '01']",1,2,3,5,0,8,0.5,4,4
"['11001', '0', '11101', '0111', '0011011', '01001', '0101']",1,7,13,18,5,31,12.51010101010101,56,60
"['11000', '10111', '1100', '10']",1,4,7,9,2,16,3.5428571428571427,16,19
"['1011', '011']",1,2,2,5,0,7,0.8571428571428571,1,4
"['1111010', '01100']",1,2,5,7,0,12,0.6666666666666666,3,2
"['0110000', '111']",1,2,5,5,0,10,0.4,5,0
"['1001', '0111110']",1,2,4,7,0,11,0.36363636363636365,5,0
"['110110', '1', '1011110', '00', '111110']",1,5,7,15,2,22,4.208180708180708,36,27
"['01101', '100011', '10', '11111', '0011011', '1110']",1,6,10,19,2,29,8.37151737151737,47,46
"['001001', '11100']",1,2,6,5,0,11,0.5454545454545454,3,3
"['1110101', '001011']",1,2,5,8,0,13,0.6153846153846154,3,3
"['0000111', '10001', '000', '011001']",1,4,13,8,0,21,3.8037684537684537,18,16
"['001100', '10', '01000']",1,3,9,4,0,13,1.7987012987012987,9,10
"['01001', '101101']",1,2,5,6,0,11,0.7272727272727273,2,3
"['11010', '0001110', '0001111', '1000', '000010', '0000']",1,6,21,12,4,33,9.411960261960262,45,74
"['100', '10110']",1,2,4,4,0,8,0.75,2,3
"['00', '0101011', '1', '1101110']",1,4,7,10,2,17,2.1031746031746033,27,11
"['0100000', '010', '1', '10001', '10110']",1,5,13,8,2,21,5.033333333333333,35,20
"['0', '01101', '101', '10001', '1111001']",1,5,9,12,2,21,5.25,33,29
"['01', '11', '101', '10000', '00']",1,5,8,6,3,14,4.642857142857143,22,22
"['0', '01110']",1,2,3,3,0,6,0.3333333333333333,4,4
"['0101', '1111000']",1,2,5,6,0,11,0.36363636363636365,5,2
"['0', '0111000']",1,2,5,3,0,8,0.25,6,4
"['0011101', '10111', '100', '1000000', '100011', '1011', '01100']",1,7,19,18,4,37,12.451476301476301,70,69
"['011011', '1010110', '100', '10']",1,4,8,10,0,18,3.404273504273504,21,16
"['10101', '111001']",1,2,4,7,0,11,0.7272727272727273,2,5
"['11001', '011', '100', '001010', '011000']",1,5,13,10,4,23,6.0227272727272725,28,24
"['00001', '01111', '1111', '010111', '001010', '110101']",1,6,13,19,5,32,8.402020202020202,39,47
"['0001', '00', '1']",1,3,5,2,0,7,1.0666666666666667,7,6
"['0001001', '0011101', '1', '010010', '00010', '000111', '111101']",1,7,20,18,5,38,11.404761904761905,73,62
"['0', '110']",1,2,2,2,0,4,0.5,2,2
"['00', '001001', '100111']",1,3,8,6,2,14,1.6666666666666665,11,6
"['100', '001', '011001']",1,3,7,5,2,12,2.0,8,9
"['0', '101100', '1101011', '10100', '1000011']",1,5,13,13,2,26,5.13986013986014,38,27
"['11000', '0001', '1000111', '10', '110']",1,5,11,10,0,21,5.645526695526695,32,28
"['001', '1', '010000', '0000001', '000100']",1,5,18,5,2,23,4.92997557997558,35,33
"['01101', '0101000', '0110100', '1011', '110']",1,5,13,13,2,26,6.436147186147186,30,26
"['0101010', '10']",1,2,5,4,0,9,0.4444444444444444,5,3
"['00111', '10110', '011', '111101']",1,4,6,13,2,19,3.635353535353535,15,16
"['1000001', '001', '00', '1011100', '1110']",1,5,13,10,2,23,4.827417027417027,38,26
"['00110', '10101', '00', '1']",1,4,7,6,2,13,2.4095238095238094,19,10
"['011', '000011', '101', '100', '0000']",1,5,12,7,3,19,5.1650793650793645,27,30
"['1110', '0011', '100', '0000001', '0000101', '1011', '01100', '0100']",1,8,23,15,6,38,15.277633477633477,87,81
"['0000', '001100', '11111']",1,3,8,7,0,15,1.1636363636363636,11,8
"['1001', '1', '000101']",1,3,6,5,0,11,1.2857142857142856,11,9
"['00011', '11100', '1111']",1,3,5,9,2,14,1.511111111111111,10,14
"['0110', '00000']",1,2,7,2,0,9,0.4444444444444444,3,4
"['001', '111', '0011', '10', '01011', '0100']",1,6,10,11,4,21,8.046031746031746,32,40
"['0', '1100']",1,2,3,2,0,5,0.4,3,2
"['0', '11011', '1111', '00011']",1,4,5,10,2,15,2.5999999999999996,18,19
"['01', '01101', '0011000', '00110', '1000011', '001001']",1,6,19,13,4,32,9.40900210900211,49,42
"['1011', '01', '01111']",1,3,3,8,0,11,1.9047619047619047,7,8
"['11101', '000000', '00001']",1,3,11,5,2,16,1.309090909090909,10,11
"['1101001', '101', '1010', '11']",1,4,6,10,0,16,4.095526695526695,16,23
"['00100', '11010', '011100']",1,3,9,7,2,16,2.0545454545454547,8,11
"['1101110', '011100', '11111']",1,3,5,13,0,18,1.8146853146853146,8,6
"['1100011', '1000000', '10011', '0100']",1,4,14,9,2,23,3.662337662337662,20,17
"['001100', '01100', '1111']",1,3,7,8,0,15,1.7535353535353535,8,9
"['1001100', '1011', '000001']",1,3,10,7,0,17,1.5888111888111889,11,8
"['0010', '11011', '10001', '1111', '1000', '1010000', '001100']",1,7,19,16,5,35,11.937101787101787,63,58
"['101110', '01', '0110', '1001111']",1,4,7,12,0,19,3.7257964257964256,19,14
"['0001011', '1011010', '101']",1,3,8,9,2,17,1.7714285714285714,11,8
"['10101', '1010101', '100', '000010']",1,4,12,9,0,21,3.634770784770785,18,21
"['0', '0101', '1101010']",1,3,6,6,0,12,1.3772727272727274,12,6
"['100000', '11100', '101001']",1,3,10,7,2,17,1.7727272727272727,7,8
"['1001', '1100000', '0001111', '100111', '10', '000']",1,6,16,13,2,29,7.9994560994561,55,47
"['00', '1001', '0011111']",1,3,6,7,0,13,1.6565656565656566,12,6
"['110000', '0100000', '0011', '10100', '0111']",1,5,16,10,2,26,5.329331779331779,33,32
"['011011', '10101', '1101101', '00111']",1,4,8,15,2,23,4.323776223776224,15,19
"['1000001', '010', '01101', '11', '100110', '000000', '011000']",1,7,22,13,3,35,11.328499278499278,72,51
"['11', '1101101', '00', '10', '1001100', '01000']",1,6,13,12,5,25,6.976190476190476,53,34
"['11', '0101', '011', '011010']",1,4,6,9,0,15,4.09047619047619,13,16
"['010100', '0011011', '01001', '00010', '0111110']",1,5,16,14,4,30,5.984448884448884,30,34
"['1011010', '010', '11011', '00100', '0001', '1000010', '111110', '0111111', '000001', '000000']",1,10,31,25,8,56,22.58065823065823,158,134
"['00', '011', '0111']",1,3,4,5,0,9,1.5904761904761904,6,9
"['1011010', '011', '01111', '000001', '10011', '0101', '01011']",1,7,16,19,3,35,12.899683649683649,56,62
"['1000100', '0010', '111', '1110', '0011', '100110', '1010', '101111', '111001']",1,9,19,25,7,44,22.173282273282272,99,116
"['1', '101', '1111001', '0000', '01000']",1,5,11,9,0,20,3.9993506493506494,36,21
"['001', '100', '10100', '000', '0110011']",1,5,13,8,3,21,6.016666666666667,27,31
"['010100', '01111', '1111000', '0101100', '1010011', '0011011']",1,6,18,21,4,39,9.682817182817184,46,49
"['101100', '01', '0010100', '0001111', '000', '0001011', '1010000', '01001', '1111111']",1,9,27,24,5,51,18.75193695193695,138,120
"['010100', '0011', '1001101', '1000', '00', '01010', '0001011']",1,7,21,14,4,35,13.241736041736042,64,65
"['111', '0011001', '0001', '00', '01010', '0101']",1,6,14,11,2,25,8.079076479076479,41,40
"['100', '0100101']",1,2,6,4,0,10,0.6,4,2
"['10', '111010', '1111']",1,3,3,9,0,12,1.6333333333333333,9,11
"['1100', '011', '010110', '1011000']",1,4,10,10,0,20,3.9345987345987345,19,15
"['01', '001', '11111']",1,3,3,7,0,10,1.3357142857142859,9,7
"['01101', '001', '1', '1100000', '011101', '111101']",1,6,12,16,2,28,7.336424686424686,54,49
"['1', '101101']",1,2,2,5,0,7,0.2857142857142857,5,4
"['0', '10010']",1,2,4,2,0,6,0.3333333333333333,4,2
"['101', '1010', '000', '01000']",1,4,10,5,2,15,3.6785714285714284,12,16
"['0011', '1110110', '100000', '00110']",1,4,12,10,0,22,3.326184926184926,19,21
"['0', '1110001', '010011']",1,3,7,7,0,14,1.151098901098901,14,5
"['011011', '100', '10100', '00', '0000011', '0101']",1,6,16,11,0,27,8.500860250860251,47,44
"['110000', '001', '0000101', '10100', '0111111', '10010', '001100']",1,7,22,17,6,39,11.816955266955267,73,63
['101000'],1,1,4,2,0,6,0,0,0
"['0001110', '0110001']",1,2,8,6,2,14,0.5714285714285714,5,2
"['1011', '110', '000', '011110']",1,4,7,9,2,16,2.9015873015873015,17,13
"['1011', '000101']",1,2,5,5,0,10,0.6,3,2
"['11011', '010000', '0101101', '0110', '0010100', '10', '011000']",1,7,21,16,4,37,12.886957486957487,65,62
"['0010', '11010', '11', '11101', '110']",1,5,7,12,2,19,6.258730158730159,23,32
"['0', '111110', '010111', '1101110']",1,4,6,14,2,20,3.0137362637362637,22,19
"['001', '0000100', '101', '100100', '011001']",1,5,16,9,4,25,6.384615384615384,31,31
"['0', '0011000', '00111', '1111', '11101']",1,5,9,13,2,22,4.602525252525252,36,30
"['010', '0111011', '1110100', '10011', '01000']",1,5,13,14,4,27,5.930952380952381,33,27
"['011011', '1001', '1111000', '010011', '1100']",1,5,12,15,4,27,5.845804195804196,30,29
"['110110', '101', '00011']",1,3,6,8,0,14,1.712121212121212,9,7
"['11110', '1111101', '111', '100', '1100111']",1,5,6,19,4,25,5.545238095238095,32,49
"['0010001', '0', '1011001', '10101', '000001', '010110', '11100']",1,7,21,16,6,37,11.038228438228439,73,53
"['0110101', '0110', '10011', '011001', '01001']",1,5,13,14,2,27,7.386713286713286,22,35
"['00', '111011']",1,2,3,5,0,8,0.25,5,0
"['011', '000']",1,2,4,2,2,6,0.3333333333333333,2,2
"['11010', '000111', '1111110']",1,3,6,12,0,18,1.506993006993007,11,11
"['0011', '1101', '1011011', '110010']",1,4,8,13,2,21,3.7881118881118883,17,22
['0101111'],1,1,2,5,0,7,0,0,0
"['100110', '1010', '001010']",1,3,9,7,2,16,2.4333333333333336,6,12
"['01', '100', '10010']",1,3,6,4,0,10,1.7214285714285715,7,8
"['00', '001', '1110100', '1111']",1,4,7,9,0,16,2.6574314574314575,21,19
"['0', '001', '1010', '11111', '0111100']",1,5,8,12,0,20,4.027994227994228,37,19
"['0101', '000']",1,2,5,2,0,7,0.5714285714285714,2,2
['111001'],1,1,2,4,0,6,0,0,0
"['1011', '100111', '01011', '1111']",1,4,5,14,2,19,3.9606060606060605,11,32
"['010', '001', '110', '00010', '1100', '1110']",1,6,12,10,5,22,9.019841269841269,32,47
"['0110101', '11', '0011001', '0000001', '10100', '001110', '10', '0111', '0000110']",1,9,26,21,6,47,19.066344766344766,128,97
"['1111', '1100010', '1110001', '0100']",1,4,10,12,4,22,3.4707792207792205,20,17
"['0', '1001']",1,2,3,2,0,5,0.4,3,0
"['0001100', '00']",1,2,7,2,0,9,0.4444444444444444,5,8
"['11', '01', '0010011']",1,3,5,6,2,11,1.3888888888888888,11,8
"['0011', '00']",1,2,4,2,0,6,0.6666666666666666,2,4
"['1101', '0101']",1,2,3,5,2,8,0.75,1,4
"['011111', '010', '111']",1,3,3,9,2,12,1.4444444444444444,9,9
"['11010', '00001', '101010', '110001', '100']",1,5,14,11,4,25,6.195454545454545,26,30
"['1000', '1001', '0011000']",1,3,10,5,2,15,2.0227272727272725,8,10
"['11010', '111', '0011000', '1100000', '10']",1,5,13,11,2,24,5.457936507936508,37,28
"['100100', '1100', '000', '001010']",1,4,13,6,2,19,3.938095238095238,15,24
"['1111100', '110110', '111', '101001', '1011101', '1100100', '1001001', '01000', '1110']",1,9,22,30,6,52,22.47073482073482,106,112
"['0', '01111', '111010']",1,3,4,8,0,12,1.3463203463203464,12,8
"['011011', '10', '11001']",1,3,5,8,0,13,1.7987012987012987,9,7
"['00100', '011']",1,2,5,3,0,8,0.5,3,2
"['10101', '1110110', '010', '0000']",1,4,10,9,0,19,3.196176046176046,19,11
"['0011', '001', '100']",1,3,6,4,2,10,2.095238095238095,6,10
"['11', '10', '000', '0011011', '1101']",1,5,8,10,2,18,4.735209235209235,30,25
"['00111', '10101', '011', '10000']",1,4,9,9,3,18,3.35,16,15
"['010100', '1000100', '010011']",1,3,12,7,2,19,2.051282051282051,9,11
"['10010', '10', '000101']",1,3,8,5,0,13,1.7987012987012987,9,8
"['1', '0110']",1,2,2,3,0,5,0.4,3,0
"['001', '111', '101101', '00111', '00110', '01001']",1,6,12,15,5,27,9.626262626262626,35,43
"['0', '110010', '111100', '10011', '011000']",1,5,12,12,3,24,5.175324675324675,36,22
"['1010', '01']",1,2,3,3,0,6,0.6666666666666666,2,2
"['11110', '1101']",1,2,2,7,0,9,0.6666666666666666,2,3
"['0', '0001', '1110001', '1011111']",1,4,8,11,2,19,2.5623376623376624,27,15
"['10100', '000']",1,2,6,2,0,8,0.5,2,4
"['001010', '111']",1,2,4,5,0,9,0.4444444444444444,4,0
"['0010110', '100110', '101001', '1110']",1,4,11,12,2,23,3.8247086247086246,16,18
"['010', '0011100', '1111']",1,3,6,8,0,14,1.431168831168831,11,4
"['0', '00100']",1,2,5,1,0,6,0.3333333333333333,4,4
"['100', '1', '000001', '011100']",1,4,10,6,2,16,2.515873015873016,23,14
['1011100'],1,1,3,4,0,7,0,0,0
"['0011', '1000', '0110011']",1,3,8,7,2,15,1.7727272727272727,10,10
"['1011110', '1010', '0101011', '011']",1,4,8,13,2,21,3.7974025974025976,19,18
['111000'],1,1,3,3,0,6,0,0,0
"['101011', '0110110']",1,2,5,8,0,13,0.7692307692307693,3,0
"['0011', '0011000']",1,2,7,4,0,11,0.7272727272727273,3,6
"['01', '100', '1001', '011110', '0000']",1,5,11,8,2,19,5.073015873015873,28,24
"['0111000', '0011110']",1,2,7,7,2,14,0.7142857142857143,3,5
"['011', '1000', '00', '01010', '0101100', '1101010']",1,6,16,12,2,28,9.083044733044733,45,51
"['0110010', '00', '1110', '011000']",1,4,11,8,0,19,3.346309246309246,19,25
"['0111010', '1001', '1111', '000001', '10', '1100']",1,6,13,14,3,27,7.436985236985237,49,35
"['0001', '100', '11']",1,3,5,4,0,9,1.3047619047619048,7,7
"['0', '1010', '01111']",1,3,4,6,0,10,1.1777777777777778,10,6
"['0001100', '111101', '01000', '1111']",1,4,10,12,0,22,2.7110334110334113,22,17
"['1000011', '001010', '111']",1,3,8,8,0,16,1.45982905982906,11,6
"['1111100', '010', '1011001', '011']",1,4,8,12,4,20,3.380952380952381,22,12
"['1110010', '1101111', '00001', '11', '010010', '1010111', '00', '010011']",1,8,19,23,7,42,14.45942945942946,100,84
"['11000', '0110111', '010010', '000']",1,4,12,9,0,21,3.6593240093240094,19,20
"['1001100', '00', '00010', '10101']",1,4,12,7,2,19,3.5206349206349206,20,16
"['0010001', '0110', '111101', '1001100', '1011', '110', '1100011']",1,7,17,21,5,38,13.144738594738595,69,58
"['10', '1001111', '000', '0111100']",1,4,9,10,2,19,2.803174603174603,25,13
"['00111', '0101010', '0000000']",1,3,13,6,2,19,1.5714285714285714,11,10
"['00011', '00', '10', '0101', '1100']",1,5,10,7,4,17,5.634920634920634,24,26
"['1011010', '1', '0001111', '010101', '001010', '0010010']",1,6,18,16,5,34,8.33058608058608,55,40
['0111101'],1,1,2,5,0,7,0,0,0
"['0', '1000110', '100101']",1,3,8,6,0,14,1.304945054945055,14,6
"['111', '100011', '110111', '01001', '0101', '01000']",1,6,13,16,4,29,9.018398268398268,40,48
"['010', '1101100']",1,2,5,5,0,10,0.6,4,2
['0000000'],1,1,7,0,0,7,0,0,0
"['001', '0111010', '010', '101101', '11', '0011', '10001', '111000']",1,8,17,19,4,36,16.032905982905984,85,69
"['0010110', '011', '11', '0101011', '11101', '01100']",1,6,12,17,4,29,8.905555555555555,47,41
"['0', '0101011']",1,2,4,4,0,8,0.25,6,2
"['010100', '010', '1', '00000']",1,4,11,4,0,15,2.316017316017316,20,16
"['10111', '10']",1,2,2,5,0,7,0.5714285714285714,3,3
"['0111111', '1110000', '11']",1,3,5,11,2,16,1.3174603174603174,15,12
"['1101001', '00', '1100110', '00011']",1,4,11,10,2,21,3.507936507936508,23,16
"['11', '10101', '1100001', '0010011', '110']",1,5,11,13,2,24,5.6650793650793645,35,37
"['0', '11001', '001', '0101110', '101000', '1111001', '0011011']",1,7,17,19,3,36,11.083072483072483,78,53
"['101011', '100', '100011', '10', '111001']",1,5,10,13,3,23,6.466666666666667,28,37
"['0111000', '01', '10', '111101']",1,4,7,10,2,17,3.0042735042735043,23,12
"['11100', '0011', '110', '000110']",1,4,9,9,0,18,3.777994227994228,18,20
"['1000001', '00']",1,2,7,2,0,9,0.4444444444444444,5,0
"['0100011', '101100', '010', '011110']",1,4,11,11,2,22,3.454700854700855,21,19
"['1010101', '1']",1,2,3,5,0,8,0.25,6,4
"['011', '111010', '10111', '100', '1101011', '10000', '000101', '0010011', '0000', '0100']",1,10,27,23,10,50,25.903768453768453,137,137
"['0010001', '001', '11', '101', '100', '1000', '010101', '0000010']",1,8,22,13,5,35,15.552702852702852,84,78
"['1111100', '00100', '011', '11111']",1,4,7,13,2,20,2.9333333333333336,21,24
"['01', '010', '001101', '011011', '01100']",1,5,11,11,2,22,6.742640692640693,26,32
"['00110', '1110110', '1', '0011000']",1,4,10,10,2,20,2.9047619047619047,25,18
"['101', '100', '000']",1,3,6,3,3,9,1.6666666666666665,4,7
"['0110', '001010']",1,2,6,4,0,10,0.8,2,5
['111101'],1,1,1,5,0,6,0,0,0
"['1100101', '0110111', '011', '000']",1,4,9,11,4,20,3.0476190476190474,22,15
"['1000001', '10', '11']",1,3,6,5,2,11,1.3888888888888888,11,9
"['1110111', '1011110', '1111', '00', '1100011']",1,5,8,19,3,27,5.292929292929293,38,36
"['0011', '1101', '010', '100']",1,4,7,7,4,14,3.452380952380952,14,12
"['110110', '111', '10', '0111', '0000110']",1,5,9,13,0,22,5.362426462426463,33,30
"['0', '110000']",1,2,5,2,0,7,0.2857142857142857,5,2
['1110010'],1,1,3,4,0,7,0,0,0
"['0', '10101']",1,2,3,3,0,6,0.3333333333333333,4,0
"['0010', '001', '111', '1011000', '001011']",1,5,12,11,2,23,5.348140748140748,31,30
"['1000', '10011']",1,2,5,4,0,9,0.6666666666666666,2,4
"['101000', '100', '100010', '00', '00110']",1,5,15,7,2,22,5.962337662337662,28,36
"['11011', '11', '10101', '010010', '0111']",1,5,8,14,2,22,6.315584415584415,27,29
"['00000', '10111', '10011', '01100', '0100']",1,5,14,10,4,24,5.444444444444445,26,25
"['00', '001', '11100']",1,3,6,4,0,10,1.8714285714285714,8,11
"['1001', '110']",1,2,3,4,0,7,0.5714285714285714,2,2
"['111100', '11', '0100010', '101', '1001', '10']",1,6,11,13,2,24,8.812620712620713,45,37
"['0', '10', '011110', '101101']",1,4,6,9,2,15,2.9047619047619047,22,12
"['01', '1010', '10110', '0111']",1,4,6,9,2,15,3.96031746031746,13,16
['1110'],1,1,1,3,0,4,0,0,0
"['01101', '1100001', '11111', '00010', '0101', '01000']",1,6,16,15,4,31,8.512121212121212,44,38
"['1110111', '10', '111']",1,3,2,10,0,12,1.4444444444444444,11,16
"['100101', '1', '0000100']",1,3,9,5,0,14,1.151098901098901,14,4
"['11001', '1111100', '000110', '0001', '1010111']",1,5,13,16,2,29,5.411555111555112,36,29
['101111'],1,1,1,5,0,6,0,0,0
"['1011', '010']",1,2,3,4,0,7,0.5714285714285714,2,0
"['0011001', '00', '01111']",1,3,7,7,0,14,1.3968253968253967,12,8
"['0110010', '1000', '10', '101111']",1,4,9,10,0,19,3.3537684537684536,22,14
"['110000', '10111', '010']",1,3,7,7,0,14,1.308080808080808,11,5
"['001111', '11', '1101101', '10', '0111', '01001']",1,6,9,17,2,26,8.303191253191253,47,44
"['001', '011001', '011011', '0000', '100110', '11111', '011111', '1011', '110', '0100']",1,10,20,27,9,47,24.321645021645022,128,128
['1011011'],1,1,2,5,0,7,0,0,0
"['110010', '11']",1,2,3,5,0,8,0.5,4,4
"['101100', '1000100', '001111', '011', '1011']",1,5,12,14,2,26,5.959007659007659,30,33
"['011', '111111', '01111', '10011']",1,4,4,15,2,19,3.635353535353535,16,30
"['11011', '101111', '110101']",1,3,4,13,2,17,2.3030303030303028,6,19
['0000101'],1,1,5,2,0,7,0,0,0
"['001111', '101010', '10001', '1100011', '000111', '1100', '011000']",1,7,20,20,4,40,13.423776223776224,65,60
"['0', '011']",1,2,2,2,0,4,0.5,2,2
"['0001001', '01', '101']",1,3,7,5,0,12,1.6444444444444444,10,9
"['11110', '1000']",1,2,4,5,0,9,0.4444444444444444,3,2
"['0011011', '0000110', '01010']",1,3,11,8,2,19,2.0476190476190474,9,10
"['00100', '110', '100011']",1,3,8,6,0,14,1.4898989898989898,11,5
"['01', '111010']",1,2,3,5,0,8,0.5,4,2
"['110000', '110110', '1010']",1,3,8,8,2,16,2.0666666666666664,7,9
"['0', '1000000', '1001100', '1001111']",1,4,13,9,3,22,2.607142857142857,26,19
"['110', '01000', '1111011']",1,3,6,9,0,15,1.4333333333333333,12,6
"['1110111', '10111', '110011', '000', '01001', '0101']",1,6,12,18,2,30,8.823992673992674,43,45
"['1100', '110101']",1,2,4,6,0,10,0.8,2,4
"['010100', '010', '001', '00111']",1,4,10,7,2,17,3.573232323232323,16,20
"['010', '10', '110100', '1011111']",1,4,7,11,0,18,3.2726495726495726,22,13
"['001000', '101', '1001', '0001101', '00', '10010']",1,6,17,10,0,27,9.277794427794428,44,44
"['1100011', '101100', '101', '10']",1,4,8,10,0,18,3.6264957264957265,21,18
"['1001100', '0110']",1,2,6,5,0,11,0.7272727272727273,3,2
"['0000', '010001', '0110', '0010011']",1,4,14,7,2,21,3.741958041958042,16,17
"['01', '00', '001']",1,3,5,2,2,7,2.1,3,9
"['111100', '011', '101011', '10110', '0000', '0100001']",1,6,16,15,2,31,8.083344433344433,49,37
"['11011', '0101000', '11', '100', '000']",1,5,11,9,2,20,4.532539682539682,33,27
"['10001', '0101']",1,2,5,4,0,9,0.6666666666666666,2,3
"['111100', '111', '0010011']",1,3,6,10,0,16,1.528205128205128,12,14
"['111', '101000', '0001111', '1110100', '110']",1,5,11,15,4,26,5.5577533577533575,38,38
"['011101', '101', '010101', '0100']",1,4,9,10,2,19,3.9714285714285715,14,20
"['0001', '10010', '1', '010']",1,4,8,5,0,13,3.2214285714285715,15,12
"['1', '01110']",1,2,2,4,0,6,0.3333333333333333,4,0
"['1', '010111']",1,2,2,5,0,7,0.2857142857142857,5,2
"['001', '010', '001111', '000101', '10']",1,5,11,9,4,20,5.727777777777778,29,26
"['11110', '11', '11000', '101', '01000']",1,5,9,11,3,20,5.5285714285714285,26,26
"['1', '00001', '1100100', '0100100', '1100', '101111']",1,6,16,14,2,30,6.946742146742147,57,45
"['110000', '010001', '0100111', '001', '101101', '100', '110111']",1,7,18,19,6,37,12.747008547008546,65,63
"['10001', '110001', '00']",1,3,8,5,0,13,1.9805194805194803,8,8
"['110', '1', '0101110', '00100', '1100']",1,5,10,10,0,20,5.319264069264069,32,25
"['01010', '1', '0010000']",1,3,9,4,0,13,1.25,13,4
"['001', '111', '0001', '100', '000111', '0100101']",1,6,14,12,3,26,8.921900321900322,41,46
"['010', '111010']",1,2,4,5,0,9,0.6666666666666666,3,4
"['11000', '1000', '10']",1,3,7,4,0,11,2.126984126984127,6,10
"['01', '11011', '0111001', '0100010', '11000', '1110101', '10', '000000']",1,8,22,19,7,41,14.367565767565766,103,69
"['00101', '11', '111110', '10011', '0101001', '01000', '011000']",1,7,18,18,5,36,11.54084804084804,66,53
"['1001', '1']",1,2,2,3,0,5,0.4,3,4
"['0', '100', '110011', '111110']",1,4,6,10,2,16,2.6825396825396823,22,12
"['0', '10100', '11101', '001']",1,4,7,7,2,14,2.7666666666666666,18,12
"['1101001', '010', '00100', '1001000', '110101']",1,5,16,12,2,28,6.914868464868465,27,23
"['111111', '001', '011']",1,3,3,9,2,12,1.3333333333333333,10,8
"['11110', '11', '1001000', '100000', '10', '0100100']",1,6,17,12,4,29,7.442696192696193,53,39
"['1010111', '10', '11']",1,3,3,8,2,11,1.3888888888888888,11,11
"['0011', '0001', '100101']",1,3,8,6,2,14,2.15,5,8
"['1011', '11111', '10', '0010011']",1,4,6,12,0,18,2.901875901875902,20,21
"['01', '11110', '1100000', '1101100', '011110', '1011']",1,6,13,18,2,31,7.657997557997557,51,41
"['111', '011100', '101', '10', '1001100']",1,5,9,12,2,21,5.691452991452992,30,24
"['0', '101', '0010', '1100']",1,4,7,5,2,12,2.942857142857143,15,11
"['0000', '111111', '1111011']",1,3,5,12,0,17,1.104895104895105,13,12
"['0', '010110']",1,2,4,3,0,7,0.2857142857142857,5,4
"['11', '00', '00001']",1,3,6,3,2,9,0.8571428571428571,9,6
"['00110', '010011', '1111000']",1,3,9,9,0,18,1.6888111888111887,12,8
"['0011', '0010101', '10', '0111', '0101']",1,5,10,11,3,21,6.209595959595959,26,27
"['10100', '10001', '100001', '11']",1,4,10,8,2,18,3.697402597402597,15,26
"['101000', '0100000', '10', '111']",1,4,11,7,0,18,2.758119658119658,23,13
"['01', '000']",1,2,4,1,0,5,0.4,2,2
"['100110', '0010111', '101100', '000001']",1,4,14,11,3,25,3.358974358974359,20,16
"['11001', '010', '1101011', '000101', '001010', '00010', '0101']",1,7,20,16,4,36,14.425790875790875,53,60
"['0100010', '01110', '11']",1,3,7,7,0,14,1.6825396825396823,11,6
['1001110'],1,1,3,4,0,7,0,0,0
"['0', '000100', '01100']",1,3,9,3,0,12,1.3463203463203464,11,15
"['101011', '00']",1,2,4,4,0,8,0.5,4,0
"['00100', '1010101']",1,2,7,5,0,12,0.6666666666666666,3,0
"['100', '11111', '1000011', '01011', '0100101']",1,5,12,15,4,27,5.230952380952381,33,32
"['00101', '011', '1101101', '1011', '010011']",1,5,10,15,0,25,6.91040626040626,26,34
"['1011', '1011100']",1,2,4,7,0,11,0.7272727272727273,3,5
"['101', '010']",1,2,3,3,2,6,0.6666666666666666,2,0
"['1010110', '1', '100000', '0111', '1110110']",1,5,11,14,2,25,4.41068931068931,40,27
"['1001', '10']",1,2,3,3,0,6,0.6666666666666666,2,3
"['000110', '101', '11101', '10', '001100']",1,5,11,11,2,22,5.934559884559884,31,22
"['10', '0110001']",1,2,5,4,0,9,0.4444444444444444,5,2
"['0101', '100', '0111010', '101111']",1,4,8,12,0,20,3.5305583305583306,19,12
"['0011101', '11', '101011', '01111', '1110100', '0000010']",1,6,15,19,3,34,7.967920967920968,59,41
"['1000', '0010', '11101', '000']",1,4,10,6,2,16,3.353174603174603,14,17
"['110110', '0011010', '1010', '110111', '11111', '01001', '01110']",1,7,14,24,5,38,12.97047397047397,55,61
"['01', '100', '0000001', '1110101', '0000', '0011100']",1,6,19,11,3,30,7.484848484848484,58,49
"['101', '111']",1,2,1,5,2,6,0.6666666666666666,1,4
"['0010001', '00']",1,2,7,2,0,9,0.4444444444444444,5,4
"['0101', '1', '01110']",1,3,4,6,0,10,1.4,9,5
"['10000', '1111010', '111']",1,3,6,9,0,15,1.35,12,10
"['011', '01100', '01111', '011101', '0111111', '01000']",1,6,12,19,3,31,9.684382284382284,39,67
"['101', '110', '101001']",1,3,5,7,2,12,1.7777777777777777,8,11
"['0110000', '10001', '0011010', '1111']",1,4,12,11,2,23,3.2344877344877343,22,9
"['001111', '10110', '001010', '11']",1,4,8,11,2,19,3.5108225108225106,18,15
"['10101', '100000', '1']",1,3,7,5,0,12,1.1645021645021645,12,9
"['11110', '010', '1001', '11']",1,4,5,9,0,14,3.153968253968254,16,13
"['0', '100110', '01']",1,3,5,4,0,9,1.4523809523809523,10,6
"['101', '0010', '111']",1,3,4,6,2,10,1.5238095238095237,6,4
"['11001', '010', '1', '1011100', '1011']",1,5,8,12,0,20,4.993145743145743,33,24
"['0111000', '00', '11100', '011']",1,4,9,8,0,17,3.3492063492063493,19,22
"['0101110', '11', '1010101', '0010100', '000', '1101', '1110']",1,7,16,18,5,34,11.021861471861472,71,50
"['001', '1000111', '10100', '011110', '01000']",1,5,14,12,2,26,5.535586635586635,34,23
"['11010', '1', '0000100', '100010', '100000', '000000', '1011', '001011', '111001']",1,9,29,18,5,47,18.537379287379288,122,108
"['110000', '1', '0111110']",1,3,6,8,0,14,0.9972527472527473,15,4
"['00', '110111', '01100']",1,3,6,7,0,13,1.3668831168831168,12,6
"['010', '1111']",1,2,2,5,0,7,0.2857142857142857,3,0
"['1011', '01', '111000', '100']",1,4,7,8,0,15,2.954761904761905,18,15
"['0001', '111']",1,2,3,4,0,7,0.2857142857142857,3,2
"['011111', '1']",1,2,1,6,0,7,0.2857142857142857,5,2
['010110'],1,1,3,3,0,6,0,0,0
"['1110011', '0111011']",1,2,4,10,2,14,0.8571428571428571,2,5
"['101', '0111100', '100010']",1,3,8,8,0,16,1.528205128205128,13,5
"['0', '100', '0011101']",1,3,6,5,0,11,1.15,13,7
"['0100001', '01', '10110']",1,3,8,6,0,14,1.5158730158730158,12,8
"['1101111', '00101', '011100', '000', '011010']",1,5,13,14,2,27,5.7161227661227665,33,27
"['0010', '0100000', '11']",1,3,9,4,0,13,1.101010101010101,13,5
"['101', '0001100', '11101', '1100', '01000']",1,5,13,11,2,24,5.682034632034632,29,27
"['110000', '1010101', '01100']",1,3,10,8,0,18,1.8426573426573427,9,5
"['0011', '1111']",1,2,2,6,2,8,0.5,2,4
"['00001', '1111', '00', '100000', '0100011']",1,5,15,9,0,24,4.477722277722278,36,27
"['10100', '10']",1,2,4,3,0,7,0.5714285714285714,3,3
"['0100011', '001', '0111011']",1,3,8,9,2,17,1.4285714285714286,10,9
"['0', '1101']",1,2,2,3,0,5,0.4,3,0
"['11', '0101', '110', '0110001', '0100']",1,5,10,10,2,20,6.1918470418470415,26,25
"['11010', '1', '000', '1101']",1,4,6,7,0,13,2.407936507936508,17,13
"['001000', '1100', '11']",1,3,7,5,0,12,1.5166666666666666,10,8
"['0011', '0101']",1,2,4,4,2,8,0.75,2,2
"['111101', '0110110', '00000']",1,3,9,9,0,18,1.2972027972027973,12,4
"['00', '010111', '10']",1,3,5,5,2,10,1.5,9,6
"['1011', '0010111']",1,2,4,7,0,11,0.7272727272727273,3,3
"['010100', '0011011', '00101']",1,3,10,8,0,18,2.175990675990676,8,10
"['10101', '1', '011', '111001']",1,4,5,10,0,15,3.040764790764791,19,20
"['11', '1101', '0100']",1,3,4,6,2,10,1.5,7,6
"['1011001', '0010111', '1110101', '00', '11101', '010111', '011010', '1100']",1,8,18,26,5,44,17.038161838161837,88,83
"['10110', '001011', '01000']",1,3,9,7,2,16,1.8727272727272726,9,7
"['00110', '01001', '0111']",1,3,7,7,2,14,1.9333333333333331,7,7
"['11010', '11']",1,2,2,5,0,7,0.5714285714285714,3,4
"['1011', '1', '10011']",1,3,3,7,0,10,1.6222222222222222,8,15
"['000110', '11010', '11111', '0110010', '01011', '01110']",1,6,14,19,4,33,9.045687645687646,37,47
"['0010', '1', '00011', '001110', '0110011']",1,5,12,11,0,23,5.457159507159507,34,26
"['01101', '001', '0011', '0001', '010101', '110111']",1,6,13,15,4,28,9.085497835497835,33,45
"['0', '01111', '01110', '00011']",1,4,7,9,3,16,3.0,18,18
"['001', '1111110', '1111', '011101', '000']",1,5,8,15,2,23,4.383927183927184,35,27
"['1110000', '0000000']",1,2,11,3,2,14,0.5714285714285714,3,8
"['1111000', '1000100', '00101', '111']",1,4,11,11,2,22,3.071428571428571,24,19
"['0', '1011', '0010', '000111']",1,4,8,7,2,15,2.7857142857142856,19,12
"['0110', '011', '000']",1,3,6,4,2,10,1.7619047619047619,5,10
"['001', '100', '11101', '10', '01011']",1,5,8,10,4,18,5.609523809523809,25,24
"['1000110', '011']",1,2,5,5,0,10,0.6,4,2
"['11000', '1100']",1,2,5,4,0,9,0.8888888888888888,1,6
"['010100', '110000', '11110', '001', '101', '100', '1111']",1,7,14,16,5,30,10.99083694083694,59,58
"['0001', '10010', '110010']",1,3,9,6,0,15,2.175757575757576,6,10
"['0', '10111', '0001100']",1,3,7,6,0,13,1.0833333333333333,14,4
"['1011', '1110110', '1000', '1111111']",1,4,6,16,4,22,3.0324675324675323,21,22
"['1000001', '011', '111', '0']",1,4,7,7,2,14,2.216666666666667,22,12
"['0', '10', '0111']",1,3,3,4,0,7,1.4,7,6
"['0', '100110', '01001', '100011']",1,4,10,8,2,18,3.1926406926406927,22,12
"['0010', '11011', '11', '0001111', '10', '0000110']",1,6,13,14,4,27,7.629870129870129,53,41
"['000110', '1101', '10011', '01010']",1,4,10,10,2,20,3.7656565656565655,15,10
"['0010111', '10101', '1111', '110111', '010110', '0101']",1,6,11,21,4,32,10.054623154623155,35,51
"['0110010', '00', '10001']",1,3,9,5,0,14,1.6825396825396823,11,4
"['1000001', '110', '010010', '11']",1,4,10,8,0,18,3.2042735042735044,22,13
"['0', '01101', '10', '111']",1,4,4,7,0,11,2.7214285714285715,15,10
"['011111', '00', '100', '111100']",1,4,7,10,2,17,3.1055555555555556,21,21
"['0', '1010', '010010']",1,3,7,4,0,11,1.2857142857142856,10,10
"['11010', '11100', '101001', '11']",1,4,7,11,2,18,3.897402597402597,17,19
"['0010001', '1011', '1101', '000']",1,4,10,8,2,18,2.8305194805194804,20,14
"['0001011', '101', '0000010']",1,3,11,6,2,17,1.7142857142857144,11,6
"['0001', '100101', '111', '01010']",1,4,9,9,0,18,3.224098124098124,16,11
"['110110', '111', '100010']",1,3,6,9,2,15,1.7777777777777777,9,9
"['0011110', '10', '0111', '1110']",1,4,6,11,2,17,3.648989898989899,18,19
"['010100', '1', '10110', '10100', '100101', '010110', '0110001']",1,7,19,17,5,36,12.591292041292041,65,56
"['0101', '0110', '110']",1,3,5,6,2,11,2.1785714285714284,5,9
"['1100111', '1010000', '010', '011']",1,4,10,10,4,20,3.238095238095238,23,13
"['0011', '000101', '111010']",1,3,8,8,2,16,1.7000000000000002,10,8
"['101', '1110011', '0001111', '110011', '00', '10011', '0101', '1011111']",1,8,15,26,3,41,17.255649905649904,91,107
"['01', '00', '0110111']",1,3,5,6,2,11,1.3888888888888888,11,7
"['001', '010', '10010', '111']",1,4,7,7,3,14,3.333333333333333,13,12
"['10', '000010', '011000']",1,3,10,4,2,14,1.5,11,11
"['11110', '100001', '00001', '1010000', '101001']",1,5,17,12,4,29,5.768764568764569,27,39
"['01', '0100111', '0000', '1001100', '110']",1,5,13,10,2,23,4.7131313131313135,37,24
"['00', '001', '001011', '111101']",1,4,8,9,2,17,3.161111111111111,21,18
"['11001', '001101', '10101', '100', '10110', '000010', '000']",1,7,19,14,7,33,12.96010101010101,56,58
"['111000', '0100110', '1']",1,3,7,7,0,14,1.151098901098901,15,4
"['1011', '10101', '1']",1,3,3,7,0,10,1.6222222222222222,8,14
"['11110', '00', '01010', '00001']",1,4,10,7,3,17,2.4285714285714284,20,17
"['01', '001', '101', '1011000', '110']",1,5,9,9,3,18,5.711111111111111,28,26
"['110000', '10111', '10010', '1111111']",1,4,8,15,2,23,2.831934731934732,21,22
"['0010', '10111', '0110', '1010', '0111']",1,5,9,12,4,21,6.666666666666666,18,29
"['0011', '1', '111101']",1,3,3,8,0,11,1.0857142857142859,12,9
"['11', '101000', '10000', '10', '1010010']",1,5,13,9,2,22,5.563048063048063,30,32
['010000'],1,1,5,1,0,6,0,0,0
"['11101', '10', '0100']",1,3,5,6,0,11,1.6825396825396823,8,4
"['001', '101', '1111', '00', '001011', '0001000']",1,6,14,11,2,25,7.198790098790099,49,43
"['101', '1', '0010101', '0000']",1,4,9,6,0,15,2.3629870129870127,22,14
"['101', '11110', '011', '1011111']",1,4,4,14,2,18,3.533333333333333,19,21
"['001', '1', '0000000']",1,3,9,2,0,11,0.9,14,6
['0100101'],1,1,4,3,0,7,0,0,0
"['0111000', '110010', '10111', '1111', '10011', '0000', '110']",1,7,15,19,4,34,11.201121101121101,63,61
"['01', '00101', '11', '0110', '1010', '1110']",1,6,9,12,5,21,9.087301587301587,31,36
"['101100', '01', '100000', '111']",1,4,9,8,2,17,2.3166666666666664,21,14
"['1110', '1100000', '011101', '10', '1010011', '0010010', '0110110', '011000']",1,8,24,22,6,46,16.274347874347875,97,78
"['101100', '00', '0100111', '1']",1,4,8,8,0,16,2.0955433455433456,26,12
"['00', '0101', '011110', '11111']",1,4,6,11,0,17,2.9383838383838383,19,11
"['00111', '01100', '1110', '11']",1,4,6,10,2,16,3.742857142857143,16,17
"['10101', '01101', '10000', '000111']",1,4,11,10,3,21,3.418181818181818,18,17
"['111100', '10', '1', '011001']",1,4,6,9,2,15,2.9047619047619047,22,12
"['01111', '00', '1100011', '010011', '1001111']",1,5,11,16,2,27,5.8061383061383065,34,33
"['0011', '1110', '011000']",1,3,7,7,2,14,1.7,10,8
"['0001001', '11010', '001', '01111', '00', '100111']",1,6,14,14,2,28,8.356365856365857,49,39
"['100110', '00', '0001010', '11100', '01011']",1,5,14,11,2,25,5.529259629259629,34,29
"['00101', '011', '000', '1010010', '110']",1,5,12,9,3,21,5.6,28,24
"['1011110', '101000', '10100']",1,3,9,9,0,18,2.191142191142191,7,15
"['1100010', '0010', '1001']",1,3,9,6,2,15,2.2045454545454546,8,7
"['101', '1111001', '11']",1,3,3,9,0,12,1.8444444444444446,10,15
"['101', '1000', '110', '0110100']",1,4,9,8,2,17,3.554978354978355,17,12
"['1', '001101', '101010', '1000110', '100']",1,5,12,11,2,23,4.9171550671550674,37,26
"['100000', '001', '1', '0100']",1,4,10,4,0,14,2.8015873015873014,19,13
"['01', '010', '0111', '0000', '1110']",1,5,9,8,3,17,5.097619047619047,23,28
"['0010', '1', '10111', '1000', '0110110']",1,5,10,11,2,21,4.77979797979798,34,19
"['111100', '1000101', '00011', '00100', '101110', '1001011', '0100']",1,7,21,19,6,40,12.748051948051948,63,59
"['0010', '01101', '10111', '0010101', '00', '01011', '01100']",1,7,17,16,4,33,12.76060606060606,55,61
"['001', '1000110', '100110', '1000', '111101']",1,5,13,13,2,26,6.414940614940615,30,33
"['00', '111', '0100']",1,3,5,4,0,9,0.9523809523809523,8,6
"['101100', '1011010', '100100', '0001111', '1000000', '010101', '0000', '0110011']",1,8,29,21,7,50,17.08987678987679,90,90
['0111111'],1,1,1,6,0,7,0,0,0
"['01', '11110', '0011111']",1,3,4,10,0,14,1.3968253968253967,12,9
"['1011011', '1', '011110', '01010']",1,4,7,12,0,19,3.0322177822177823,23,10
"['0000', '0011101', '01100', '0100']",1,4,13,7,2,20,3.409090909090909,15,29
"['0', '10111', '100', '1110']",1,4,5,8,0,13,2.9714285714285715,16,13
"['0', '11000', '111000']",1,3,7,5,0,12,1.528138528138528,10,11
"['01', '111010', '1101000', '1101110', '0001101', '1110001', '111110', '100000']",1,8,22,26,7,48,15.673382173382173,97,86
"['0', '011011', '0111']",1,3,4,7,0,11,1.4857142857142858,10,9
"['1100', '000', '1111111']",1,3,5,9,0,14,0.935064935064935,14,8
"['0001', '110', '0000100', '111']",1,4,10,7,2,17,2.5653679653679653,21,15
"['101100', '001101', '0001', '100101', '000', '0111']",1,6,16,13,5,29,9.02063492063492,37,44
"['0010', '111100', '101', '1000', '110']",1,5,10,10,4,20,5.813492063492063,26,24
"['0', '0101011', '1001010', '110101']",1,4,10,11,2,21,3.0384615384615383,24,11
"['0', '11110', '1101111', '101000', '1011101', '1111111']",1,6,9,24,3,33,7.033966033966034,56,50
"['101', '0001', '1001', '1110', '1011111']",1,5,8,14,3,22,5.554545454545455,30,36
"['0010', '100', '1']",1,3,5,3,0,8,1.4714285714285715,7,5
"['1110111', '01', '11110', '101', '10011', '0100100', '000', '110']",1,8,15,20,7,35,14.091269841269842,91,70
"['0010', '101010', '01111', '00', '0111']",1,5,10,11,2,21,5.364502164502165,27,31
"['11001', '111101', '0111100']",1,3,6,12,0,18,2.163170163170163,8,6
"['1011', '1100001', '1011100', '11']",1,4,8,12,2,20,3.3997113997113995,23,26
"['0', '11001', '0100000', '00101', '110001', '0010011', '0111101', '1110']",1,8,22,20,5,42,14.43064158064158,102,74
"['01101', '010', '100']",1,3,6,5,2,11,1.9166666666666665,7,7
"['1', '10', '0001000']",1,3,7,3,0,10,1.3611111111111112,12,4
"['00100', '00', '11010']",1,3,8,4,2,12,1.7428571428571429,9,12
"['1011010', '01', '111100']",1,3,6,9,0,15,1.4636752136752138,12,6
"['0100001', '1000100', '110110']",1,3,12,8,2,20,1.6483516483516483,10,6
"['110110', '00', '000101']",1,3,8,6,2,14,1.5,12,8
"['110000', '0010001', '01', '1', '1100', '0100']",1,6,15,9,2,24,7.734937284937285,49,40
"['1011010', '1011', '111001']",1,3,6,11,0,17,2.0965034965034963,9,12
"['0010', '1', '011', '00111', '0001011']",1,5,10,10,0,20,5.632034632034632,30,26
"['0010', '1000101', '111100', '101', '0001', '1110011', '11111', '011111']",1,8,16,26,6,42,15.883832833832834,93,97
"['1101111', '00111', '1100000', '110011', '10010', '110']",1,6,14,19,4,33,8.901065601065602,48,61
['0110101'],1,1,3,4,0,7,0,0,0
"['0', '0100010', '0111001', '0000111']",1,4,13,9,3,22,2.75,29,15
"['1', '10000', '10']",1,3,5,3,0,8,1.5714285714285714,8,7
"['11', '101', '000000', '1011', '01100']",1,5,11,9,0,20,4.8477633477633475,32,22
"['11010', '11', '00011', '101', '011101', '10011']",1,6,10,16,3,26,9.099134199134198,40,50
"['1010', '1100', '001110', '11']",1,4,7,9,2,16,3.583333333333333,16,14
"['10100', '001', '1110']",1,3,6,6,0,12,1.2301587301587302,8,7
"['1101', '1001', '1']",1,3,3,6,2,9,1.55,7,13
"['01', '010', '00111', '00110', '11100']",1,5,10,10,3,20,5.978571428571429,27,31
"['0011001', '01', '1']",1,3,5,5,0,10,1.3611111111111112,12,7
"['1111100', '001', '0010000', '1001010', '0001010', '01001', '111001']",1,7,24,18,4,42,12.723060273060273,76,65
"['11001', '1111101', '10110', '00', '1101']",1,5,8,15,2,23,5.914574314574314,31,29
"['1010010', '100111', '01100', '1111']",1,4,9,13,0,22,3.417404817404817,19,15
"['01', '0010', '11', '00110', '1010', '110']",1,6,10,10,4,20,9.374603174603175,28,40
"['0110100', '0001', '10001', '1001', '111011']",1,5,13,13,2,26,6.097707847707848,28,30
"['0001', '100000', '011', '0111']",1,4,10,7,2,17,2.9507936507936505,18,17
['0010111'],1,1,3,4,0,7,0,0,0
"['110', '10', '001000']",1,3,7,4,0,11,1.7444444444444445,9,7
"['110000', '1110011', '0101010', '100000', '1110110', '101001']",1,6,20,19,6,39,9.681318681318682,43,40
"['00', '1', '0100100']",1,3,7,3,0,10,0.6944444444444444,13,6
"['00101', '101', '100100', '0101011', '000']",1,5,14,10,2,24,6.375990675990676,28,26
"['00', '011010', '001110', '1']",1,4,8,7,2,15,2.4047619047619047,22,15
"['011101', '11110', '01', '0011110']",1,4,7,13,0,20,3.55999555999556,20,18
"['0', '000011', '10111', '1101011', '1111', '10011']",1,6,10,18,2,28,7.628876678876679,46,60
"['1000', '001', '0100']",1,3,8,3,2,11,1.8928571428571428,6,9
"['1010111', '1010110', '1111111']",1,3,5,16,3,21,1.5714285714285714,6,17
"['010', '0001111', '01010', '111000', '110101']",1,5,13,14,2,27,5.623581973581974,36,28
"['00111', '101', '1001', '10', '11111']",1,5,6,13,2,19,5.606349206349206,26,34
"['001111', '0000100', '0110', '01011', '1110', '0100']",1,6,16,14,3,30,8.702952602952603,43,53
"['1000', '111110', '111']",1,3,4,9,0,13,1.3523809523809525,10,10
"['00100', '10111', '100100', '0110', '0101']",1,5,13,11,4,24,6.2712121212121215,23,25
"['100', '0010100', '010010', '00001']",1,4,15,6,0,21,3.609324009324009,18,20
['0101010'],1,1,4,3,0,7,0,0,0
"['00100', '0100', '0010011']",1,3,11,5,0,16,2.4494949494949494,6,18
"['00010', '1010101', '1', '0100100']",1,4,12,8,2,20,2.880952380952381,24,9
"['011', '1110', '0010011']",1,3,6,8,0,14,1.535064935064935,11,10
"['100', '1', '000']",1,3,5,2,2,7,1.1666666666666665,6,6
"['11', '001000', '101', '1110011', '1010']",1,5,10,12,0,22,5.66969141969142,33,26
"['100101', '000', '11']",1,3,6,5,0,11,1.1666666666666665,10,4
"['000101', '1', '0000']",1,3,8,3,0,11,1.0857142857142859,11,8
"['0101000', '111', '1011110', '00', '011111']",1,5,10,15,2,25,4.607753357753357,40,25
"['1001000', '00', '11111', '010011', '110']",1,5,11,12,0,23,4.001243201243201,39,25
"['100110', '1', '01110']",1,3,5,7,0,12,1.3463203463203464,11,6
"['11110', '1101100', '1111010', '100110', '10010', '01001', '0101']",1,7,17,22,5,39,13.42011322011322,58,62
"['1001', '0011100', '11111']",1,3,6,10,0,16,1.4898989898989898,12,4
"['11011', '001', '100001', '000001', '0111101', '1100', '111101']",1,7,17,20,3,37,11.723332223332223,65,76
"['0110101', '1010001', '10', '11']",1,4,8,10,4,18,2.992063492063492,24,16
"['1000100', '01', '11110', '01110', '110101']",1,5,11,14,2,25,4.974547674547674,33,24
"['01', '0010100', '01110']",1,3,8,6,0,14,1.6825396825396823,11,9
"['1010', '0100000', '001110', '10000']",1,4,15,7,0,22,3.4524475524475524,19,21
"['11', '101', '0001', '01001', '1110']",1,5,8,10,2,18,5.847619047619047,23,28
"['0011001', '00010', '1100100']",1,3,12,7,2,19,2.0476190476190474,10,9
"['101', '10001', '000101', '0010101', '1010', '111111', '0100001']",1,7,19,19,4,38,12.197641247641247,64,69
"['1110100', '111110', '10010', '001011']",1,4,10,14,2,24,3.167832167832168,19,18
"['1', '10', '000011']",1,3,5,4,0,9,1.2023809523809523,11,6
"['1111', '1000', '10', '0111', '1011000', '1011111']",1,6,10,18,5,28,7.498196248196248,51,55
"['1010111', '011', '0111', '0001111']",1,4,7,14,2,21,4.2259740259740255,18,24
"['00', '110', '1']",1,3,3,3,0,6,0.9,6,4
"['11110', '01', '1000101', '0100']",1,4,9,9,0,18,2.72005772005772,22,12
"['0011001', '11000', '1101101', '0110', '111110', '000', '1100111', '01000']",1,8,21,23,5,44,16.673071373071373,89,85
"['100010', '1111010', '10', '10011', '000']",1,5,12,11,0,23,5.158530358530358,34,27
"['0', '1100', '0111', '11001']",1,4,6,8,2,14,2.966666666666667,17,15
['1011110'],1,1,2,5,0,7,0,0,0
"['1000111', '01111', '01000']",1,3,8,9,2,17,1.7333333333333334,10,7
"['11110', '110010', '1011110', '00111', '111110']",1,5,9,20,4,29,6.53006993006993,24,45
"['1011', '0101', '111', '0100']",1,4,6,9,3,15,3.4285714285714284,12,14
"['110000', '101', '110111', '11']",1,4,6,11,2,17,3.411111111111111,19,27
"['01101', '111', '0010100', '10', '1110']",1,5,9,12,0,21,5.786652236652237,29,23
"['01', '101101', '0111', '011110', '0110010', '0100']",1,6,13,16,4,29,9.737451437451437,43,46
"['1000011', '00100', '001101']",1,3,11,7,0,18,1.8426573426573427,10,7
"['01001', '00', '1', '100011']",1,4,8,6,0,14,2.4177489177489178,21,10
"['0', '1010', '1001001', '001100', '1110']",1,5,12,10,2,22,4.588161838161838,34,20
"['0', '01101', '010101', '100']",1,4,8,7,0,15,3.012987012987013,18,15
"['011', '000000', '0111100']",1,3,10,6,0,16,1.12991452991453,13,12
"['011011', '0100010', '1010', '00', '0101', '0110110']",1,6,16,14,4,30,9.852242202242202,43,51
['110000'],1,1,4,2,0,6,0,0,0
"['0', '0011', '1001101']",1,3,6,6,0,12,1.3772727272727274,12,4
"['0', '00100', '0101', '1001111']",1,4,9,8,0,17,2.6954545454545453,23,10
"['0', '110110', '001', '0101110', '00111', '1100110']",1,6,13,16,2,29,8.265540015540015,50,45
"['0011110', '000100', '10', '11']",1,4,9,8,2,17,2.7542735042735043,23,13
"['010000', '111', '1010', '0100100', '0100']",1,5,15,9,2,24,5.825169275169275,29,34
"['1001110', '100', '001111', '011000']",1,4,11,11,2,22,3.595726495726496,22,17
"['011101', '0111010', '111', '000']",1,4,8,11,2,19,3.2341880341880342,19,15
"['00100', '10001', '1']",1,3,7,4,2,11,1.2666666666666666,11,4
"['0001011', '110', '1110']",1,3,6,8,0,14,1.6207792207792209,11,11
"['01', '1111', '10010', '0111', '01110', '011000']",1,6,11,15,4,26,8.691847041847042,40,43
"['1011010', '00101', '11']",1,3,6,8,0,14,1.5158730158730158,11,6
"['00', '0000100', '0111']",1,3,9,4,0,13,1.1414141414141414,13,12
"['010', '111010', '0101011', '0010011', '1100']",1,5,13,14,2,27,6.263070263070263,32,32
"['0010', '100010', '1111']",1,3,7,7,2,14,1.4500000000000002,9,7
"['11110', '11000', '100', '1001', '10100', '00010', '01110', '110101']",1,8,19,19,5,38,17.103607503607503,68,74
"['0010001', '001', '001011']",1,3,10,6,0,16,2.0358974358974358,9,15
"['01', '1000', '10000', '110100']",1,4,11,6,0,17,3.1533910533910534,16,19
"['1001011', '100010', '000', '11']",1,4,10,8,0,18,2.9803418803418804,21,14
"['000010', '1110', '111001']",1,3,8,8,2,16,1.7000000000000002,10,8
"['1000011', '0111000', '1101000', '1110']",1,4,13,12,3,25,3.6363636363636362,22,16
"['100', '1111', '1010', '11101', '10011']",1,5,7,14,4,21,5.95952380952381,21,37
"['000110', '11011', '010', '101101']",1,4,9,11,2,20,3.7727272727272725,18,9
"['101', '01', '0111001', '11100']",1,4,7,10,0,17,3.4634920634920636,19,16
"['0', '101', '0010010', '010011']",1,4,10,7,0,17,3.0716117216117214,22,10
"['00110', '0010', '011']",1,3,7,5,0,12,2.2103174603174605,5,11
"['00111', '1100010', '000100', '100000']",1,4,16,8,2,24,3.780885780885781,18,19
"['0', '101', '1101', '10000']",1,4,7,6,0,13,3.034920634920635,16,13
"['00', '10', '11']",1,3,3,3,3,6,1.0,4,4
"['1110010', '100', '0101001']",1,3,9,8,2,17,1.9142857142857141,11,6
"['01', '00011', '00111', '10000', '10010', '11111']",1,6,13,14,5,27,7.685714285714286,43,43
"['001', '000', '1100110']",1,3,8,5,2,13,1.8666666666666667,9,8
"['0011101', '1101101', '0011010', '10', '000', '000010']",1,6,18,14,3,32,8.18131868131868,54,50
"['00011', '1001', '11101', '10', '000111', '0100']",1,6,13,13,4,26,8.267243867243867,44,40
"['0001010', '01000', '11']",1,3,9,5,0,14,1.2301587301587302,12,6
"['001', '010', '1010', '000000', '0001011', '0000111']",1,6,20,10,4,30,8.581129981129981,51,51
"['00111', '10', '00001']",1,3,7,5,2,12,1.1714285714285713,10,7
"['00', '010', '011110']",1,3,6,5,0,11,1.9666666666666668,8,14
"['1010', '1000', '0011110', '01111']",1,4,9,11,2,20,2.9772727272727275,19,15
"['0', '001110', '001101']",1,3,7,6,2,13,1.4047619047619047,12,11
"['001111', '1100010', '100', '00', '111000']",1,5,13,11,2,24,5.6863247863247866,38,33
"['0', '1111101', '10']",1,3,3,7,0,10,1.3611111111111112,12,4
"['00100', '100', '000101', '0100', '110011', '111110', '0000', '0101', '01110', '011000']",1,10,28,21,9,49,26.92020202020202,122,151
"['00', '0010', '010001', '1011100']",1,4,12,7,0,19,3.19013209013209,22,19
"['0', '010', '001111']",1,3,5,5,0,10,1.2301587301587302,11,8
"['01', '110010', '100', '1001111']",1,4,8,10,0,18,3.2264957264957266,22,15
"['001000', '00011', '10111', '101011', '1001', '0011', '01010', '000000', '110']",1,9,25,19,8,44,20.5504329004329,98,104
"['101', '110', '0100']",1,3,5,5,2,10,1.8095238095238093,6,4
"['100', '10', '110100']",1,3,6,5,0,11,1.9666666666666668,8,9
"['010001', '111', '0010000', '100010', '1111010']",1,5,16,13,4,29,5.412332112332113,36,24
"['01', '0010', '011100', '0011010', '0110010']",1,5,15,11,2,26,6.305705405705406,31,47
"['01', '00010', '1101']",1,3,6,5,0,11,1.6825396825396823,8,5
"['101', '0001000', '0000']",1,3,11,3,0,14,1.412987012987013,11,12
"['00111', '1100100', '1101110']",1,3,8,11,2,19,1.880952380952381,9,11
"['1010110', '1010101', '00001']",1,3,10,9,2,19,1.5238095238095237,9,11
"['0101', '111010', '1111', '1000010', '111000', '110']",1,6,13,17,4,30,8.74938394938395,44,49
"['010100', '010', '1']",1,3,6,4,0,10,1.4523809523809523,10,6
"['0111', '00', '0010', '010110']",1,4,9,7,2,16,3.1999999999999997,15,22
"['0', '11011', '100001', '0011000']",1,4,11,8,0,19,2.52988677988678,26,8
"['00100', '1010', '1001000']",1,3,11,5,0,16,2.2272727272727275,7,9
"['01', '00', '0100111', '011100']",1,4,9,8,2,17,3.0042735042735043,23,19
"['11110', '01101', '1000', '10', '01000']",1,5,11,10,3,21,5.758730158730159,26,26
"['01101', '1', '000011', '10001', '1101']",1,5,10,11,2,21,4.980663780663781,31,32
['1010001'],1,1,4,3,0,7,0,0,0
"['011', '0011010', '10010', '0000', '01100', '1110']",1,6,16,12,4,28,8.552092352092352,39,48
"['0000', '11', '1110', '0111100']",1,4,8,9,2,17,2.452020202020202,21,14
"['110010', '001', '100', '1010', '000010', '1100111']",1,6,16,13,4,29,9.582572982572982,43,44
"['011', '01011', '01110']",1,3,5,8,2,13,2.1,6,12
"['110000', '010', '1111', '10', '0111']",1,5,8,11,2,19,4.818253968253968,30,27
"['01', '0111111', '01110']",1,3,4,10,0,14,1.6825396825396823,11,11
"['011111', '00', '0100010']",1,3,8,7,0,15,1.1559829059829059,14,9
"['0110000', '01', '1100100']",1,3,10,6,2,16,1.746031746031746,12,8
"['00', '0111001', '1101011', '0100']",1,4,10,10,2,20,3.2568542568542567,22,13
"['011', '000', '11']",1,3,4,4,2,8,1.1333333333333333,6,6
"['11001', '11', '10111', '000101', '100110', '0110110']",1,6,13,18,4,31,8.963525363525363,48,40
"['0', '00110', '001011']",1,3,7,5,0,12,1.3463203463203464,11,10
"['010010', '1000100', '00110', '10']",1,4,13,7,0,20,3.5251970251970253,20,19
"['1011010', '101101', '1000010', '00', '1000', '011010']",1,6,18,14,4,32,9.834643134643136,44,51
"['001', '10', '111', '010110']",1,4,6,8,2,14,2.522222222222222,16,11
"['0000101', '0010', '001', '1101111']",1,4,11,10,2,21,3.3766233766233764,22,15
"['100', '0110', '0000100']",1,3,10,4,0,14,1.7168831168831167,10,11
"['0010', '1001', '00110', '000000', '0101', '11100']",1,6,18,10,5,28,8.936868686868687,43,42
"['111000', '0110', '010010', '1011100', '000', '000100']",1,6,20,12,3,32,9.532034632034632,44,63
"['01', '110', '0101001']",1,3,6,6,0,12,1.2444444444444445,11,8
"['01000', '111101', '0100110', '01010']",1,4,12,11,2,23,3.9911421911421914,16,20
"['01', '101', '0001', '1101011', '001001']",1,5,11,11,0,22,5.828227328227328,30,30
"['1100001', '100', '00', '011']",1,4,9,6,2,15,2.977777777777778,20,13
"['10001', '1000', '111']",1,3,6,6,0,12,1.6746031746031744,7,11
['1010111'],1,1,2,5,0,7,0,0,0
"['0000101', '001', '01110']",1,3,9,6,0,15,1.6,11,8
"['01', '10101', '111010']",1,3,5,8,0,13,1.7987012987012987,9,7
"['01100', '111', '1000111']",1,3,6,9,0,15,1.6,12,8
"['1111000', '010010', '011']",1,3,8,8,0,16,1.682051282051282,12,8
"['1011', '010101', '010110', '000']",1,4,10,9,2,19,4.052380952380952,15,13
"['11110', '110010', '011', '1100010', '00', '1101', '0101']",1,7,14,17,2,31,11.905544455544455,59,62
"['0111101', '011100', '0100']",1,3,8,9,0,17,2.114685314685315,8,15
"['011111', '1100000', '100']",1,3,8,8,0,16,1.12991452991453,15,8
"['10001', '001', '000001', '0000']",1,4,14,4,0,18,4.182034632034632,13,26
"['10111', '10', '011001']",1,3,5,8,0,13,1.7987012987012987,10,7
"['1001001', '010', '11']",1,3,6,6,0,12,1.4444444444444444,11,4
"['0', '100', '0110011']",1,3,6,5,0,11,1.35,12,6
"['1001110', '11', '10100', '11101', '0111', '0101']",1,6,10,17,4,27,9.154473304473305,41,42
"['0', '000110', '010', '11011']",1,4,8,7,0,15,2.831168831168831,20,13
"['11001', '01000', '11']",1,3,6,6,2,12,1.457142857142857,9,6
"['0101', '0000010', '011100', '0101000']",1,4,16,8,2,24,3.378221778221778,19,27
"['10100', '00', '0001', '011']",1,4,9,5,0,14,3.153968253968254,15,17
"['00101', '0001', '10110', '010010', '00']",1,5,14,8,2,22,6.275180375180375,26,29
"['1010100', '1', '011', '100001']",1,4,9,8,0,17,2.5416971916971915,24,15
"['0011', '0011110', '11101', '000']",1,4,9,10,0,19,3.25981240981241,20,18
"['00111', '0101', '0010001', '101110']",1,4,11,11,0,22,3.8494172494172494,17,15
['1101111'],1,1,1,6,0,7,0,0,0
"['101', '001001', '111100', '011']",1,4,8,10,4,18,3.388888888888889,20,15
"['0010110', '100', '110', '01011']",1,4,9,9,2,18,3.5,17,16
"['1010101', '100111', '0111100']",1,3,8,12,2,20,1.8131868131868132,10,5
"['00111', '01', '0011110', '0111010']",1,4,9,12,2,21,3.817460317460317,20,20
"['00', '100', '111', '101101']",1,4,6,8,2,14,2.966666666666667,16,13
"['001100', '010', '1100']",1,3,8,5,0,13,2.038095238095238,7,12
"['001001', '11000', '000', '011010', '110', '0100']",1,6,17,10,4,27,9.426695526695527,36,51
"['0001001', '01111', '110100', '1000', '010111', '01110']",1,6,16,17,4,33,8.106526806526807,45,43
"['010001', '0110100', '001000', '100', '011110', '110', '111001']",1,7,20,17,6,37,12.96923076923077,63,57
"['001', '100', '1000', '0000011', '101110']",1,5,14,9,2,23,5.813342213342213,33,31
"['011', '00000', '100', '001010', '000010', '0101']",1,6,19,8,4,27,8.881601731601732,39,52
"['1', '0110100', '00000', '1010101', '01011']",1,5,14,11,4,25,4.114285714285714,39,19
"['101001', '110010', '1', '0101100']",1,4,10,10,2,20,3.0393772893772892,24,10
['010111'],1,1,2,4,0,6,0,0,0
"['1010', '0101111', '11']",1,3,4,9,0,13,1.6565656565656566,11,8
"['0111001', '00111', '100', '01010', '11111', '0001011', '000']",1,7,17,18,7,35,11.278571428571428,67,59
"['01', '0110111', '101011', '10110', '1010']",1,5,9,15,0,24,6.58005328005328,29,30
"['1111', '00', '0001011', '0001010', '000111', '111101']",1,6,15,17,4,32,7.738689088689089,53,59
"['010', '001001', '0000000', '111111']",1,4,13,9,2,22,2.2376068376068377,27,12
"['0010', '111011', '1101110', '100111', '100011', '010011']",1,6,14,21,4,35,9.848018648018648,40,52
"['0011', '1001', '010010', '1010000']",1,4,13,8,2,21,3.8283216783216782,18,12
"['110000', '010', '10001', '1000', '101110']",1,5,14,10,2,24,6.244155844155844,27,26
"['0', '11', '00101', '111011']",1,4,5,9,0,14,2.2359307359307357,21,14
"['00111', '010101', '01010']",1,3,8,8,2,16,2.2363636363636363,6,10
"['011100', '0110', '011', '1110']",1,4,7,10,2,17,4.445238095238095,11,23
"['11110', '01101', '0000100', '101', '1101100']",1,5,13,14,4,27,5.421428571428572,34,24
"['101', '001010', '001011']",1,3,8,7,2,15,2.1666666666666665,7,8
"['01', '1101100', '11111', '0110110', '0100']",1,5,10,15,2,25,5.708513708513708,34,25
"['010', '011100', '101010', '0111111', '1101', '1011111']",1,6,11,22,4,33,8.645354645354645,49,41
"['1111100', '001', '001111', '011', '0110', '100101', '0000111']",1,7,16,20,6,36,12.609590409590409,71,60
"['011111', '0100101', '1101010']",1,3,8,12,2,20,1.7912087912087913,10,8
"['0000101', '01', '001']",1,3,8,4,0,12,1.8444444444444446,10,10
"['110010', '1', '0000100', '1001101']",1,4,12,9,2,21,2.741758241758242,26,10
"['01', '010', '00001', '011011', '00011', '100']",1,6,14,10,4,24,8.32972582972583,40,40
"['1000000', '1', '10000']",1,3,10,3,0,13,1.4166666666666667,12,13
"['0101000', '111', '00', '10010', '1011', '1101']",1,6,12,13,2,25,7.685353535353535,44,34
"['011111', '1', '100111']",1,3,3,10,2,13,1.2380952380952381,13,10
"['100110', '01', '10000', '1110']",1,4,9,8,0,17,3.0907647907647906,18,16
"['110011', '101', '1000', '0010']",1,4,9,8,2,17,3.5095238095238095,15,12
"['001000', '111011', '001110', '01001', '1100']",1,5,14,13,3,27,5.951515151515151,30,26
"['0101000', '1', '10']",1,3,6,4,0,10,1.3611111111111112,12,4
"['01101', '101010', '101', '11000', '1101100', '0111', '011001', '1101']",1,8,17,23,6,40,19.121073371073372,70,88
['0111000'],1,1,4,3,0,7,0,0,0
"['101000', '01', '011']",1,3,6,5,0,11,1.7444444444444445,9,7
"['101', '110', '001011', '0100']",1,4,8,8,2,16,3.5206349206349206,16,12
"['01', '011', '111', '00', '10010']",1,5,7,8,4,15,4.90952380952381,22,21
"['110110', '0111111', '000', '01110']",1,4,8,13,0,21,2.818104118104118,21,20
"['0100001', '1101', '10101', '000000']",1,4,14,8,0,22,2.875990675990676,19,14
"['1000', '000011', '11']",1,3,7,5,0,12,1.4333333333333333,10,10
"['1010', '0110', '011']",1,3,5,6,2,11,1.9285714285714284,5,9
"['101100', '010001', '101', '01000', '111001']",1,5,14,12,3,26,6.626262626262626,25,29
"['0101110', '101001', '00', '1101', '0100101']",1,5,13,13,2,26,5.550993450993451,36,22
"['0', '11100', '10110', '011']",1,4,6,8,2,14,3.216666666666667,17,13
"['1101000', '1', '011', '0010100']",1,4,10,8,2,18,2.7142857142857144,26,13
"['01', '0010', '1', '00000']",1,4,9,3,0,12,2.6857142857142855,17,12
"['01111', '1111', '10', '1011', '01100']",1,5,6,14,4,20,5.623809523809523,24,30
"['101', '10110', '1110']",1,3,4,8,0,12,2.2103174603174605,5,10
"['0010', '10001', '0001', '10100', '001100']",1,5,16,8,4,24,6.6893939393939394,24,33
"['0001', '10011', '0100100', '101001', '0100']",1,5,16,10,2,26,7.051048951048951,25,27
"['011101', '1100', '1']",1,3,4,7,0,11,1.2857142857142856,11,6
"['1000000', '00', '01010']",1,3,11,3,0,14,1.5158730158730158,12,10
"['1010100', '1', '1011000', '00001']",1,4,12,8,2,20,2.5238095238095237,26,18
"['10111', '00', '11100']",1,3,5,7,2,12,1.457142857142857,10,8
"['0011', '01111', '0001111', '1000', '1011']",1,5,10,14,3,24,5.957070707070707,28,35
"['101', '1', '10000', '1101010']",1,4,8,8,0,16,2.85,22,15
"['1000', '000', '111001']",1,3,8,5,0,13,1.9015873015873015,8,8
"['11110', '0100010', '100', '10100', '010110', '101110', '1011111']",1,7,17,22,6,39,13.272044622044621,60,68
"['110', '111', '00101']",1,3,4,7,2,11,1.6666666666666665,7,8
"['110111', '0000011', '00011']",1,3,9,9,0,18,1.8403263403263403,9,16
"['0011', '00010', '1010101', '1010000']",1,4,14,9,2,23,3.4567099567099566,18,17
"['1000010', '11011', '10000', '11']",1,4,10,9,2,19,3.034920634920635,21,22
"['0001', '001', '01100']",1,3,8,4,0,12,1.8015873015873014,7,11
"['0101', '110111', '0111']",1,3,4,10,2,14,2.15,6,11
"['101', '00', '10', '11']",1,4,4,5,3,9,3.0,8,11
"['01', '11', '00111', '001000', '0000']",1,5,12,7,2,19,4.3160894660894655,31,31
"['01', '110', '11']",1,3,2,5,2,7,1.7000000000000002,4,8
"['101000', '01111', '10', '11111']",1,4,6,12,2,18,2.5987012987012985,21,19
"['010100', '111', '1000', '01011', '0101001']",1,5,13,12,0,25,5.903740703740704,26,32
"['00', '01001', '1']",1,3,5,3,0,8,0.9047619047619047,9,4
"['1101001', '0001001', '11011', '101', '1011100', '110']",1,6,14,18,5,32,9.223809523809523,50,54
"['0', '001111', '011']",1,3,4,6,0,10,1.4523809523809523,10,7
"['000110', '11', '1000', '001010', '1100']",1,5,13,9,4,22,5.783333333333333,29,28
"['100110', '11010', '10', '01110']",1,4,8,10,2,18,3.5155844155844154,16,20
"['101011', '01000', '11']",1,3,6,7,0,13,1.331168831168831,11,6
"['010', '00100', '110100', '1011011', '110']",1,5,12,12,2,24,6.292657342657343,30,27
"['00', '1101', '11']",1,3,3,5,2,8,1.0,7,6
"['00111', '101', '010010']",1,3,7,7,0,14,1.712121212121212,9,4
"['1110101', '001100', '0110', '10']",1,4,9,10,0,19,3.571950271950272,21,11
['0010011'],1,1,4,3,0,7,0,0,0
['110110'],1,1,2,4,0,6,0,0,0
"['0011', '001', '10010', '000']",1,4,10,5,2,15,4.261904761904762,10,18
"['1111000', '10101', '0010100']",1,3,10,9,2,19,1.7380952380952381,11,6
"['101000', '001111', '0101100']",1,3,10,9,2,19,1.717948717948718,9,9
"['101100', '100001', '111', '0011', '101', '0001111']",1,6,13,16,4,29,8.535941835941836,47,51
"['0011', '11010', '1', '0001000']",1,4,10,7,0,17,2.473232323232323,24,13
"['0011', '101000', '1101011', '010110', '0111', '011111', '101111']",1,7,14,25,6,39,12.984265734265735,58,67
"['11', '10110', '0111', '1100', '01110', '0100']",1,6,10,14,5,24,9.58174603174603,32,42
"['0011', '10010', '11', '0000']",1,4,9,6,2,15,3.071428571428571,15,14
"['00', '1', '0110']",1,3,4,3,0,7,1.0666666666666667,7,4
"['1111100', '110010', '0001', '0001100', '11111', '0100011', '01011', '1110']",1,8,20,25,7,45,15.067005217005217,95,96
"['00', '100', '0001']",1,3,7,2,0,9,2.038095238095238,5,11
"['11', '100', '1111001', '110100', '000']",1,5,10,11,2,21,4.737606837606838,32,29
"['1000', '010', '100', '1011000']",1,4,11,6,2,17,4.022510822510823,16,21
"['1001000', '0110', '1001111', '0100']",1,4,12,10,4,22,3.5032467532467533,20,15
"['0100001', '00011', '01001', '11']",1,4,11,8,2,19,3.8873015873015873,18,19
"['0010001', '11', '0101010', '01110', '0100']",1,5,14,11,2,25,5.795815295815296,33,26
"['0001001', '00011', '11000', '101', '1111', '000000', '1010000']",1,7,23,14,4,37,10.723432123432124,73,79
"['110', '1', '00011']",1,3,4,5,0,9,1.3333333333333333,10,7
"['001', '01111', '011']",1,3,4,7,2,11,1.9166666666666665,6,9
"['0001011', '0001111', '1110', '0']",1,4,9,10,2,19,2.6662337662337663,25,19
"['01', '101', '00', '100011', '1001011']",1,5,10,10,2,20,5.7786324786324785,30,27
"['1010', '001', '0111']",1,3,5,6,2,11,1.6428571428571428,7,6
"['10100', '010', '010111', '100111']",1,4,9,11,2,20,3.7853535353535355,17,16
"['00', '10001', '111100', '10']",1,4,8,7,2,15,3.188311688311688,19,13
"['0', '10111', '0110', '1111110']",1,4,5,12,0,17,2.6954545454545453,22,14
"['010001', '11', '101', '1001', '00', '101111']",1,6,10,13,4,23,8.151587301587302,42,44
"['0', '1011', '11100', '1111011']",1,4,5,12,0,17,2.8217171717171716,22,18
"['0010', '1011000', '11']",1,3,7,6,0,13,1.323232323232323,12,5
"['0010110', '010', '1110000', '010000']",1,4,15,8,2,23,3.6227106227106227,21,27
"['11011', '111010', '111101']",1,3,4,13,2,17,2.287878787878788,6,14
"['11110', '1101', '010011']",1,3,5,10,0,15,1.4303030303030302,9,9
"['11000', '10001', '101', '10000', '110100', '10', '010011']",1,7,18,14,5,32,13.482467532467533,54,61
"['0', '11011', '010']",1,3,4,5,0,9,1.3333333333333333,9,4
"['1001100', '1', '000']",1,3,7,4,0,11,0.85,13,6
"['10101', '100', '111000', '111110']",1,4,8,12,2,20,3.436868686868687,17,16
"['00100', '010', '1']",1,3,6,3,0,9,1.5833333333333333,8,4
"['1010', '1101', '011001']",1,3,6,8,2,14,2.15,8,7
"['010', '101', '11000', '10010', '00010', '01100']",1,6,16,10,6,26,9.666666666666666,36,43
"['1010', '010', '0110100', '000']",1,4,11,6,2,17,3.8225108225108224,15,23
"['010', '1', '001', '0001', '0000']",1,5,11,4,4,15,5.388095238095238,21,27
"['010', '111', '0011', '10', '1101', '01110']",1,6,8,13,4,21,9.00952380952381,32,35
"['1000', '1100', '10110', '00000']",1,4,12,6,4,18,3.594444444444444,13,20
"['0101', '1', '01100', '100010']",1,4,9,7,0,16,2.831168831168831,21,11
"['0100010', '0011', '1001101', '110111', '10', '1000011', '0111100']",1,7,19,21,4,40,11.635686535686535,80,52
"['00', '0110', '0000100']",1,3,10,3,0,13,1.6565656565656566,11,16
"['01001', '100', '1100']",1,3,7,5,0,12,2.2738095238095237,5,8
['1111010'],1,1,2,5,0,7,0,0,0
"['1011', '0110', '10']",1,3,4,6,2,10,2.083333333333333,6,6
"['010100', '0110101', '00101', '1000010']",1,4,15,10,2,25,3.875624375624376,17,17
"['01011', '1010101', '101110', '000']",1,4,10,11,0,21,3.8742812742812744,18,12
"['00000', '10010', '00010', '01011', '01100']",1,5,17,8,5,25,5.8,23,37
"['000011', '1100', '01111', '110', '0100']",1,5,11,11,2,22,5.3573593073593075,28,32
"['0', '1011', '10011']",1,3,4,6,0,10,1.6222222222222222,8,7
"['00', '111110', '1001']",1,3,5,7,0,12,1.3166666666666667,11,4
"['0', '1001001', '01000', '101101']",1,4,11,8,0,19,2.6965534465534464,23,10
"['11100', '10111', '01101', '100']",1,4,7,11,3,18,3.55,15,17
"['010', '100', '0111']",1,3,5,5,2,10,1.5238095238095237,7,7
"['1011110', '1100', '001111']",1,3,6,11,0,17,1.7146853146853147,10,8
"['01', '0101011', '10', '0110001']",1,4,9,9,4,18,2.706349206349206,25,16
"['111', '0011', '1011101', '011101', '10', '00010']",1,6,11,16,0,27,7.951287601287601,47,38
"['0', '000110', '0100000', '00101', '1100101', '11100', '0110110']",1,7,22,16,5,38,10.768881118881119,78,62
"['0', '11000', '10101', '1000']",1,4,9,6,2,15,3.2222222222222223,17,14
"['0011101', '010', '1', '001100', '0100']",1,5,12,9,0,21,5.4923909423909425,32,30
"['001', '011', '10001', '100000', '001010']",1,5,15,8,4,23,5.6893939393939394,29,27
"['1110101', '1010', '11101', '010010']",1,4,9,13,0,22,3.988111888111888,15,18
"['100', '0000001', '111']",1,3,8,5,2,13,0.9333333333333333,13,7
"['1100', '10110', '00011']",1,3,7,7,2,14,1.711111111111111,9,8
"['0101', '110', '1101111', '10']",1,4,5,11,0,16,3.627994227994228,18,16
"['01', '00011', '11']",1,3,4,5,2,9,1.6428571428571428,7,8
"['101', '01001', '0000000', '100010']",1,4,15,6,0,21,3.110839160839161,21,12
"['01', '0010', '0011001', '1000', '0001010']",1,5,16,8,4,24,5.898629148629149,34,33
"['011111', '10110', '01011']",1,3,5,11,2,16,1.8909090909090909,7,8
"['1011001', '00111', '10101', '110011', '111110', '1101']",1,6,11,22,4,33,9.404817404817404,40,59
"['1101001', '010001', '11000', '1100001', '101011', '00']",1,6,18,15,4,33,9.357087357087357,43,50
"['1010001', '10111', '1010110', '000']",1,4,11,11,2,22,3.4976190476190476,20,17
"['00', '11101', '110', '000010']",1,4,9,7,0,16,2.743795093795094,20,14
"['1110010', '10', '000000', '00011']",1,4,13,7,0,20,2.487151737151737,25,18
"['11010', '0010', '0110', '100010', '10010', '0100']",1,6,17,11,5,28,10.908585858585859,28,59
"['11', '10101', '0010100', '001010', '110111']",1,5,12,14,2,26,6.021700521700522,32,26
"['100', '000101', '01011', '00001']",1,4,12,7,2,19,3.298989898989899,15,17
"['11000', '01', '111']",1,3,4,6,0,10,1.1857142857142857,9,8
"['01', '10', '0000100']",1,3,8,3,2,11,1.3888888888888888,12,6
"['100', '011', '111']",1,3,3,6,3,9,1.3333333333333333,6,8
"['11001', '110110', '0010', '001101', '000011', '101', '011000', '0111100']",1,8,22,21,4,43,16.896098346098345,88,75
"['101101', '110100', '100010', '00', '1011111']",1,5,12,15,3,27,5.414529914529915,37,26
"['0', '100001', '11000', '1011', '1110']",1,5,10,10,2,20,4.757431457431458,31,22
"['011', '1000110', '1001', '0000001', '100011']",1,5,16,11,2,27,6.420712620712621,31,35
"['110011', '0111011', '000']",1,3,7,9,0,16,1.6136752136752137,11,7
"['0', '0010', '111']",1,3,4,4,0,8,0.6857142857142857,9,4
"['101', '11101', '1100110', '000110']",1,4,9,12,0,21,3.775796425796426,19,17
"['100', '00010', '010', '110']",1,4,9,5,3,14,3.75,12,19
"['0010', '110', '10000', '1100110']",1,4,11,8,0,19,3.732034632034632,17,19
"['1011', '0001', '10', '0000']",1,4,9,5,3,14,2.833333333333333,14,15
"['0011', '110', '10']",1,3,4,5,0,9,1.7047619047619047,7,8
"['100000', '10000', '1110']",1,3,10,5,0,15,1.7535353535353535,8,13
"['11101', '001001', '100000', '10']",1,4,11,8,2,19,2.9805194805194803,21,15
"['111011', '1000010', '110111', '000010', '11111']",1,5,12,18,3,30,5.3158508158508155,31,42
"['00111', '11010', '1010010']",1,3,8,9,2,17,1.5666666666666667,10,9
"['010011', '0111010', '01011']",1,3,8,10,0,18,1.8706293706293706,7,12
"['0', '0110', '111', '0110110']",1,4,6,9,0,15,2.5487012987012987,21,18
"['1011110', '1110001', '1100', '110']",1,4,8,13,2,21,3.901298701298701,20,18
"['0100010', '01', '10', '0100']",1,4,10,5,2,15,3.4494949494949494,19,20
"['1100', '110', '001011', '01010']",1,4,9,9,0,18,3.5955266955266953,15,18
"['0', '0010', '1101110']",1,3,6,6,0,12,1.1954545454545453,13,9
"['0010110', '0001001', '111111', '1011', '01001']",1,5,13,16,2,29,5.366033966033966,33,25
"['1010001', '1001', '11100']",1,3,8,8,0,16,2.0606060606060606,9,11
"['0', '101100', '1011110', '0011', '0100']",1,5,11,11,2,22,5.095854145854146,35,29
"['101', '010', '0111']",1,3,4,6,2,10,1.8095238095238093,6,5
"['10111', '010000', '0100111']",1,3,9,9,0,18,1.8123543123543124,9,10
"['01', '0010', '0101110', '10001', '00010']",1,5,14,9,2,23,5.988311688311688,29,28
"['001', '01101', '0000000', '11101', '011111', '0011011', '111000', '110', '0100']",1,9,23,23,8,46,18.916572316572317,120,110
"['001', '011', '111001', '101101']",1,4,7,11,4,18,3.7222222222222223,16,19
"['0', '0110100', '010010', '0110000', '1001100', '111101']",1,6,19,15,5,34,7.7866300366300365,57,43
"['110010', '0100110', '0110', '1000010', '00', '110111', '1110']",1,7,18,18,6,36,11.863147963147963,66,66
"['0011011', '1001', '100000', '000']",1,4,13,7,0,20,3.445088245088245,21,19
"['000110', '11', '100', '10100', '01010']",1,5,12,9,2,21,5.878210678210678,27,24
"['110011', '0001', '01111']",1,3,6,9,0,15,1.5898989898989897,9,8
"['001', '001110', '000000']",1,3,11,4,2,15,1.6111111111111112,10,14
"['010100', '00', '10011']",1,3,8,5,0,13,1.6168831168831168,11,6
"['11000', '10010', '0110']",1,3,8,6,2,14,1.911111111111111,7,7
"['1101101', '010000', '0110']",1,3,9,8,0,17,1.7888111888111888,10,5
"['0', '1111001', '0011010', '111']",1,4,7,11,2,18,2.2714285714285714,27,12
"['0', '01', '000111']",1,3,5,4,0,9,1.4523809523809523,10,6
"['11000', '0001', '000']",1,3,9,3,0,12,2.2738095238095237,6,16
"['1000100', '1', '011100']",1,3,8,6,0,14,0.9972527472527473,14,6
"['10110', '1111', '1010010', '110', '011000']",1,5,11,14,0,25,6.107831057831058,29,26
"['1111001', '10100', '11101', '0011010']",1,4,10,14,4,24,4.004761904761905,17,14
"['00001', '00100', '101', '01111', '1011', '011000']",1,6,15,13,3,28,8.175324675324674,42,38
"['100', '110', '10000']",1,3,7,4,2,11,1.9166666666666665,6,9
"['01', '001', '1011110', '10', '0001000']",1,5,12,9,4,21,4.906349206349207,38,25
"['101011', '100', '1001011']",1,3,7,9,0,16,2.18974358974359,8,16
"['101010', '1011101', '1110011', '000101', '011010']",1,5,14,18,5,32,6.56043956043956,29,25
"['010', '111', '100', '1000010', '110']",1,5,10,9,4,19,5.333333333333333,26,26
"['011', '0001', '1110101', '100110', '10', '000', '0111', '1100']",1,8,16,17,5,33,15.01047841047841,82,73
"['011010', '10', '0111', '0000']",1,4,9,7,2,16,2.8166666666666664,18,17
"['0110101', '0010', '11110', '111010', '11', '100100', '1001', '100011']",1,8,18,22,5,40,15.913036963036962,83,79
"['0101000', '001', '011', '1000110', '1111', '1000011', '1101']",1,7,17,18,7,35,11.543939393939393,70,58
"['0001101', '110', '0000011']",1,3,10,7,2,17,1.7142857142857144,13,9
"['101', '1', '0110100', '01000']",1,4,9,7,0,16,2.85,21,10
"['11000', '100110', '10', '011110', '11100']",1,5,11,13,4,24,5.973160173160173,29,27
"['1110001', '110', '10', '11']",1,4,5,9,2,14,3.588888888888889,17,20
"['111011', '10111', '01', '0000']",1,4,7,10,0,17,2.5542568542568542,21,13
"['0101011', '100101', '1']",1,3,6,8,0,14,1.151098901098901,14,8
"['0010001', '1', '1101101', '000', '1010000', '1001001']",1,6,19,13,4,32,7.3428571428571425,61,42
"['0011011', '0101', '0100']",1,3,8,7,2,15,1.8409090909090908,8,9
"['1000', '01101', '0001110']",1,3,9,7,0,16,1.6565656565656566,11,8
"['011011', '1010', '010']",1,3,6,7,0,13,2.123809523809524,7,9
"['01', '00', '1']",1,3,3,2,2,5,1.1666666666666665,4,4
"['001', '011', '1010101', '1001101', '001110', '010111', '1011']",1,7,15,21,6,36,13.471517371517372,58,57
"['00111', '101', '0110', '00', '1100']",1,5,9,9,2,18,5.8087301587301585,25,24
"['0', '0011001', '010110', '11111']",1,4,8,11,0,19,2.1685814185814185,26,10
"['0101', '00', '001', '111000']",1,4,9,6,0,15,3.3825396825396825,16,18
"['11001', '0010', '1']",1,3,5,5,0,10,1.4,10,4
"['0', '01101', '1001000', '000111']",1,4,11,8,0,19,2.557858807858808,26,14
"['0010110', '1101011', '0001101', '1110100', '1100']",1,5,15,17,4,32,6.545454545454545,34,31
"['1111', '10111', '110', '010111']",1,4,4,14,0,18,3.6916305916305916,13,30
"['0011', '0010', '00101']",1,3,8,5,2,13,2.5277777777777777,3,13
"['100', '10', '000', '1001']",1,4,8,4,2,12,3.961904761904762,9,16
"['00100', '11101', '01100']",1,3,8,7,3,15,1.8,6,7
"['0', '100100', '1111']",1,3,5,6,0,11,0.6857142857142857,13,4
"['010', '1101111', '0011110', '01010', '01110']",1,5,11,16,4,27,6.680952380952381,29,37
"['1100001', '1110011', '100', '000']",1,4,11,9,4,20,3.5809523809523807,20,14
"['11010', '0001', '001010', '0111', '1100110', '1011', '1101']",1,7,15,19,4,34,13.441958041958042,53,61
"['11001', '0001', '10100', '10', '010011', '110']",1,6,13,12,2,25,8.922005772005772,39,39
"['1001110', '001111', '1111']",1,3,5,12,0,17,2.114685314685315,7,12
"['00111', '010', '11']",1,3,4,6,0,10,1.4714285714285715,8,6
"['1010', '0001', '010010']",1,3,9,5,2,14,1.9,7,8
"['1', '1011001', '1001101', '100010', '1110100', '01110']",1,6,15,18,3,33,7.864552114552114,56,36
"['010100', '001', '011100', '0001', '01111', '10']",1,6,14,12,2,26,7.615584415584416,44,46
"['00', '0100011', '0110']",1,3,8,5,0,13,1.6565656565656566,11,9
['0100011'],1,1,4,3,0,7,0,0,0
"['010', '111100', '1101111', '1010', '1011', '1100', '01000']",1,7,14,19,3,33,12.484576534576535,59,61
"['001', '101011', '1000', '10', '0000']",1,5,12,7,2,19,5.237301587301587,26,28
"['100', '11100', '000011']",1,3,8,6,0,14,1.558080808080808,11,11
"['0100000', '1', '1011100', '1110', '0100']",1,5,13,10,4,23,4.916883116883117,38,25
"['0010', '010', '1010110', '001000', '0001100']",1,5,18,9,2,27,6.895437895437896,28,47
"['0', '11000', '01']",1,3,5,3,0,8,1.2857142857142856,9,6
"['01101', '001', '1', '010010', '1110001', '010110']",1,6,14,14,2,28,8.0511877011877,52,35
"['000101', '10', '1111']",1,3,5,7,0,12,1.2333333333333334,11,6
"['0011011', '00', '0100111', '1']",1,4,8,9,2,17,2.1031746031746033,27,13
['101100'],1,1,3,3,0,6,0,0,0
"['0', '1010110', '00010', '000111', '111101']",1,5,12,13,2,25,4.322594072594073,39,24
"['100001', '0010000', '11', '0110', '0101010', '0100100', '011111', '001001']",1,8,26,19,6,45,16.50964590964591,97,75
"['01', '1100000', '111011']",1,3,7,8,0,15,1.1837606837606838,14,8
"['011111', '0001', '0']",1,3,5,6,0,11,1.0857142857142859,12,6
"['1', '0010000', '0001101', '1100', '1110']",1,5,13,10,4,23,4.621428571428571,40,25
"['0', '0110000', '001']",1,3,8,3,0,11,1.15,13,9
"['1000101', '1100001', '1111001', '10010', '0100']",1,5,16,14,3,30,6.612554112554112,32,27
"['0001', '1000', '1111000']",1,3,9,6,2,15,2.0227272727272725,10,13
"['010', '10011', '000']",1,3,7,4,2,11,1.6666666666666665,7,4
"['01', '100', '1001111']",1,3,5,7,0,12,1.4444444444444444,11,8
"['0', '010', '11']",1,3,3,3,0,6,0.9,6,4
"['0', '0011110', '1111001']",1,3,6,9,2,15,1.2142857142857144,16,4
"['010', '011', '11']",1,3,3,5,2,8,1.8666666666666667,4,7
"['101010', '10111', '0']",1,3,5,7,0,12,1.3463203463203464,11,6
"['111110', '10', '110001']",1,3,5,9,2,14,1.5,12,8
"['00010', '01000', '11']",1,3,8,4,2,12,1.1714285714285713,10,6
"['1100010', '111110', '111', '1100110']",1,4,8,15,2,23,3.646886446886447,17,29
"['0010', '11011', '00011', '110100', '00']",1,5,12,10,2,22,5.4258297258297254,29,35
"['00', '110', '10']",1,3,4,3,2,7,1.7000000000000002,4,7
"['110010', '1111110', '1000111', '1000', '000', '01110', '0100']",1,7,18,18,4,36,12.040631590631591,68,62
['01110'],1,1,2,3,0,5,0,0,0
"['1111100', '100110', '10', '000']",1,4,9,9,0,18,3.0264957264957264,22,16
"['1000110', '0001', '001', '100']",1,4,11,6,2,17,4.022510822510823,16,19
"['1001110', '1100011', '01101', '01110']",1,4,10,14,4,24,4.180952380952381,20,16
"['1011', '0010', '1110110', '1110']",1,4,7,12,3,19,3.5,16,19
"['00111', '10', '000']",1,3,6,4,0,10,1.1857142857142857,9,8
"['0', '1110101', '00101']",1,3,6,7,0,13,1.25,13,7
['1000111'],1,1,3,4,0,7,0,0,0
"['1010110', '10110', '0100']",1,3,8,8,0,16,2.2272727272727275,7,12
"['1000000', '00', '001110', '0110']",1,4,13,6,0,19,3.0824397824397822,22,25
"['0001', '000001', '0100']",1,3,11,3,2,14,1.7000000000000002,7,13
"['00100', '00101', '100110', '00001']",1,4,14,7,3,21,4.0,12,20
"['1010', '11101', '110']",1,3,4,8,0,12,1.9880952380952381,5,8
"['010', '100001', '111010', '0011', '100010']",1,5,14,11,3,25,5.949206349206349,30,28
"['1', '00101', '001000', '1001', '1011', '010011', '0100011']",1,7,18,15,4,33,12.572827172827173,63,58
"['011111', '10000', '1010', '00', '10100', '1100111']",1,6,14,15,2,29,7.932484182484182,50,41
"['111010', '111', '1100010', '100', '0101100', '000']",1,6,15,14,5,29,8.087667887667887,49,43
"['101', '0101011', '0011111', '1']",1,4,6,12,2,18,2.571428571428571,26,15
"['00', '000100', '1']",1,3,7,2,0,9,0.7857142857142857,11,8
"['011111', '010', '01110', '11']",1,4,5,11,0,16,3.3931457431457432,17,18
"['1110000', '111', '01010']",1,3,7,8,0,15,1.6,11,8
"['01', '1001000', '10', '01001', '001001']",1,5,14,8,2,22,5.876734376734377,32,29
"['111110', '1111001', '0010011']",1,3,7,13,2,20,1.6483516483516483,11,11
"['1010111', '1111110', '0000']",1,3,7,11,2,18,0.974025974025974,14,6
['000110'],1,1,4,2,0,6,0,0,0
"['00', '1001', '111001']",1,3,6,6,0,12,1.9666666666666668,8,7
"['100100', '1', '10']",1,3,5,4,0,9,1.4523809523809523,10,7
"['1', '100', '0000', '0001011', '110']",1,5,11,7,2,18,4.301082251082251,33,26
"['110100', '1', '100111']",1,3,5,8,2,13,1.0714285714285714,13,9
"['0101', '010', '010001']",1,3,8,5,0,13,2.3238095238095235,6,13
"['0', '10100', '100111']",1,3,6,6,0,12,1.1645021645021645,12,5
['0010101'],1,1,4,3,0,7,0,0,0
"['1111', '1100', '100010']",1,3,6,8,2,14,1.5,9,8
"['110', '0011', '0001', '000101', '100011', '100101', '0000110']",1,7,21,15,5,36,14.2488677988678,54,65
"['0111011', '11', '00001', '0110', '1110']",1,5,9,13,2,22,5.268037518037518,31,27
"['00101', '11', '00100', '1100000', '10', '10011']",1,6,15,11,5,26,8.231746031746031,47,41
['011000'],1,1,4,2,0,6,0,0,0
"['1000100', '011', '100101', '000', '0110110']",1,5,15,11,4,26,5.8227106227106225,35,24
"['0010001', '101', '00']",1,3,8,4,0,12,1.2444444444444445,11,7
"['011', '11', '101101', '0001', '000']",1,5,9,9,2,18,4.906349206349207,26,25
"['111100', '0001100', '100000', '110111', '0101', '110']",1,6,16,16,3,32,8.074148074148074,51,43
"['11010', '001', '11', '11101', '1011']",1,5,6,13,2,19,5.914285714285715,24,36
"['01', '1', '0000']",1,3,5,2,0,7,1.0,8,4
"['0000111', '1010000', '0111010', '11']",1,4,12,11,3,23,3.0476190476190474,29,15
"['1011', '00', '010', '10']",1,4,6,5,2,11,3.6714285714285713,10,12
"['010', '0010000', '10101', '1101101', '10110', '0110000', '00']",1,7,21,15,5,36,13.066666666666666,70,57
"['00', '10110', '1110', '111100']",1,4,7,10,0,17,3.820923520923521,15,18
"['1011001', '010010', '1']",1,3,7,7,0,14,1.304945054945055,14,4
"['011111', '110110', '0100000', '0100']",1,4,12,11,2,23,2.9965034965034967,22,21
"['010', '100', '0000011', '1']",1,4,9,5,2,14,2.716666666666667,22,11
"['1101', '0110111', '10011', '0101100']",1,4,9,14,2,23,3.2886002886002883,19,14
"['110000', '111010', '0000001', '000000', '001100']",1,5,22,9,4,31,5.9743589743589745,29,50
"['110000', '110010', '10101', '0110', '0010011', '0001100', '011110']",1,7,22,19,5,41,12.452436452436453,70,59
"['01', '11000', '11101', '10011', '01110']",1,5,9,13,4,22,5.6,29,23
"['0', '1000101', '01100']",1,3,8,5,0,13,1.0833333333333333,14,4
"['1111001', '01000', '11111']",1,3,6,11,2,17,1.5333333333333334,10,10
"['0001001', '01', '0001110', '1']",1,4,10,7,2,17,2.7698412698412698,26,14
"['1110111', '11010', '001000']",1,3,8,10,0,18,1.5198135198135199,11,6
"['010', '010001', '0111010', '11', '1011110', '01000', '110101']",1,7,17,19,4,36,12.143983793983793,70,56
"['0', '11001', '11110', '11011', '0111011', '101101', '0101011', '100110', '1000']",1,9,18,28,7,46,20.644266844266845,112,102
"['0011101', '0000100', '00000']",1,3,14,5,2,19,1.9047619047619047,9,20
"['0011', '01001', '10001', '000010']",1,4,13,7,2,20,4.006060606060606,13,13
"['101', '110', '1100', '011']",1,4,5,8,3,13,4.0,12,16
"['10101', '1101101', '001111']",1,3,6,12,0,18,1.9941724941724943,8,11
"['101000', '100', '1']",1,3,6,4,0,10,1.4523809523809523,10,8
"['0000110', '0110', '000011']",1,3,11,6,0,17,2.2503496503496505,8,16
"['1011001', '000101', '0001100', '10010', '10']",1,5,16,11,2,27,5.965978465978466,33,27
"['011101', '1', '1000111', '0100']",1,4,8,10,0,18,2.6965534465534464,26,11
"['101100', '10100', '1', '10011']",1,4,8,9,2,17,3.188744588744589,20,20
"['001', '010000', '1011101', '01010', '1101', '1100']",1,6,15,14,2,29,8.698840048840049,43,38
"['0', '001', '1111101', '0111']",1,4,5,10,0,15,2.666883116883117,22,13
"['0', '101101', '11']",1,3,3,6,0,9,0.7857142857142857,11,4
"['1001', '10', '000010']",1,3,8,4,0,12,1.7666666666666666,9,6
"['0', '01', '0010111']",1,3,5,5,0,10,1.3611111111111112,12,6
"['0011101', '111', '10', '1001001', '110', '01110']",1,6,11,16,4,27,8.907936507936508,46,36
"['0', '1011', '1001110']",1,3,5,7,0,12,1.3772727272727274,12,5
"['11', '01101', '1110', '0100']",1,4,6,9,2,15,3.4047619047619047,14,13
"['0011', '01', '1100101']",1,3,6,7,0,13,1.8383838383838382,10,8
"['011111', '1011', '10011', '0']",1,4,5,11,0,16,3.0533910533910533,19,15
"['0', '111100', '0110', '01010', '0111']",1,5,9,11,2,20,5.47005772005772,28,33
"['0101111', '0110100', '1111']",1,3,6,12,2,18,1.7012987012987013,11,11
"['0111000', '100', '0111', '0000', '1011', '1101', '101001']",1,7,16,16,4,32,11.395687645687646,59,56
"['00011', '101101', '00', '0011111', '1110110', '11100']",1,6,13,19,4,32,8.517660117660117,53,47
"['101101', '1000', '100111', '10', '1001100']",1,5,12,13,2,25,6.410178710178711,30,38
"['0', '01101', '111']",1,3,3,6,0,9,1.0833333333333333,9,4
"['0010', '010', '000011', '10110', '0111100']",1,5,14,11,0,25,5.9555500055500055,32,34
"['1001', '1101111', '0000011', '11']",1,4,8,12,2,20,3.075036075036075,24,26
"['100100', '1', '001101', '10011']",1,4,9,9,2,18,3.0259740259740258,22,18
"['01111', '01', '0110']",1,3,4,7,0,11,1.9047619047619047,7,10
"['0', '1101101', '111110', '1001100', '101110']",1,5,10,17,4,27,5.2344322344322345,35,23
"['000000', '111010', '011110']",1,3,10,8,3,18,1.3333333333333333,10,9
"['011100', '111100', '1001010', '101101']",1,4,11,14,3,25,3.7051282051282053,15,15
['0011111'],1,1,2,5,0,7,0,0,0
"['0100001', '1111110', '000']",1,3,9,8,2,17,1.0857142857142856,16,6
"['001', '000011', '11000', '10000', '100111', '000', '0101', '111001']",1,8,22,16,7,38,16.623665223665224,79,91
"['11001', '1000110', '000', '11']",1,4,9,8,0,17,2.615873015873016,21,12
"['100', '1', '111011']",1,3,3,7,0,10,1.2301587301587302,11,8
"['000110', '01', '110010', '0010111', '1101011', '011101']",1,6,15,19,5,34,8.94932844932845,52,38
"['000110', '0101101', '100', '1111001', '100011']",1,5,14,15,4,29,6.32026862026862,35,23
"['101', '100', '100011', '10011']",1,4,8,9,2,17,4.409090909090909,12,30
"['101000', '111010', '11']",1,3,6,8,2,14,1.6666666666666665,10,8
"['01000', '100011', '1110100', '10', '1111111']",1,5,11,16,2,27,4.639360639360639,41,27
"['010101', '110', '1']",1,3,4,6,0,10,1.2301587301587302,10,6
"['1011', '110', '1110']",1,3,3,8,2,11,1.9285714285714284,5,11
"['011', '1100100', '00001']",1,3,9,6,0,15,1.4,12,8
"['11', '0100010', '10', '010011', '01011']",1,5,11,11,2,22,5.876734376734377,31,32
"['0000111', '100', '01100', '1111']",1,4,9,10,0,19,2.9256132756132756,22,18
"['0001101', '11000', '01000', '110101']",1,4,13,10,2,23,3.688111888111888,18,21
"['0110', '000', '11']",1,3,5,4,0,9,1.2380952380952381,7,4
"['0100000', '01', '1000101', '11', '011110', '01000']",1,6,17,12,4,29,7.4416694416694416,58,38
"['11', '11101', '100111', '1011', '0110001']",1,5,8,16,0,24,6.022166722166722,32,44
"['0010', '011100', '100010', '0111111', '1110110']",1,5,13,17,4,30,5.345354645354646,35,33
"['011011', '10110', '000', '01000']",1,4,11,8,2,19,3.567171717171717,18,19
"['10111', '0111', '11']",1,3,2,9,0,11,2.126984126984127,6,15
"['1011', '100010', '11']",1,3,5,7,0,12,1.7666666666666666,9,11
"['010000', '001011', '011']",1,3,9,6,2,15,1.6111111111111112,11,10
"['10101', '00', '1', '011']",1,4,5,6,0,11,2.5547619047619046,15,10
"['010000', '001', '001101', '0000000', '000010', '110']",1,6,23,8,5,31,7.946153846153846,52,63
"['0', '11011', '0111011', '1111', '10']",1,5,5,14,0,19,5.048701298701299,32,29
"['1000000', '01', '11']",1,3,7,4,2,11,0.9444444444444444,13,6
"['0011', '111010', '010', '011']",1,4,7,9,2,16,3.606349206349206,15,19
"['110010', '1101101', '00110', '10', '000']",1,5,12,11,0,23,5.713891663891664,32,25
"['0010', '0101000', '1100', '0110']",1,4,12,7,3,19,4.0,15,23
"['0111000', '11001', '101', '10111', '000101', '111111', '011110', '1011000', '000000', '111000']",1,10,27,30,9,57,24.631579531579533,149,147
"['0', '0101', '111']",1,3,3,5,0,8,0.9714285714285714,8,4
"['11100', '110', '1']",1,3,3,6,0,9,1.5833333333333333,8,7
"['101', '1110011', '0110', '1111', '10010', '010110', '1100']",1,7,13,20,3,33,12.886235986235986,56,55
"['01', '111100', '1101000']",1,3,7,8,0,15,1.3098290598290598,12,8
"['0010', '1001', '10011', '1110']",1,4,8,9,3,17,3.75,13,15
"['0', '11110', '010']",1,3,4,5,0,9,1.3333333333333333,9,9
"['01', '111000', '00', '001101']",1,4,9,7,4,16,2.75,22,18
"['101', '00', '01111', '011']",1,4,5,8,2,13,3.0023809523809524,15,13
"['01001', '0110', '1001011', '11111']",1,4,8,13,2,21,3.0565656565656565,18,13
"['01100', '00', '1', '01000']",1,4,9,4,2,13,2.6095238095238096,17,18
"['00011', '110001', '11100', '0100']",1,4,11,9,2,20,3.5656565656565657,18,17
"['01', '0010', '00111', '1100001', '100100', '111111', '1000']",1,7,17,17,4,34,11.054723054723055,72,57
"['1011010', '01', '111', '101101', '00', '010111']",1,6,10,16,4,26,8.247863247863247,48,39
"['0', '0011101', '0001000']",1,3,10,5,2,15,1.0714285714285714,15,10
"['1101111', '0111', '11']",1,3,2,11,0,13,1.8383838383838382,10,17
"['0', '011011', '0011010', '110011', '10100', '10011']",1,6,14,16,4,30,8.033316683316682,52,38
"['00', '11011', '1']",1,3,3,5,0,8,0.6190476190476191,10,4
"['110000', '100', '10100', '00', '000001']",1,5,16,6,2,22,5.99011544011544,29,38
"['111100', '011', '100', '10110', '00']",1,5,9,10,2,19,5.9431457431457435,26,28
"['0100001', '1011', '10100', '10']",1,4,10,8,0,18,3.5613275613275612,19,16
"['1001', '1', '10']",1,3,3,4,0,7,1.7333333333333334,6,9
"['01101', '100001', '0110100', '000011', '00111', '1100']",1,6,18,15,4,33,9.076612276612277,45,43
"['00100', '00', '11000', '111']",1,4,9,6,2,15,2.492857142857143,19,20
"['0010110', '0010', '001101', '1111', '10', '0000', '0111110']",1,7,17,17,5,34,11.132811632811633,68,66
"['11011', '010', '011']",1,3,4,7,2,11,1.9166666666666665,6,8
"['0100001', '1101010', '1', '0100']",1,4,11,8,2,19,2.925974025974026,25,13
"['1010101', '1', '0100']",1,3,6,6,0,12,1.3772727272727274,12,4
"['01011', '00100', '010000', '000001']",1,4,16,6,4,22,3.4484848484848483,15,23
"['111010', '1001', '100100', '1010111', '0101']",1,5,12,15,4,27,6.7019813519813525,28,30
"['0000', '001', '011001', '1011111']",1,4,10,10,0,20,2.8352980352980355,22,14
"['110000', '01', '011', '0000']",1,4,10,5,0,15,2.9134920634920634,19,20
"['111010', '11', '00', '0110010', '000100']",1,5,13,10,4,23,4.677350427350428,38,28
"['0000111', '001', '10000', '0100100']",1,4,15,7,2,22,3.7714285714285714,20,20
"['01', '1', '0010']",1,3,4,3,0,7,1.7333333333333334,6,4
"['1000111', '011', '110100']",1,3,7,9,0,16,1.505982905982906,12,9
"['010000', '1', '100', '000010', '0110010']",1,5,16,7,2,23,4.92997557997558,35,29
"['0', '11110', '1110011', '1000', '001010', '1100']",1,6,13,14,2,27,7.448573648573649,50,38
['1100111'],1,1,2,5,0,7,0,0,0
"['101010', '1011', '100', '011']",1,4,7,9,2,16,3.895238095238095,14,18
"['0', '100110', '0101', '001']",1,4,8,6,0,14,3.0238095238095237,18,13
"['1011', '1010', '000']",1,3,6,5,2,11,1.6071428571428572,6,6
"['10110', '01010', '00000']",1,3,10,5,3,15,1.8,7,9
['0001110'],1,1,4,3,0,7,0,0,0
"['11', '11000', '0101010', '1000', '110111']",1,5,11,13,0,24,5.692873792873793,32,30
"['01', '1100000', '110']",1,3,7,5,0,12,1.2222222222222223,12,8
"['00000', '11', '11101', '100011', '110']",1,5,10,11,2,21,4.424963924963925,33,29
"['0010110', '0011', '100000', '100110']",1,4,14,9,2,23,3.978554778554779,17,21
"['010', '1101101', '00', '10', '1011000', '000111']",1,6,14,13,4,27,8.063431013431014,55,37
"['1101', '01010', '10011', '0001000']",1,4,12,9,2,21,3.2414141414141415,19,9
"['00110', '001', '111']",1,3,5,6,2,11,1.5833333333333333,7,6
"['110010', '00000', '101', '010111', '10', '1010011']",1,6,15,14,2,29,7.994377844377844,50,36
"['1', '011011', '00', '0101', '0100']",1,5,9,8,2,17,5.069047619047619,27,24
"['010', '00111', '01100', '10101', '100000', '111101', '111001']",1,7,17,19,6,36,11.89090909090909,61,53
"['011011', '10001', '000111']",1,3,8,9,2,17,1.7575757575757576,9,7
"['1000001', '1011001', '11', '100', '100101', '01010', '000010', '1011000']",1,8,25,18,5,43,16.334754134754135,93,81
"['1000011', '011010', '1001011']",1,3,10,10,2,20,1.7802197802197801,8,8
"['011', '1010101', '00110', '11111', '110101']",1,5,9,17,2,26,5.958624708624709,28,29
"['00100', '101', '0111']",1,3,6,6,0,12,1.5158730158730158,8,4
"['01', '1', '000010', '011001', '000111']",1,5,12,9,3,21,5.023809523809524,37,22
"['01001', '010', '0110', '000010']",1,4,12,6,0,18,4.085930735930736,13,26
"['11001', '1010', '010001', '011']",1,4,9,9,0,18,3.732034632034632,16,16
"['01', '1101', '1101000', '001011']",1,4,9,10,0,19,3.3999222999223,21,19
"['110000', '101000', '010011', '00010']",1,4,15,8,3,23,3.8181818181818183,16,19
"['111010', '111', '10011']",1,3,4,10,0,14,1.5303030303030303,8,15
"['00', '1', '1000111']",1,3,5,5,0,10,0.6944444444444444,13,4
"['110000', '01', '0111010']",1,3,8,7,0,15,1.3098290598290598,13,7
"['1100', '0111', '11']",1,3,3,7,2,10,1.8333333333333333,7,11
"['1', '0011010', '1010011', '0011011', '110']",1,5,11,14,3,25,4.85,38,28
"['01', '1001', '01100']",1,3,6,5,0,11,1.9047619047619047,8,6
"['0010', '100001', '1100001', '0000011', '0110110']",1,5,19,12,3,31,6.104495504495504,33,24
"['1011', '100', '0111010', '0001000']",1,4,12,9,2,21,3.2519480519480517,22,13
"['11010', '00101', '11', '100110', '0000111', '11100']",1,6,14,16,3,30,8.558963258963258,51,44
"['0111', '000111', '01110']",1,3,6,9,0,15,2.416161616161616,6,12
"['1111100', '11', '00111', '1010100', '0000111', '01100']",1,6,15,18,5,33,8.314285714285715,56,56
"['0', '11000', '1110']",1,3,5,5,0,10,1.4,9,7
"['11101', '10', '00011']",1,3,5,7,2,12,1.2571428571428571,11,7
"['0', '1001', '0001110']",1,3,7,5,0,12,1.1954545454545453,13,4
['1111110'],1,1,1,6,0,7,0,0,0
"['0111', '10101', '1110']",1,3,4,9,2,13,1.8611111111111112,6,8
"['1001000', '10', '000000', '011000']",1,4,16,5,2,21,2.9252136752136755,20,26
"['010', '111100', '00101', '101010', '100', '0001011', '1010000', '110', '1110']",1,9,23,21,7,44,20.48063603063603,111,104
"['01', '10100', '10', '111010']",1,4,7,8,2,15,3.37012987012987,18,14
"['00001', '11', '001010', '011111', '110101']",1,5,11,14,3,25,4.725108225108225,34,25
"['101010', '00110', '100', '0101110']",1,4,11,10,0,21,3.732867132867133,16,20
"['0011', '1', '10']",1,3,3,4,0,7,1.4,7,6
"['000110', '0111010', '100', '0001001']",1,4,14,9,2,23,3.6004884004884006,21,20
"['1010110', '0011101', '1', '1100101', '0100100', '1001001']",1,6,18,18,5,36,8.25,59,36
"['100', '001010', '10011']",1,3,8,6,0,14,2.143939393939394,8,7
"['11001', '11101', '100111', '01001', '0111', '11111', '1101', '0111100']",1,8,13,28,6,41,18.555788655788657,68,112
"['0', '111100', '110111']",1,3,4,9,2,13,1.0714285714285714,13,7
"['010', '000010', '0110110']",1,3,10,6,0,16,1.7282051282051283,10,17
"['0001', '110001', '0100']",1,3,9,5,2,14,1.9,7,8
"['010', '01111', '10010', '000']",1,4,9,7,4,16,3.3166666666666664,16,17
"['010', '001', '0011', '00', '111001']",1,5,10,8,2,18,6.573015873015873,24,27
"['010', '01100', '11']",1,3,5,5,0,10,1.7214285714285715,7,5
"['111110', '011', '100010']",1,3,6,9,2,15,1.222222222222222,11,8
"['0110001', '0111111', '100', '011110']",1,4,9,14,2,23,3.2004884004884007,22,20
"['1', '111010', '0111', '0110']",1,4,5,10,2,15,3.0357142857142856,18,15
"['0', '00001', '11']",1,3,5,3,0,8,0.6190476190476191,10,4
"['001', '0110', '11']",1,3,4,5,0,9,1.638095238095238,6,4
"['000100', '0101010', '0101111', '100111']",1,4,13,13,4,26,3.675824175824176,17,15
"['011101', '00', '01101']",1,3,6,7,0,13,1.9805194805194803,8,11
"['01111', '1100001', '0001', '10']",1,4,9,9,0,18,2.5685425685425685,23,16
"['01', '100', '11']",1,3,3,4,2,7,1.3,5,6
"['00', '1000', '111010']",1,3,7,5,0,12,1.7666666666666666,9,8
"['1', '10', '0111100']",1,3,4,6,0,10,1.3611111111111112,12,4
"['1011001', '00101', '0001', '00', '0101']",1,5,13,9,2,22,6.177489177489178,24,32
"['0010110', '00', '111110', '11111', '01001', '0101', '111101']",1,7,13,22,4,35,10.932190032190032,67,65
"['11001', '01', '011', '11']",1,4,4,8,2,12,3.742857142857143,12,21
"['1100111', '00101', '10000']",1,3,9,8,2,17,1.7666666666666666,10,7
"['0101', '001', '1']",1,3,4,4,0,8,1.4714285714285715,6,7
"['00110', '11010', '111']",1,3,5,8,2,13,1.85,8,7
"['10100', '100', '110', '101111']",1,4,7,10,2,17,3.3510101010101008,16,19
"['11000', '00100', '1110']",1,3,8,6,2,14,1.711111111111111,8,9
"['010', '110', '001101']",1,3,6,6,2,12,2.0,7,7
"['000110', '1', '001000', '0101100', '1011111']",1,5,14,13,4,27,4.450549450549451,42,22
"['0010', '101101', '010111', '001010', '0111101']",1,5,13,16,3,29,6.712121212121212,27,27
"['0', '010011', '011010', '110111']",1,4,8,11,3,19,2.6904761904761902,22,13
"['1', '10', '0001011', '000000', '1100011']",1,5,14,9,2,23,4.096764346764346,44,25
"['0010', '10111', '10001', '0011', '1001', '1111', '110', '0111100']",1,8,15,21,6,36,16.445310245310246,75,76
"['0111010', '110', '0100110', '0100100']",1,4,13,11,3,24,3.457142857142857,19,28
"['1000001', '110000', '10111', '100', '011101', '1100101', '0000111', '0100001', '1110']",1,9,27,25,6,52,21.541447441447442,119,114
"['11011', '010001', '000011', '0000001', '00', '010111', '10', '01011']",1,8,22,17,7,39,15.577972027972027,87,85
"['001', '11', '10000', '10011', '0100001', '1001001', '0101', '1110', '1111011']",1,9,21,23,7,44,20.066450216450217,115,118
"['1', '0011', '000101', '100011', '011111']",1,5,10,13,3,23,5.29047619047619,34,28
"['00', '1', '10']",1,3,3,2,2,5,1.1666666666666665,4,4
"['001', '000', '1001']",1,3,7,3,2,10,2.095238095238095,4,8
"['1011001', '1', '011']",1,3,4,7,0,11,1.35,12,8
"['1', '1101100', '10', '000010', '01001', '111001']",1,6,14,13,2,27,7.535436785436786,56,34
"['0001', '0110', '1111000']",1,3,8,7,2,15,1.5909090909090908,12,8
"['11010', '001', '00000', '1101', '1011111']",1,5,11,13,2,24,4.6946608946608945,35,26
"['0', '10', '0111', '11111']",1,4,3,9,0,12,2.3523809523809525,18,14
"['010100', '110010', '00100', '1001', '11101', '0101', '1100', '1001111']",1,8,20,21,7,41,18.270862470862472,76,80
"['11110', '001011', '11']",1,3,4,9,0,13,1.435064935064935,11,11
"['0010', '001001', '10', '011']",1,4,9,6,0,15,3.604761904761905,15,16
"['0010', '11', '1100001', '1010100', '100100', '110']",1,6,16,13,2,29,8.692740592740593,47,41
"['000100', '110', '000']",1,3,9,3,2,12,1.4444444444444444,9,14
"['011101', '1100', '100', '100111']",1,4,8,11,2,19,3.8349206349206346,18,17
"['0010001', '00010', '011000']",1,3,13,5,0,18,1.9813519813519813,8,12
"['1010', '111110', '00', '110', '1110']",1,5,7,12,2,19,5.445238095238095,23,34
"['100100', '1011', '00100']",1,3,9,6,0,15,1.9535353535353535,7,10
"['1011', '01', '00101', '10011']",1,4,7,9,2,16,4.1650793650793645,13,18
"['01', '0000110', '111001', '0100']",1,4,11,8,0,19,3.0362859362859362,23,13
"['1101000', '00', '10110', '0010']",1,4,11,7,0,18,3.1724386724386724,19,20
"['111', '0010000', '0001', '0010011', '1010000', '1101', '01100', '111001']",1,8,24,19,5,43,15.792163392163392,88,90
"['0101111', '1', '0110110']",1,3,5,10,2,15,1.2142857142857144,15,5
"['0110111', '0101', '001', '01100']",1,4,9,10,0,19,3.532034632034632,16,19
"['010', '10', '0110100']",1,3,7,5,0,12,1.8444444444444446,10,10
"['11010', '100', '0101010', '010101', '0111111', '00010']",1,6,16,17,4,33,8.69928404928405,44,48
"['110110', '0110', '1110']",1,3,5,9,2,14,2.15,5,14
"['00100', '10101', '1010101', '0100001', '110']",1,5,15,12,4,27,5.947619047619048,30,28
"['011', '101010', '11101', '0111', '11100', '1111111']",1,6,8,22,2,30,8.921711621711621,43,58
"['1101', '011', '0111110', '1111']",1,4,4,14,2,18,3.7655844155844154,16,17
"['00001', '100010', '100000', '1010011', '0010010']",1,5,21,10,4,31,6.476523476523477,22,31
"['0110101', '01', '0111001', '1100', '01000']",1,5,13,12,2,25,5.795815295815296,32,31
"['00', '1', '01100']",1,3,5,3,0,8,0.9047619047619047,9,6
"['01', '101', '1001', '0010010', '000111', '01000']",1,6,16,11,0,27,9.372238872238873,44,35
"['1111001', '01001', '0010', '111']",1,4,8,11,0,19,3.264502164502164,21,17
"['010', '111010', '00000', '01100', '110', '1110', '111001']",1,7,16,16,6,32,12.693722943722944,54,65
"['1001', '1', '1011111']",1,3,3,9,0,12,1.1954545454545453,13,13
"['1010', '111000', '1110', '1111']",1,4,6,12,3,18,3.75,12,24
"['0110111', '1', '10001', '100000', '0111']",1,5,11,12,0,23,4.009063159063159,40,30
"['0011', '001', '000']",1,3,7,3,2,10,2.095238095238095,4,12
"['101101', '0101011', '110100', '111011', '0011111']",1,5,11,21,5,32,6.417582417582418,30,35
"['01', '0001', '0000000', '1000', '10011', '011001']",1,6,19,9,2,28,8.236191586191586,49,45
"['11110', '11', '0011', '0110', '00010']",1,5,9,11,4,20,5.784920634920635,25,28
"['0100010', '1011', '01001', '011']",1,4,10,9,0,19,4.252597402597402,15,17
"['11110', '0101', '00101']",1,3,6,8,2,14,1.7333333333333334,8,9
"['0101010', '1011011', '10011', '0001000']",1,4,14,12,3,26,3.5238095238095237,18,11
"['1110100', '10111', '10', '111011']",1,4,6,14,0,20,3.5123765123765125,20,25
"['0', '0000101', '01001', '011']",1,4,10,6,0,16,3.1,21,14
"['1111100', '111010', '101011', '1001', '10110', '10100', '10011']",1,7,15,23,5,38,14.126418026418026,51,75
"['0', '0101010', '100']",1,3,7,4,0,11,1.35,12,8
"['1', '0010100', '011', '01100']",1,4,9,7,0,16,3.2666666666666666,20,15
"['0110000', '100', '011']",1,3,8,5,2,13,1.5333333333333332,11,9
"['110111', '000', '1111']",1,3,4,9,0,13,0.8222222222222222,11,10
"['1001110', '00100', '010', '11100']",1,4,11,9,2,20,3.4166666666666665,17,18
"['0110111', '1', '00000']",1,3,7,6,0,13,0.5833333333333333,16,4
"['101101', '00000', '0011', '0001', '111111', '100011']",1,6,15,16,5,31,7.47020202020202,46,46
"['01011', '101', '10000', '001000']",1,4,12,7,2,19,3.367171717171717,18,14
"['0001100', '010010', '01111', '10']",1,4,11,9,0,20,3.044844044844045,23,16
"['111', '00', '100111', '1000011', '00010']",1,5,12,11,0,23,4.813891663891663,34,27
"['111001', '0011100', '1101010']",1,3,9,11,2,20,2.10989010989011,10,5
"['11110', '0110100', '000011', '001100', '00010', '101111']",1,6,18,17,5,35,8.534032634032634,47,47
"['01101', '00001', '1000', '110111', '1111111']",1,5,10,17,2,27,4.312043512043512,36,31
"['111', '00001', '101101', '10001', '1100']",1,5,11,12,2,23,5.59011544011544,26,35
"['001101', '1110011', '1010', '000', '1101']",1,5,11,13,2,24,5.961921411921412,31,25
"['0011011', '01001', '111011']",1,3,7,11,0,18,1.8146853146853146,8,11
"['1101101', '10100', '0101', '0010100']",1,4,12,11,2,23,4.010822510822511,17,17
['0001011'],1,1,4,3,0,7,0,0,0
"['0010', '1001', '1100110']",1,3,8,7,2,15,2.2045454545454546,8,5
"['000110', '011100', '11', '01000', '10100', '111101', '0100']",1,7,18,16,5,34,11.974314574314574,61,62
"['01', '110111', '000']",1,3,5,6,0,11,1.1222222222222222,11,4
"['0011010', '10', '000001']",1,3,10,5,0,15,1.1559829059829059,13,8
"['1101100', '001', '10011', '11']",1,4,7,10,0,17,3.2325396825396826,20,20
"['0', '111111', '110', '01110', '1011111']",1,5,5,17,0,22,4.659129759129759,36,29
"['11', '101011', '100110', '10011', '0001011']",1,5,11,15,2,26,6.718670218670218,28,46
"['11001', '110000', '01111', '10', '11100']",1,5,10,13,3,23,5.746753246753247,31,30
"['0', '110', '10010']",1,3,5,4,0,9,1.3333333333333333,8,7
"['0010001', '0010', '010000', '111001', '011000']",1,5,19,10,3,29,6.527272727272727,26,32
"['0011', '000', '0100']",1,3,8,3,2,11,1.6428571428571428,6,13
"['1011', '01', '0011', '110']",1,4,5,8,2,13,3.626190476190476,12,16
"['0001001', '0001', '011010']",1,3,11,6,0,17,1.7426573426573428,10,11
"['111111', '001', '0000']",1,3,6,7,0,13,0.7936507936507936,13,6
"['0', '1010000', '1000111', '1111011']",1,4,10,12,3,22,2.321428571428571,30,14
"['01', '001', '0011010', '1110001', '010110', '11111']",1,6,13,17,2,30,7.712537462537463,56,38
"['0010', '001', '11111']",1,3,5,7,0,12,1.3293650793650793,9,6
"['1101011', '000101', '0111']",1,3,7,10,0,17,1.760839160839161,9,8
"['001', '110', '0100', '00001']",1,4,10,5,2,15,2.9206349206349205,15,17
"['011', '0011110', '1101100', '00', '10', '0101100']",1,6,14,14,5,28,7.909523809523809,55,52
"['101', '11110', '111']",1,3,2,9,2,11,1.9166666666666665,6,12
"['0', '11011', '10000']",1,3,6,5,2,11,1.0666666666666667,11,4
"['0', '10100', '10001', '10000']",1,4,11,5,3,16,3.0,16,16
"['0001100', '1101000', '0000000', '11111']",1,4,16,10,3,26,2.4047619047619047,24,25
"['100011', '01110', '101101']",1,3,7,10,2,17,1.9393939393939394,10,5
"['0001001', '1', '010010']",1,3,9,5,0,14,1.304945054945055,14,4
"['1110101', '1001', '0000010', '1010011']",1,4,13,12,3,25,3.7142857142857144,21,15
"['011', '100101', '110111', '1010011', '011010']",1,5,11,17,3,28,6.753846153846154,29,29
"['0100000', '110', '1101']",1,3,8,6,0,14,1.6207792207792209,11,6
"['0000000', '1010111', '1000', '100000', '10']",1,5,18,8,2,26,5.240725940725941,38,40
"['01101', '110', '00001']",1,3,7,6,2,13,1.4,8,7
"['101', '01', '001']",1,3,4,4,2,8,2.2666666666666666,3,9
"['000011', '100', '10100', '111110', '0111', '1011', '110', '001100']",1,8,17,20,7,37,15.465656565656564,82,84
"['1', '110100', '1101010']",1,3,6,8,0,14,1.458791208791209,12,10
"['01', '10111', '0110', '10000', '1111010', '000010']",1,6,15,14,2,29,7.6772671772671774,50,39
"['110000', '110110', '011', '1011', '11100']",1,5,10,14,2,24,6.233910533910533,27,33
"['010', '01111', '11111']",1,3,3,10,2,13,1.55,8,11
"['0', '010111', '0111', '1011', '101001', '1011111']",1,6,9,19,4,28,8.877256077256078,47,48
"['0001101', '0', '011000']",1,3,9,5,0,14,1.151098901098901,15,10
"['00', '1', '1111000']",1,3,5,5,0,10,0.6944444444444444,13,6
"['00101', '0001', '100', '0110', '000111', '1100']",1,6,15,11,3,26,8.999494949494949,38,45
"['1011', '100110', '0110110']",1,3,7,10,0,17,2.1426573426573428,7,8
"['11000', '0001', '111']",1,3,6,6,0,12,1.4523809523809523,9,10
"['10100', '10101', '011', '110100']",1,4,9,10,2,19,4.130808080808081,13,20
"['101010', '0001', '0101', '101110', '1110']",1,5,11,13,5,24,5.483333333333333,25,28
"['01', '0111011', '0011110', '00', '01010', '1100110']",1,6,14,16,5,30,8.309523809523808,56,46
"['11110', '1110000', '101', '10000', '01110']",1,5,12,13,3,25,5.666666666666667,31,28
"['011101', '0001', '1']",1,3,5,6,0,11,1.0857142857142859,11,7
"['11000', '1110110', '1', '1011111']",1,4,6,14,2,20,2.4047619047619047,27,18
"['0000', '001', '101110', '1111']",1,4,8,9,2,17,2.3015873015873014,19,12
"['100100', '011010', '0', '0100']",1,4,11,6,2,17,3.038095238095238,20,22
"['0010', '10000', '110111', '10011', '000100']",1,5,15,11,4,26,5.648484848484848,27,26
['1010000'],1,1,5,2,0,7,0,0,0
"['0', '1000', '0111110']",1,3,6,6,0,12,1.0136363636363637,14,8
"['0010', '1100000', '1001', '10000', '10', '10011', '1110']",1,7,18,13,5,31,12.684776334776334,57,61
"['000110', '01', '111010', '1000110', '00110', '100111', '00010']",1,7,20,17,5,37,13.71014541014541,57,72
"['0001001', '1011001', '0111011', '00001', '10101', '1110011', '1000']",1,7,21,21,6,42,12.876190476190475,62,71
"['100', '0110', '110111', '0111110', '101001']",1,5,10,16,2,26,5.7534021534021536,34,21
"['0100111', '10001', '1111', '0100011', '1100', '111101']",1,6,13,20,4,33,8.682939282939282,44,61
['1101110'],1,1,2,5,0,7,0,0,0
"['1001110', '110', '0']",1,3,5,6,0,11,1.35,12,8
"['00100', '01', '11100']",1,3,7,5,2,12,1.457142857142857,9,9
"['0', '101000', '10110']",1,3,7,5,0,12,1.3463203463203464,11,8
['0010000'],1,1,6,1,0,7,0,0,0
"['0100000', '1110110', '10']",1,3,9,7,2,16,1.3174603174603174,14,7
"['101', '10100', '001110', '0000000']",1,4,14,7,0,21,2.552952602952603,23,17
"['1011', '100', '1']",1,3,3,5,0,8,1.4714285714285715,7,9
"['100', '1', '0111']",1,3,3,5,0,8,1.1857142857142857,8,6
"['00110', '1', '001011']",1,3,6,6,0,12,1.3463203463203464,11,6
"['10111', '1001', '011']",1,3,4,8,0,12,1.9880952380952381,6,10
"['001', '1110000', '11', '10101', '1101', '01011', '0100']",1,7,14,16,4,30,11.42106782106782,59,60
"['100110', '100', '10000', '11']",1,4,9,7,0,16,3.3296536796536795,17,19
"['10111', '0011', '00', '10010', '01001']",1,5,11,10,3,21,6.095238095238095,25,22
"['00', '0111011', '11']",1,3,4,7,2,11,0.8888888888888888,12,6
"['11000', '00', '1']",1,3,5,3,0,8,0.9047619047619047,9,6
"['0101', '100', '000001']",1,3,9,4,0,13,1.4158730158730157,9,8
"['10100', '0010', '110', '1']",1,4,7,6,0,13,2.9714285714285715,15,12
"['00011', '0110', '0000101', '00110', '01010']",1,5,16,10,3,26,7.356565656565657,23,36
"['00', '11101', '0110']",1,3,5,6,0,11,1.619047619047619,8,4
"['01', '1111001', '10', '000001', '01000', '1111011']",1,6,14,15,4,29,7.175796425796426,58,40
"['00011', '10111', '10110', '1101110', '11101', '0111']",1,6,10,21,4,31,10.04949494949495,35,51
"['1', '101', '0101011', '0000', '000100']",1,5,13,8,0,21,4.326712176712177,37,22
"['0010', '111', '1010', '00010', '1100', '01011']",1,6,13,12,5,25,8.556349206349205,34,43
"['010100', '010', '0111010', '00111', '00']",1,5,13,10,0,23,6.063891663891663,31,43
"['0011001', '1011110', '0001', '00', '10', '0101001']",1,6,16,13,5,29,7.803030303030303,57,44
"['01', '11110', '00', '0100000']",1,4,10,6,2,16,2.2936507936507935,24,17
"['101', '0011110', '10000', '0001011', '01001', '001001', '01000']",1,7,23,15,5,38,13.230719280719281,64,64
"['0', '100', '0110', '1000101']",1,4,9,6,0,15,2.866883116883117,21,12
"['111', '00001', '100', '000', '0001011']",1,5,13,8,3,21,4.566666666666666,30,34
"['0', '011110', '10110', '1100110']",1,4,8,11,0,19,3.045038295038295,22,21
"['11011', '110100', '10', '0110010', '101001']",1,5,12,14,2,26,6.508880008880009,31,24
"['001', '000011', '11', '100111', '0100']",1,5,11,10,2,21,5.304761904761905,30,26
"['011', '0011001', '100', '1111', '011110']",1,5,9,14,2,23,5.462426462426462,32,23
"['01101', '010001', '101011', '0001', '100', '0110010']",1,6,17,14,2,31,9.226129426129425,41,40
"['00001', '00', '0100', '11']",1,4,9,4,2,13,2.3015873015873014,16,15
"['11100', '10110', '01110', '00011']",1,4,9,11,4,20,4.0,17,16
"['0', '000100', '001011']",1,3,9,4,2,13,1.2380952380952381,13,10
"['1011001', '100', '1010', '1000', '11101', '001001']",1,6,15,14,2,29,9.62947607947608,37,48
"['00', '100101', '10']",1,3,6,4,2,10,1.5,9,5
"['100111', '0110100', '0100']",1,3,9,8,0,17,1.7888111888111888,11,8
"['0', '101', '110010', '011110']",1,4,7,9,2,16,2.6825396825396823,22,11
"['001', '1101011', '1111', '1010111', '0101', '110']",1,6,9,19,6,28,8.217748917748917,43,53
"['11', '101', '1101000', '1001', '10', '0100101']",1,6,12,13,4,25,9.255266955266954,47,45
"['01', '111100', '11000', '1000', '10', '0100']",1,6,13,10,4,23,8.673304473304473,40,42
"['0', '1111100', '0010', '010010']",1,4,10,8,0,18,2.5608891108891108,25,22
"['110', '100101', '01011']",1,3,6,8,0,14,1.6717171717171717,9,7
"['101', '0011', '0001110', '1']",1,4,7,8,0,15,2.8487012987012985,21,11
"['0000', '01110', '1111']",1,3,6,7,2,13,1.1111111111111112,9,4
"['11110', '10101', '1111', '00', '01011']",1,5,7,14,3,21,5.0285714285714285,27,27
"['1100010', '10000', '11']",1,3,8,6,0,14,1.5634920634920635,11,8
"['0', '101100', '000010', '11001']",1,4,11,7,2,18,2.5108225108225106,24,11
"['1100111', '010', '000', '0100']",1,4,10,7,2,17,3.4406926406926406,17,16
"['11', '0011', '1100001', '1010100', '1111000', '1000111']",1,6,16,18,4,34,8.158730158730158,59,55
"['00', '100', '001010', '11']",1,4,8,5,2,13,2.8666666666666667,16,15
"['01', '111', '10111', '1001101', '110', '01000']",1,6,10,15,4,25,7.82063492063492,46,40
"['101010', '1000', '01011']",1,3,8,7,0,15,1.9717171717171718,7,7
"['00111', '0001001', '001']",1,3,9,6,0,15,2.0166666666666666,9,12
['1000101'],1,1,4,3,0,7,0,0,0
"['0110101', '1010110', '010', '001', '000011', '001000', '011011', '0001', '0111']",1,9,25,21,9,46,21.107936507936508,104,107
"['00111', '01001', '1111110', '100010']",1,4,10,13,2,23,2.831934731934732,22,15
"['1101101', '1100001', '010', '0101001']",1,4,12,12,3,24,3.5428571428571427,19,18
"['0001001', '01', '010', '110']",1,4,9,6,2,15,3.311111111111111,18,15
"['1101', '10', '11']",1,3,2,6,2,8,1.8333333333333333,5,10
"['01101', '011', '0001', '010111', '001011']",1,5,11,13,2,24,6.205266955266955,23,30
"['0010', '1', '0001000', '111100']",1,4,11,7,0,18,2.5245254745254746,25,15
"['001', '01111', '1']",1,3,3,6,0,9,1.3333333333333333,9,6
"['0', '0100011', '001010']",1,3,9,5,0,14,1.151098901098901,14,8
"['01', '1100001', '00', '001110', '10']",1,5,11,8,3,19,4.794871794871795,36,22
"['00', '010001', '0111']",1,3,7,5,0,12,1.4333333333333333,10,7
"['0', '101000', '011010']",1,3,8,5,2,13,1.2380952380952381,13,8
"['100', '110', '100001', '1']",1,4,7,6,2,13,3.0634920634920633,17,16
"['011', '111', '0100010', '100', '010111']",1,5,10,12,3,22,5.326495726495726,32,29
"['0010', '10001', '10000', '1001001', '011111', '1011']",1,6,16,15,4,31,8.872649572649573,43,44
"['001111', '00101', '11']",1,3,5,8,0,13,1.7987012987012987,9,10
"['110010', '1111000', '00', '00010', '01100']",1,5,15,10,2,25,5.877744477744478,34,40
"['01', '010', '111010', '01100']",1,4,8,8,0,16,4.0153679653679655,15,19
"['0', '000011', '1100111', '1011011', '110101']",1,5,11,16,4,27,4.9010989010989015,40,31
"['101100', '10001', '1111', '00110', '10011', '000000', '01110']",1,7,19,17,6,36,11.27878787878788,60,49
"['1110111', '101', '1111']",1,3,2,12,0,14,1.8987012987012988,9,20
"['101', '1110100', '01010']",1,3,7,8,0,15,2.0166666666666666,9,4
"['1001110', '001', '100001', '111', '01000']",1,5,13,11,2,24,5.403768453768453,34,23
"['0011011', '10100', '011000']",1,3,10,8,0,18,1.8426573426573427,10,9
"['001100', '100', '110']",1,3,7,5,2,12,2.0,7,9
"['1', '10', '0100']",1,3,4,3,0,7,1.7333333333333334,6,4
"['0010001', '0011000', '11', '000010', '1011', '110']",1,6,17,12,2,29,8.20024975024975,53,39
"['0111', '01010', '101001']",1,3,7,8,0,15,1.993939393939394,8,5
"['0110101', '01', '010', '00', '100111']",1,5,10,10,2,20,5.648717948717949,32,22
"['0110', '0111', '1111']",1,3,3,9,3,12,2.0,4,10
"['0001111', '1', '0110', '0100']",1,4,8,8,2,16,2.709090909090909,22,12
"['01', '0010', '00111', '1001', '000']",1,5,11,7,2,18,6.316666666666666,22,25
"['101100', '1101', '0011010']",1,3,8,9,0,17,2.0965034965034963,8,5
"['0110', '011', '0000000']",1,3,10,4,0,14,1.4207792207792207,12,10
"['0010', '011', '1000', '0000', '101111']",1,5,12,9,3,21,5.059523809523809,28,27
"['0000101', '1', '10']",1,3,6,4,0,10,1.3611111111111112,12,6
"['100', '010', '011010', '0101110']",1,4,10,9,2,19,3.9692307692307693,18,26
"['010', '1', '000001']",1,3,7,3,0,10,1.2301587301587302,11,4
"['0011001', '010', '010000']",1,3,11,5,0,16,1.882051282051282,10,11
"['101', '10', '011001']",1,3,5,6,0,11,1.9666666666666668,8,8
"['00100', '10', '1101010']",1,3,8,6,0,14,1.6825396825396823,11,7
"['1010', '1001', '00011']",1,3,7,6,2,13,1.8611111111111112,7,7
"['0', '1011101', '1101', '0111011']",1,4,6,13,2,19,3.2116883116883117,23,14
"['11001', '0110011', '0101011', '1101110', '0111111', '110111', '000001', '1011', '0100']",1,9,21,32,8,53,20.34970584970585,107,121
"['11110', '1011101', '1001', '1111', '0000010']",1,5,11,16,4,27,5.467532467532467,34,29
"['0110', '10', '001010']",1,3,7,5,0,12,1.9666666666666668,8,11
"['0111010', '001000', '001010', '000', '0101']",1,5,17,9,2,26,6.84998334998335,26,48
"['001000', '11', '10', '1100', '01100', '0100']",1,6,14,9,4,23,9.381240981240982,35,46
"['0001', '10', '11']",1,3,4,4,2,8,1.1666666666666665,7,6
"['00001', '01000', '01010', '1011000']",1,4,15,7,3,22,3.8,15,23
"['1011', '001', '110', '011000']",1,4,8,8,2,16,3.187301587301587,18,12
"['1001110', '00100', '010101', '1']",1,4,10,9,0,19,2.7117049617049616,24,10
"['0100001', '0010', '011']",1,3,9,5,0,14,1.7168831168831167,10,7
"['01', '00101', '101', '10001', '1001100']",1,5,12,10,2,22,6.420634920634921,28,34
"['0000101', '110', '11']",1,3,6,6,0,12,1.6444444444444444,11,8
"['0010', '100001', '0001', '1010100', '10110', '00110', '11111', '110', '0100']",1,9,23,20,6,43,19.536574536574538,99,100
"['11110', '011001', '011', '110100', '10', '0000', '110101']",1,7,15,17,3,32,10.76017316017316,63,55
"['1101111', '111', '101', '000001', '1110']",1,5,8,15,2,23,5.015051615051615,35,40
"['01', '111', '000011', '1000110', '0100100', '110', '0100']",1,7,18,14,4,32,10.83988233988234,70,57
"['1011', '1101', '0011101', '0111']",1,4,6,13,3,19,4.25,16,20
"['0101010', '1', '1100110']",1,3,7,8,2,15,1.0714285714285714,15,5
"['01', '011', '1111', '00', '110']",1,5,5,9,4,14,4.642857142857143,21,24
"['1110100', '101', '00', '10']",1,4,7,7,2,14,3.188888888888889,18,13
"['0011', '10010', '110', '101110']",1,4,8,10,0,18,3.732034632034632,15,18
"['01', '100', '10', '1011000', '101111']",1,5,9,11,2,20,5.248717948717949,34,29
"['00', '11101', '100111', '1010', '110', '01011', '01100']",1,7,13,17,3,30,12.229292929292928,58,50
"['0010110', '11110', '100', '000', '0010010', '110', '1001111']",1,7,18,17,6,35,11.576190476190476,69,69
"['0110101', '01001', '1', '011']",1,4,7,9,0,16,3.1,20,17
"['0001', '100', '1']",1,3,5,3,0,8,1.4714285714285715,7,7
"['1010', '11101', '00110', '000', '1110', '111001']",1,6,12,15,4,27,8.922799422799422,36,42
"['0', '10111', '100101', '0010011']",1,4,9,10,0,19,2.8503996003996,23,12
"['11001', '0011', '1111', '000', '01000']",1,5,11,10,4,21,4.921428571428571,27,28
"['11001', '1101', '010', '111']",1,4,5,10,2,15,3.9007936507936507,11,19
"['00101', '1101101', '1000111', '00', '10', '0101001']",1,6,15,15,5,30,8.142857142857142,54,36
"['0', '110110', '10000']",1,3,7,5,0,12,1.1645021645021645,12,6
"['010001', '1101110', '000010', '0111', '0101', '1110']",1,6,15,16,5,31,8.802564102564103,46,44
"['00', '11101', '0001', '1001']",1,4,8,7,2,15,3.4801587301587302,14,16
"['110110', '00001', '100', '01001', '1100']",1,5,13,10,2,23,6.394011544011544,24,28
"['1001110', '0001', '1001000', '00', '11100']",1,5,15,10,2,25,5.543290043290043,35,33
"['10', '0100', '11']",1,3,4,4,2,8,1.5,6,4
"['0000', '10', '001000']",1,3,10,2,0,12,1.4333333333333333,9,14
"['00100', '0101', '1', '101001']",1,4,9,7,0,16,3.212987012987013,18,11
"['1001111', '000000', '1111011']",1,3,9,11,2,20,1.0329670329670328,14,8
"['1101', '1', '0000']",1,3,5,4,2,9,0.65,10,4
"['1010', '0110', '000010']",1,3,9,5,2,14,1.7,8,12
"['0111111', '10', '0100', '11']",1,4,5,10,2,15,2.5303030303030303,22,13
"['1011101', '100', '00', '1101']",1,4,7,9,0,16,3.4764790764790763,18,16
"['010100', '110', '0110', '10']",1,4,8,7,0,15,4.068253968253968,13,19
"['0', '10101', '001', '11']",1,4,5,6,0,11,2.3047619047619046,15,11
"['0001101', '100101', '10000', '11']",1,4,11,9,0,20,3.3933288933288934,21,20
"['0010', '1011110', '101', '0001', '1111', '00', '0110010']",1,7,15,16,5,31,11.137157287157287,67,51
"['01', '011010', '10000']",1,3,8,5,0,13,1.331168831168831,11,7
"['101010', '001010', '1011000']",1,3,11,8,2,19,2.217948717948718,6,13
"['11001', '0110', '10', '1111']",1,4,5,10,2,15,3.4047619047619047,15,13
"['11110', '1010', '11101', '1011', '1100']",1,5,7,15,5,22,6.355555555555555,20,32
"['1000000', '01', '100100', '1']",1,4,11,5,0,16,2.693833943833944,24,15
"['110110', '1101', '1010101', '00']",1,4,8,11,0,19,3.3924630924630925,20,15
"['01', '001', '100']",1,3,5,3,2,8,1.8666666666666667,5,8
"['0110', '1111000', '000']",1,3,8,6,0,14,1.7168831168831167,10,12
"['0', '10', '11']",1,3,2,3,2,5,1.1666666666666665,4,4
"['0', '101010', '111']",1,3,4,6,0,10,0.9523809523809523,11,4
"['010', '100100', '011', '000']",1,4,10,5,3,15,3.444444444444444,14,17
"['1111010', '01001', '00']",1,3,7,7,0,14,1.5158730158730158,12,6
"['110001', '110', '0000001']",1,3,10,6,0,16,1.4820512820512821,12,11
"['00111', '1000110', '010', '1110']",1,4,9,10,0,19,3.532034632034632,18,18
"['11011', '1100001', '1000111', '1111', '0000', '0000111', '0101', '1100']",1,8,20,22,7,42,15.972582972582972,86,108
"['101', '01', '01111', '000']",1,4,6,7,2,13,2.854761904761905,15,12
['1101101'],1,1,2,5,0,7,0,0,0
"['1101001', '10010', '0110', '100010']",1,4,12,10,0,22,3.781041181041181,16,17
"['01100', '001', '000111', '11']",1,4,8,8,0,16,3.1835497835497835,19,15
['0110010'],1,1,4,3,0,7,0,0,0
"['011101', '01', '000']",1,3,6,5,0,11,1.3444444444444446,10,8
"['010', '101001', '10011', '1011', '00010', '000111', '1100', '1110']",1,8,18,19,7,37,16.752669552669552,74,77
"['0', '110110', '0010100', '1110000']",1,4,12,9,2,21,2.587912087912088,26,17
"['11110', '00100', '100', '100110', '1000', '001011']",1,6,16,13,4,29,9.141486291486292,40,51
"['1000001', '001001', '0001111', '0101', '110', '1110', '0100']",1,7,19,16,5,35,11.705733155733157,68,55
"['111', '1001', '100101', '0000111', '0101']",1,5,11,13,2,24,6.465817515817516,28,38
"['010100', '11001', '00100', '1111', '0111', '1110']",1,6,12,16,5,28,8.997474747474747,38,45
"['0111000', '0011', '001110', '010111']",1,4,11,12,2,23,4.363403263403264,17,21
"['1110001', '1011000', '0100']",1,3,10,8,2,18,2.1298701298701297,9,5
"['01', '0010', '11000', '101', '010111', '0100011']",1,6,14,13,0,27,8.646575646575647,47,37
"['01', '010010', '100000', '10', '000100']",1,5,16,6,5,22,5.083333333333333,34,28
"['11011', '11', '1111000', '00', '10', '001001']",1,6,11,13,3,24,6.7688977688977685,52,41
['011110'],1,1,2,4,0,6,0,0,0
"['01', '0001', '01101', '000']",1,4,9,5,0,14,3.4396825396825395,13,20
"['101', '00', '110001']",1,3,6,5,0,11,1.5666666666666667,9,5
"['1', '0100100', '001110', '100111']",1,4,10,10,2,20,2.8855311355311355,24,9
"['11001', '10001', '0']",1,3,6,5,2,11,1.4666666666666668,9,6
"['01', '001', '0101110']",1,3,6,6,0,12,1.6444444444444444,10,8
"['01', '10', '110111']",1,3,3,7,2,10,1.5,10,6
"['0100111', '111', '011100', '1010', '1101', '0110110']",1,6,12,19,4,31,9.564918414918415,44,38
"['1101111', '111', '1010101', '1011100', '001100']",1,5,11,19,3,30,6.079609279609279,33,32
"['00', '010101', '1', '111011']",1,4,6,9,2,15,1.9880952380952381,24,10
"['001', '11000', '101', '1111', '1110001', '00']",1,6,11,13,2,24,7.944733044733045,43,46
"['010000', '111', '1001', '100', '010101', '10011', '1110']",1,7,15,16,6,31,12.453607503607504,53,60
"['011101', '00', '010', '001']",1,4,8,6,2,14,3.8777777777777778,14,18
"['11010', '010', '1001', '10011', '0000', '1101', '1110']",1,7,14,15,6,29,12.046825396825396,46,54
"['1001110', '000110', '001111', '00111', '0011', '101', '1100000', '000']",1,8,22,19,6,41,16.75865245865246,87,96
"['11011', '100', '0110', '111110']",1,4,6,12,0,18,3.327994227994228,17,14
"['010', '1', '011100', '001110', '000']",1,5,11,8,4,19,5.015873015873016,30,31
"['0101', '1', '001011']",1,3,5,6,0,11,1.4857142857142858,10,6
"['100', '10010', '11']",1,3,5,5,0,10,1.7214285714285715,7,8
"['0010', '10', '0000']",1,3,8,2,2,10,1.75,6,11
"['101000', '00', '11100', '101101']",1,4,10,9,2,19,3.6926406926406927,17,17
"['000110', '100001', '0110100', '100', '1001101']",1,5,17,12,4,29,6.307448107448107,33,27
"['00001', '10111', '110', '00000']",1,4,11,7,3,18,2.4,19,17
"['0', '01', '1001110', '1001011']",1,4,8,9,2,17,2.9126984126984126,25,13
"['001', '1', '011', '1000010', '0000011', '0100']",1,6,16,9,4,25,7.5329004329004325,51,34
"['01', '1010', '0001', '0111']",1,4,7,7,3,14,3.5,14,14
"['100', '000', '11']",1,3,5,3,2,8,1.0666666666666667,6,6
"['1111', '00010', '111011']",1,3,5,10,0,15,1.385858585858586,10,10
"['01', '100110', '10001', '001000']",1,4,12,7,2,19,3.6926406926406927,19,13
"['011111', '00110', '10', '01010']",1,4,8,10,2,18,3.283766233766234,19,18
"['0011', '0001', '100', '1111']",1,4,7,8,3,15,2.9285714285714284,14,17
"['00', '10010', '10']",1,3,6,3,2,9,1.6428571428571428,7,8
"['1111100', '10111', '1010', '11']",1,4,5,13,0,18,3.3946608946608947,19,22
"['10111', '101', '00', '010101', '0000011']",1,5,12,11,0,23,5.135636585636585,34,25
"['0', '0011011', '001', '0101']",1,4,8,7,0,15,3.0487012987012987,19,15
"['010', '1', '1110']",1,3,3,5,0,8,1.4714285714285715,7,5
"['0011001', '100', '1100']",1,3,8,6,0,14,2.1844155844155844,8,10
"['1', '010', '0110', '000011']",1,4,8,6,0,14,3.087301587301587,19,12
"['1001', '100', '0111']",1,3,5,6,2,11,1.6428571428571428,7,8
"['110110', '1', '10001', '01111', '110011', '1010']",1,6,10,17,4,27,7.746176046176046,48,44
"['1100', '1', '00011']",1,3,5,5,0,10,1.1777777777777778,11,8
"['00', '111110', '0001', '001101']",1,4,9,9,2,18,2.716666666666667,22,18
"['01001', '10', '10011', '11']",1,4,6,8,4,14,3.5857142857142854,15,17
"['001', '11011', '1101111', '111', '000']",1,5,7,14,3,21,4.533333333333333,32,39
"['001', '1000101', '1111']",1,3,6,8,0,14,1.431168831168831,11,9
"['11011', '1111', '10', '00010', '110']",1,5,7,12,2,19,5.608730158730158,25,30
"['011011', '1010010', '110']",1,3,7,9,0,16,1.682051282051282,10,8
"['11010', '011', '1100010', '101', '00']",1,5,10,10,2,20,5.565873015873016,30,24
"['0000101', '0010110', '000001', '011110']",1,4,16,10,4,26,3.3553113553113554,18,22
"['000110', '11010', '00101', '101', '1100']",1,5,12,11,2,23,6.3219336219336215,27,26
"['1010', '00', '011000']",1,3,8,4,0,12,1.7666666666666666,9,10
"['0100110', '011', '11', '11000', '10', '01011']",1,6,11,13,4,24,8.624603174603175,44,43
"['00111', '101100', '10', '00001']",1,4,10,8,2,18,2.5805194805194804,21,16
"['1001001', '110', '1100']",1,3,7,7,0,14,1.8025974025974025,8,8
"['0110011', '1110', '0001101', '1011', '111101', '0100']",1,6,13,19,5,32,8.517782217782218,48,41
"['110', '1100', '010110', '0111']",1,4,7,10,2,17,3.795238095238095,14,19
"['11001', '011', '11', '010010', '0000000', '100110', '001010']",1,7,21,14,3,35,11.776556776556777,71,50
"['1000100', '011', '00100', '1010', '0101']",1,5,14,9,2,23,6.517965367965368,26,27
"['100001', '101', '1010', '000', '1101']",1,5,11,9,4,20,6.188095238095237,23,28
"['010100', '111', '0000011', '10', '01100']",1,5,13,10,0,23,4.908724608724609,36,25
"['0', '11110', '1001000', '10110', '10100', '1111111']",1,6,12,18,5,30,6.7023809523809526,55,41
"['010100', '001', '0110111', '011', '00110']",1,5,12,12,2,24,6.287101787101787,27,31
"['1100011', '1101111', '00101', '0100']",1,4,10,13,2,23,3.4567099567099566,21,16
"['010', '001', '000', '1001100', '1110110', '0101', '001011']",1,7,18,15,5,33,13.035964035964035,63,59
"['0011001', '000111', '100010', '0']",1,4,12,8,2,20,2.8727106227106227,26,13
"['10100', '100100', '1111101']",1,3,8,10,0,18,1.8706293706293706,9,10
"['1000', '1', '10']",1,3,4,3,0,7,1.7333333333333334,6,7
"['01001', '111010', '0101001', '11']",1,4,9,11,0,20,3.51004551004551,21,20
['1101100'],1,1,3,4,0,7,0,0,0
"['0011', '1111000', '111011', '0111', '01100']",1,5,10,16,2,26,6.019930069930069,30,36
"['01', '0001101', '110011', '001001', '1100']",1,5,13,12,2,25,5.774514374514374,34,30
"['1', '00000', '10110', '1000', '0101']",1,5,12,7,4,19,4.477777777777778,31,23
"['0011', '1101', '10']",1,3,4,6,2,10,1.5,8,7
['0000111'],1,1,4,3,0,7,0,0,0
"['0', '01101', '100010', '11']",1,4,7,7,0,14,2.2359307359307357,22,10
"['10101', '010', '01110']",1,3,6,7,2,13,1.9,7,6
"['0001100', '1001', '0110', '1']",1,4,9,7,2,16,2.8227272727272728,22,8
"['10001', '000100', '00101']",1,3,11,5,2,16,2.0545454545454547,7,7
"['00001', '00000', '0110', '0100', '0100101', '110101']",1,6,20,11,4,31,8.645493395493396,38,49
"['101100', '101', '00', '10010', '1110100']",1,5,12,11,0,23,5.747224997224997,30,28
"['0111', '011', '001011', '10011']",1,4,7,11,0,18,4.267748917748918,12,23
"['010100', '0010', '001', '111', '010101', '1011']",1,6,13,13,6,26,8.552380952380952,34,37
"['10100', '1100', '1000111', '11']",1,4,8,10,0,18,3.6168831168831166,19,22
"['0', '01101', '0100']",1,3,6,4,0,10,1.4,9,9
"['1010110', '11', '1111010', '00', '110']",1,5,8,13,4,21,4.749206349206349,36,27
"['1', '011100', '101', '10001', '101001']",1,5,10,11,2,21,5.205266955266955,33,32
"['01', '001', '1']",1,3,3,3,0,6,1.9666666666666668,4,7
"['1000001', '101100', '0111001', '1', '00111', '1010', '00010']",1,7,19,16,4,35,10.665689865689865,75,51
"['011', '11000', '10111', '110001', '01100']",1,5,11,13,3,24,6.426262626262626,28,30
"['11001', '00010', '100001', '00000']",1,4,15,6,3,21,3.981818181818182,14,14
"['11000', '1100101', '011', '1111']",1,4,7,12,0,19,3.4764790764790767,18,25
"['0000101', '01', '11']",1,3,6,5,2,11,1.3888888888888888,11,7
"['0010', '010010', '0111', '000100', '1100', '01000']",1,6,19,10,5,29,9.38080808080808,37,62
"['0', '101', '0010', '11']",1,4,5,5,0,10,2.604761904761905,13,8
"['11111', '010', '110101']",1,3,4,10,0,14,1.643939393939394,9,6
"['10101', '100', '110']",1,3,5,6,2,11,1.9166666666666665,5,7
"['1011001', '101', '1111', '0001010', '110']",1,5,10,14,4,24,5.49004329004329,34,26
"['10', '010110', '1101', '00010', '0100']",1,5,12,9,2,21,5.961327561327561,25,26
"['1101', '110101', '11111']",1,3,3,12,0,15,2.193939393939394,6,21
"['11010', '00000', '1100001', '1000000', '1000', '001011']",1,6,23,11,4,34,8.82897102897103,45,53
"['010000', '10101', '1100000', '0101011', '011001', '1100']",1,6,20,15,4,35,9.35937395937396,43,43
"['01', '11110', '1100', '000', '11111', '011010', '11100', '0110011']",1,8,15,22,3,37,15.071034521034521,81,88
"['1000101', '000101', '10110', '00', '1110001', '000111']",1,6,18,15,4,33,9.188589188589189,50,45
"['11100', '111', '0100']",1,3,5,7,0,12,1.7023809523809523,7,10
"['011', '1010100', '1010', '110111', '0000', '1101', '011000']",1,7,17,17,5,34,11.782883782883783,61,57
"['1000', '110001', '111']",1,3,6,7,0,13,1.7523809523809524,8,10
"['0', '010', '0111101']",1,3,5,6,0,11,1.35,12,9
"['11011', '0101111', '0010101', '10100', '1010001']",1,5,14,17,5,31,6.6,30,30
"['100100', '0101', '11101', '000111']",1,4,10,11,2,21,3.4575757575757575,18,17
['0111001'],1,1,3,4,0,7,0,0,0
"['011011', '0011', '11101', '010011', '0100']",1,5,11,14,4,25,5.77979797979798,24,34
"['00111', '101100', '110101']",1,3,7,10,2,17,1.7575757575757573,9,8
['0110111'],1,1,2,5,0,7,0,0,0
"['1101001', '01', '111001', '0']",1,4,7,9,0,16,3.0699023199023197,22,16
['0101110'],1,1,3,4,0,7,0,0,0
"['0101000', '100001', '011', '0101101', '011111', '00010']",1,6,18,16,4,34,8.257331557331558,50,41
"['01', '00111', '11000', '100100', '100110', '000', '000111']",1,7,19,14,5,33,12.407142857142857,62,70
"['11000', '0010101', '0001000', '11']",1,4,13,8,2,21,3.119047619047619,24,20
"['0011011', '00110', '01101']",1,3,8,9,2,17,2.466666666666667,6,10
"['01', '1', '0000001', '00101']",1,4,10,5,0,15,2.765873015873016,22,16
"['0110010', '11110', '01', '00']",1,4,8,8,2,16,2.4603174603174605,22,16
"['10111', '10011', '01100', '11']",1,4,6,11,3,17,3.7142857142857144,17,18
"['00', '0111001', '100']",1,3,7,5,0,12,1.8444444444444446,10,8
"['001111', '101011', '10001', '0000', '001100', '11100']",1,6,17,15,5,32,8.947474747474747,45,48
"['0', '0110000', '010011']",1,3,9,5,0,14,0.9972527472527473,14,9
"['111', '101000', '100', '0000001', '111110', '111101', '01100']",1,7,17,19,5,36,10.257925407925407,73,61
"['10100', '100000', '011100']",1,3,11,6,2,17,1.7727272727272727,8,11
"['110000', '1000', '1101101', '0000010']",1,4,15,9,2,24,3.4073926073926075,21,19
"['110001', '0000110', '000', '11111', '1101', '0101', '11100']",1,7,16,18,4,34,11.408386058386059,66,61
"['010', '001', '000101', '10011', '000', '000100', '011000']",1,7,22,10,6,32,13.179292929292929,57,78
"['0', '010', '000111']",1,3,6,4,0,10,1.2301587301587302,11,8
"['101100', '1010110', '111', '000']",1,4,9,10,2,19,2.658119658119658,19,14
"['001100', '0001', '010101']",1,3,10,6,2,16,1.6666666666666665,8,9
"['01', '100101', '000', '0011100', '0100']",1,5,14,8,0,22,5.638017538017538,31,31
"['0110101', '1001', '0010011', '0110000', '10100', '11111', '0000111', '00010', '0101']",1,9,27,24,9,51,20.78044733044733,114,100
"['00', '100', '0110']",1,3,6,3,0,9,2.038095238095238,5,10
"['101', '010011', '111010', '1110']",1,4,7,12,2,19,3.604761904761905,17,18
"['11110', '011', '101', '1000110', '000111', '1100', '1110']",1,7,13,19,4,32,12.823126873126872,61,64
"['100', '100111', '1101111']",1,3,5,11,0,16,1.835897435897436,10,13
"['1110101', '1110011', '0']",1,3,5,10,2,15,1.3571428571428572,14,8
"['011', '10100', '00', '10', '011001']",1,5,10,8,2,18,5.336796536796537,28,25
"['010100', '111100', '1111101', '110100', '00', '0011100']",1,6,16,18,5,34,8.904761904761905,46,64
"['1010', '0010', '000']",1,3,8,3,2,11,2.1785714285714284,4,12
"['0001010', '1101101', '11']",1,3,7,9,2,16,1.4603174603174602,14,6
"['1010101', '10000', '1111', '10100', '00', '10010', '101110']",1,7,17,17,3,34,12.233011433011432,57,61
"['101000', '010', '110']",1,3,7,5,2,12,1.7777777777777777,7,7
"['1100001', '0000001', '1100110', '1110']",1,4,14,11,3,25,3.1298701298701297,23,23
"['100100', '10', '000011']",1,3,9,5,2,14,1.25,13,8
"['01', '111110', '11']",1,3,2,8,2,10,1.25,10,8
"['0011', '00100', '11111']",1,3,6,8,2,14,1.3111111111111111,9,9
"['110110', '00110', '001', '0101110']",1,4,10,11,0,21,3.9242812742812743,16,23
"['1101111', '00001', '1011110', '1100010', '101']",1,5,12,17,3,29,5.4904761904761905,37,29
"['00', '1010100', '001', '10']",1,4,9,5,2,14,2.988888888888889,18,18
"['0', '00110', '001']",1,3,6,3,0,9,1.5833333333333333,8,10
"['11001', '001', '00', '000001', '1011']",1,5,12,8,0,20,5.582756132756133,27,30
"['0010001', '101', '10', '11']",1,4,7,7,2,14,3.388888888888889,17,16
"['10101', '1110000', '111001']",1,3,8,10,0,18,1.9965034965034967,8,13
"['1000010', '00110', '0100']",1,3,11,5,0,16,1.6565656565656566,9,10
"['010', '001', '11000', '00', '110111', '1000011']",1,6,14,12,2,26,8.248934398934399,49,37
"['001001', '000', '1110']",1,3,8,5,0,13,1.3523809523809525,10,8
"['1010', '0001', '010', '11']",1,4,7,6,2,13,3.3285714285714283,13,12
"['100101', '0110', '00000']",1,3,10,5,0,15,1.38989898989899,9,4
"['0', '0011', '0101111', '0111']",1,4,6,10,2,16,3.254545454545455,19,17
"['1010', '00', '111', '0111']",1,4,5,8,2,13,2.9285714285714284,14,14
"['11010', '101', '1001', '0100001', '01000']",1,5,14,10,2,24,6.701082251082251,25,27
"['010', '10', '000000', '0010011']",1,4,13,5,0,18,3.154273504273504,22,17
"['101010', '10110', '1']",1,3,5,7,0,12,1.528138528138528,10,9
"['11011', '111100', '1101', '01001', '000111', '1110']",1,6,11,19,6,30,9.48030303030303,43,53
['100011'],1,1,3,3,0,6,0,0,0
"['101001', '101', '10100', '1001010']",1,4,11,10,0,21,4.207808857808858,15,26
"['10010', '011', '1111111', '0100']",1,4,7,12,0,19,2.653246753246753,24,13
"['101011', '01', '1001']",1,3,5,7,0,12,1.9666666666666668,8,10
"['00111', '110', '1']",1,3,3,6,0,9,1.3333333333333333,9,7
"['00', '0010', '111011']",1,3,6,6,0,12,1.3166666666666667,11,6
"['11000', '100', '101110']",1,3,7,7,0,14,1.962121212121212,8,8
"['10', '0010000', '1111']",1,3,7,6,0,13,0.9595959595959596,14,4
"['0011', '00', '010110', '0111']",1,4,8,8,2,16,3.65,14,18
"['0100000', '010', '0011', '000', '011001', '1011', '0101001']",1,7,21,13,6,34,12.037667887667887,61,63
"['101100', '010010', '0001111', '0110000', '0111']",1,5,16,14,4,30,6.183349983349983,35,32
"['1000010', '10', '1110']",1,3,7,6,0,13,1.4747474747474747,11,10
"['0000', '100', '100011', '111011']",1,4,10,9,2,19,3.149206349206349,19,17
"['0001111', '011', '111', '0000']",1,4,8,9,2,17,2.6978354978354977,20,21
"['0110101', '0001101', '11011']",1,3,8,11,2,19,2.2142857142857144,9,8
"['110110', '00', '0101', '1100001']",1,4,10,9,0,19,3.19013209013209,21,13
"['1111100', '1001001', '00', '0001011']",1,4,12,11,3,23,2.761904761904762,27,16
"['101110', '011', '0110100']",1,3,7,9,0,16,1.882051282051282,10,8
"['00011', '0011', '0001101', '1101', '110']",1,5,11,12,2,23,6.64978354978355,27,38
"['001100', '01010', '1110000', '101111']",1,4,12,12,2,24,3.3496503496503496,22,14
"['1010', '100111', '111']",1,3,4,9,0,13,1.838095238095238,8,13
"['0111101', '11110', '1001', '10']",1,4,6,12,0,18,3.3239538239538238,19,15
"['110100', '1101110', '010101', '010111', '1100']",1,5,12,17,3,29,6.6811188811188815,25,35
"['1111001', '0111', '11']",1,3,3,10,0,13,1.6565656565656566,11,14
"['1000011', '10001', '0011001', '0']",1,4,12,8,2,20,2.9047619047619047,25,15
"['110010', '10', '11111']",1,3,4,9,0,13,1.331168831168831,11,9
"['0', '101', '1101', '1101100']",1,4,6,9,0,15,3.3344155844155843,19,15
"['1111010', '0101', '110110', '1101100']",1,4,9,15,2,24,4.097502497502497,16,20
"['1', '1001001', '0001010', '11100', '01110']",1,5,13,12,4,25,4.514285714285714,39,18
"['0010', '1', '0111']",1,3,4,5,2,9,1.3,8,4
"['000110', '01111', '1']",1,3,5,7,0,12,1.1645021645021645,12,4
"['11001', '0001001', '0111000', '1110101', '000', '000111']",1,6,19,16,3,35,9.039227439227439,52,54
"['1011', '111111', '101110']",1,3,3,13,2,16,1.7000000000000002,7,13
"['1111010', '1011101', '1100', '011100']",1,4,9,15,2,24,4.468331668331668,15,14
"['001', '1000101', '1', '10000', '111110', '001110', '0101']",1,7,16,16,2,32,9.937146187146187,74,55
"['1100000', '01111', '1111111']",1,3,6,13,2,19,1.2857142857142856,14,15
"['001', '101101', '011011', '10111', '101010', '00', '1100101', '1110']",1,8,16,23,3,39,16.291630591630593,80,77
"['11001', '01', '1001010', '1011', '11100']",1,5,10,13,2,23,5.369264069264069,30,27
"['0101000', '10111', '1001', '0101011', '10000']",1,5,15,13,4,28,6.053679653679653,28,29
"['11010', '11', '100110', '001100', '01100']",1,5,12,12,4,24,6.685281385281385,27,26
"['1010', '000100', '101110']",1,3,9,7,2,16,1.9,8,9
"['11011', '1', '111010']",1,3,3,9,0,12,1.3463203463203464,11,10
"['11001', '0011000', '11', '01100', '0010011', '1011', '010011', '101001']",1,8,21,21,6,42,18.23200133200133,79,86
"['0110101', '01', '10', '111']",1,4,5,9,2,14,2.7888888888888888,20,14
"['01', '011', '00', '1101', '110']",1,5,6,8,4,14,5.595238095238095,18,24
"['101', '111100', '100111', '0000']",1,4,9,10,2,19,2.696825396825397,22,15
"['0000111', '0101', '10', '000011']",1,4,11,8,0,19,3.2074203574203572,21,18
"['11010', '1010100', '1', '0110']",1,4,8,9,0,17,2.68030303030303,20,11
"['01101', '100', '1000111', '00', '01100']",1,5,12,10,2,22,6.203968253968254,31,29
"['001000', '1011001', '000', '11']",1,4,11,7,0,18,2.2226495726495727,23,14
"['0', '011100', '00100', '1111110', '110']",1,5,10,12,0,22,4.811704961704962,37,32
"['011', '11', '00011', '000101', '010010', '1010', '011001']",1,7,17,15,3,32,13.80093795093795,56,56
"['000110', '00110', '11101', '01100']",1,4,11,10,3,21,4.181818181818182,15,19
"['11001', '01', '1001', '000']",1,4,8,6,0,14,3.598412698412698,13,15
"['011101', '1101', '001', '10010']",1,4,8,10,0,18,3.777994227994228,15,17
"['011101', '00', '10010', '0110']",1,4,9,8,0,17,3.527994227994228,17,17
"['11', '01100', '0001', '1001001', '0100101']",1,5,14,11,2,25,5.534632034632034,33,24
"['111', '00001', '0011', '000010', '0001010']",1,5,16,9,0,25,5.782578532578532,28,33
"['101110', '01', '011']",1,3,4,7,0,11,1.9666666666666668,8,7
"['0011', '010', '0110', '000110']",1,4,10,7,2,17,4.445238095238095,12,25
"['101', '100011', '10', '000']",1,4,8,6,2,14,3.3666666666666667,15,13
"['010', '11011', '011']",1,3,4,7,2,11,1.9166666666666665,6,8
"['011', '101', '0101010', '00', '111111', '101111']",1,6,9,18,4,27,7.326923076923077,52,38
"['0', '000101', '111', '0110001']",1,4,9,8,0,17,2.1955433455433457,25,11
"['1101001', '0010', '0110111', '101000', '010011', '001001']",1,6,19,17,5,36,9.818015318015318,43,41
"['11011', '00000', '0011', '101', '100100', '1110100', '110']",1,7,17,16,4,33,11.437340437340437,64,63
"['0100000', '111010', '11', '101', '00100']",1,5,13,10,0,23,5.048262848262848,36,20
"['0', '11110', '01']",1,3,3,5,0,8,1.2857142857142856,9,6
"['01', '00', '01110', '1101100']",1,4,8,8,2,16,3.198412698412698,20,17
"['00', '111110', '1', '011000']",1,4,7,8,2,15,1.8214285714285714,24,12
"['0011', '01', '011']",1,3,4,5,0,9,2.3238095238095235,4,9
"['0010', '0101', '0110']",1,3,7,5,3,12,2.25,5,10
"['11010', '000011', '011011', '100010', '010011']",1,5,15,14,4,29,6.03030303030303,24,33
"['1011010', '0100000', '0000100', '001101', '101000', '0101', '110']",1,7,25,15,5,40,12.036485736485737,67,64
"['11011', '11000', '1001', '10', '110']",1,5,8,11,2,19,6.614285714285714,21,32
"['0111000', '01', '001', '00111', '101']",1,5,10,10,2,20,5.999206349206349,30,26
"['0', '111', '1011110', '10001', '0110000']",1,5,11,12,2,23,4.071428571428571,42,17
"['0', '001111', '00100', '0110', '011111', '000111']",1,6,13,15,3,28,7.845021645021645,47,51
"['001101', '11110', '100', '010110']",1,4,9,11,2,20,3.717171717171717,17,15
"['001', '001111', '01011', '1001101']",1,4,9,12,0,21,3.92983682983683,17,16
"['111111', '1100001', '010', '110100']",1,4,9,13,2,22,3.0196581196581196,22,16
"['01', '00', '00101', '0011100']",1,4,10,6,2,16,3.198412698412698,20,24
"['0', '0110010', '0000011']",1,3,10,5,2,15,0.9285714285714286,15,8
"['0010', '0100011', '011001']",1,3,10,7,0,17,1.9146853146853147,9,7
"['0010', '01', '111', '10010', '000', '0001010']",1,6,15,9,2,24,8.158225108225109,42,44
"['1101001', '101111', '0']",1,3,5,9,0,14,1.151098901098901,14,5
"['010', '001001', '0100']",1,3,9,4,0,13,2.3238095238095235,6,11
"['101010', '010001', '001', '000']",1,4,12,6,4,18,3.7777777777777777,16,16
"['0111010', '001111', '011', '1', '000']",1,5,9,11,2,20,4.4493894993895,36,23
"['0001', '000', '01110']",1,3,8,4,0,12,1.8015873015873014,7,12
"['00', '1', '001101']",1,3,5,4,0,9,0.7857142857142857,11,6
"['110000', '1001', '10']",1,3,7,5,0,12,1.7666666666666666,9,7
"['0001101', '10001', '0101']",1,3,9,7,0,16,2.0606060606060606,8,10
"['0011', '01001', '100']",1,3,7,5,0,12,1.9880952380952381,7,7
"['0', '0101', '010']",1,3,5,3,0,8,1.7571428571428571,6,10
"['00000', '101010', '11', '100010', '001100', '101110']",1,6,18,13,4,31,8.196969696969697,44,40
['0100000'],1,1,6,1,0,7,0,0,0
"['1011101', '0000100', '11']",1,3,8,8,2,16,1.0952380952380951,15,4
"['1000', '0010111', '0110', '000']",1,4,11,7,2,18,3.4376623376623376,19,21
"['11110', '01', '001', '1000111', '00110', '0000010', '0101100']",1,7,20,16,5,36,11.285714285714285,74,57
"['01', '00011', '1101101', '0001111', '1010111', '10100', '10010', '111000', '1100', '01110']",1,10,24,29,7,53,26.247335997336,148,131
"['0', '00110', '011100']",1,3,7,5,0,12,1.3463203463203464,11,13
"['1', '00011', '1101000', '1010111', '011101', '01010', '101111']",1,7,15,22,6,37,11.068031968031967,75,54
"['0000', '01110', '011100', '11']",1,4,9,8,0,17,2.824963924963925,18,18
"['0', '01010', '101001', '1010011']",1,4,10,9,0,19,3.186063936063936,22,13
"['110110', '1010110', '1', '111010']",1,4,7,13,2,20,3.1932234432234434,21,19
"['01101', '1101', '00', '1110100']",1,4,8,10,0,18,3.6320346320346317,18,16
"['1110000', '1001', '1', '10']",1,4,7,7,0,14,2.973232323232323,21,15
"['11001', '00', '011000', '1111']",1,4,8,9,0,17,2.865367965367965,19,12
"['11011', '001010', '001011']",1,3,8,9,2,17,2.106060606060606,6,12
"['11110', '0111001', '101', '100100', '010010', '0101']",1,6,15,16,2,31,9.274081474081473,43,38
"['001', '100001', '11', '101', '10100']",1,5,10,9,2,19,6.066883116883117,24,35
"['0000100', '1011101', '1111', '10', '0111', '0011011']",1,6,13,18,5,31,7.775974025974026,56,38
"['00', '10010', '0111']",1,3,6,5,0,11,1.349206349206349,9,6
"['10111', '00', '0011', '101111']",1,4,6,11,0,17,3.378138528138528,17,20
"['110110', '1000', '100', '1']",1,4,7,7,0,14,3.3095238095238093,17,15
"['011', '1000', '10', '0010010', '0101']",1,5,12,8,2,20,5.875180375180375,28,24
"['01', '001111', '011', '1000', '01100']",1,5,10,10,0,20,5.519264069264069,29,28
"['111', '1100100', '0001111', '00110', '10', '000000']",1,6,17,13,2,30,6.805710955710955,59,47
"['0', '110', '1111000']",1,3,5,6,0,11,1.35,12,7
"['01', '001101', '11000', '0000001', '011110']",1,5,15,11,2,26,4.756965256965257,39,28
"['110010', '0011', '001010', '1100', '111001']",1,5,13,13,5,26,6.5,29,32
"['1110111', '110000', '111', '00', '0110010']",1,5,11,14,2,25,4.613308913308913,39,30
"['0', '101', '011', '0100']",1,4,6,5,2,11,3.2095238095238097,13,11
"['01', '11', '100', '10010', '0000']",1,5,10,6,2,16,4.764285714285714,24,22
"['0001', '1', '0100100']",1,3,8,4,0,12,1.3772727272727274,12,5
"['001', '1100101', '0111']",1,3,6,8,0,14,1.7168831168831167,10,8
"['1', '1011110', '10000', '1110101', '0100011']",1,5,12,15,3,27,4.464285714285714,44,24
"['110110', '001111', '000', '0110010', '001011']",1,5,14,14,3,28,5.8478632478632475,32,32
"['1100101', '1', '000', '000101']",1,4,10,7,0,17,2.5716117216117214,23,18
"['110000', '1010', '00', '0011111']",1,4,10,9,0,19,2.8824397824397825,25,18
"['0', '1001', '100101', '011110']",1,4,8,9,2,17,2.5047619047619047,23,12
"['01', '010', '11010', '111110']",1,4,6,10,0,16,3.3613275613275615,17,18
"['0010', '00011', '1011100', '010110', '0101']",1,5,14,12,2,26,6.388927738927739,27,29
"['1110111', '0011', '0110100', '10000']",1,4,11,12,2,23,2.94011544011544,22,15
"['0011', '111110', '100', '1111']",1,4,5,12,2,17,3.0015873015873016,18,22
"['0010110', '111', '001101', '0010011', '110011', '0111']",1,6,14,19,4,33,9.774425574425575,43,53
"['1011010', '001', '11', '000101', '1000', '1010', '000111']",1,7,17,15,4,32,12.035436785436785,63,62
"['0100111', '0000100', '10111', '100', '1010000']",1,5,17,12,3,29,5.680952380952381,36,33
"['10101', '11100', '110111', '110101']",1,4,7,15,4,22,4.342424242424243,11,30
"['10001', '1100', '11']",1,3,5,6,0,11,1.9047619047619047,7,10
"['01', '0010', '10']",1,3,5,3,2,8,1.8333333333333333,6,7
"['11100', '11110', '001111', '0110110']",1,4,8,15,2,23,4.008624708624708,16,22
"['1', '011100', '10101', '110', '0100']",1,5,9,10,0,19,5.269264069264069,28,19
"['010011', '1', '000', '101101']",1,4,8,8,2,16,2.126984126984127,23,10
"['100', '1', '0011010']",1,3,6,5,0,11,1.35,12,5
"['1', '011', '000011']",1,3,5,5,0,10,1.4523809523809523,10,8
"['1110011', '100100', '001', '111']",1,4,8,11,2,19,3.25982905982906,21,21
"['101010', '1001', '0']",1,3,6,5,0,11,1.4857142857142858,10,5
"['11110', '001', '011', '1001', '1010']",1,5,8,11,4,19,5.6269841269841265,22,25
"['0011001', '000101', '0', '010111']",1,4,11,9,2,20,3.0265567765567765,23,14
"['110010', '111', '000000']",1,3,9,6,2,15,1.1666666666666665,12,6
"['01', '1001', '00101']",1,3,6,5,0,11,1.9047619047619047,7,9
"['01', '01111', '0100']",1,3,5,6,0,11,1.6825396825396823,8,9
"['1000', '1101011', '1001111']",1,3,7,11,2,18,1.8051948051948052,10,12
"['0100111', '1011001', '011']",1,3,7,10,2,17,1.9142857142857141,12,8
"['1000001', '10101', '111110', '1100']",1,4,10,12,0,22,3.1501165501165502,20,17
"['10101', '10', '1101110']",1,3,5,9,0,14,1.6825396825396823,11,8
"['0', '1100', '011111']",1,3,4,7,0,11,1.0857142857142859,12,7
"['01', '100', '00011']",1,3,6,4,0,10,1.4714285714285715,8,7
"['101100', '101', '1111001', '1']",1,4,6,11,0,17,3.0716117216117214,22,21
"['0110111', '00101', '111', '10010', '000']",1,5,11,12,4,23,5.466666666666667,31,24
"['0011000', '00011', '101', '00', '11111', '1011', '111000', '101111']",1,8,16,22,4,38,14.218431568431567,94,101
"['1', '10110', '0110001']",1,3,6,7,0,13,1.25,14,6
"['10', '010110', '00001']",1,3,8,5,0,13,1.1493506493506493,11,7
"['11001', '101', '00001']",1,3,7,6,2,13,1.85,7,12
"['0', '0110111', '1001', '1101100', '111011', '0111110']",1,6,11,21,3,32,7.176573426573427,58,34
"['010100', '00100', '1']",1,3,8,4,0,12,1.528138528138528,10,8
"['0001', '10', '000']",1,3,7,2,0,9,1.5904761904761904,6,10
['0001111'],1,1,3,4,0,7,0,0,0
"['01', '0100110', '1101110', '011010', '1110']",1,5,11,15,2,26,5.8756687756687755,32,36
"['0', '000111', '01100']",1,3,7,5,0,12,1.1645021645021645,13,9
"['11', '101101', '1110101', '1000', '000', '110']",1,6,11,14,2,25,7.865478965478966,46,42
"['110000', '101100', '01101', '0101']",1,4,11,10,2,21,3.8282828282828283,17,16
"['00010', '110', '011', '1001101']",1,4,9,9,2,18,3.533333333333333,19,12
"['00', '111110', '1']",1,3,3,6,0,9,0.5357142857142857,12,4
"['100', '111000', '111', '0100100']",1,4,10,9,2,19,3.282051282051282,20,18
"['1010110', '10110', '000011']",1,3,9,9,0,18,1.9941724941724943,9,12
"['0111001', '0110111', '0110100', '11', '0101010', '1000', '1010', '0100011', '1100', '1011111']",1,10,25,31,9,56,26.66125541125541,151,128
"['110110', '11011', '00101', '011100', '1011100', '000', '0100']",1,7,18,18,4,36,12.587978687978687,61,68
"['010', '001', '0101111', '00100', '011101', '0111']",1,6,13,15,2,28,9.207037407037406,41,47
"['1001101', '1110100', '0101100', '111001']",1,4,12,15,3,27,4.2967032967032965,18,16
"['1', '111000', '110', '01011', '101001']",1,5,9,12,2,21,4.773448773448774,33,25
"['11', '001000', '100010', '0111111', '110111', '1100']",1,6,13,18,3,31,7.255516705516706,57,45
"['01', '011', '00111', '1111001', '010010', '1000', '01010']",1,7,16,16,2,32,12.199511599511599,65,55
"['00', '000100', '01011']",1,3,9,4,0,13,1.6168831168831168,10,12
"['00101', '0011000', '0001111', '0000111', '01011']",1,5,17,14,5,31,6.8,31,37
"['0000101', '0101', '00010', '11101']",1,4,12,9,2,21,3.793939393939394,17,19
"['01', '1000', '000100']",1,3,9,3,0,12,1.4333333333333333,10,9
"['1011110', '000111', '11101']",1,3,6,12,0,18,1.8275058275058274,10,8
"['0011001', '1110110', '110']",1,3,7,10,2,17,1.7714285714285714,12,9
"['110110', '011', '00001', '1111110', '0111', '0000', '010011', '111101', '0100']",1,9,20,25,6,45,17.937090687090688,113,111
"['011011', '01', '10']",1,3,4,6,2,10,1.5,10,7
"['10001', '00', '010']",1,3,7,3,0,10,1.8714285714285714,7,4
"['0000', '11', '1101110']",1,3,6,7,0,13,0.8080808080808081,14,6
"['1010', '1', '0110100', '100010']",1,4,10,8,0,18,3.0783716283716283,23,13
"['00', '010', '1', '1110']",1,4,5,5,0,10,2.604761904761905,13,11
"['00', '010111', '10', '1110']",1,4,6,8,2,14,3.1,17,15
"['000001', '10011', '11']",1,3,7,6,0,13,1.3668831168831168,11,10
"['000011', '11', '0011001', '0001', '000', '01000', '110101']",1,7,20,13,2,33,11.436058386058386,66,70
"['0111000', '1', '101101']",1,3,6,8,0,14,1.151098901098901,15,4
"['01', '00', '1000101', '0111100']",1,4,10,8,4,18,2.706349206349206,26,14
"['0', '110000', '100001']",1,3,9,4,2,13,1.4047619047619047,12,4
"['01', '00', '101001', '1110']",1,4,7,7,2,14,2.5666666666666664,18,11
"['0010', '1000', '0100']",1,3,9,3,3,12,2.25,6,11
"['110010', '011', '1111001']",1,3,6,10,0,16,1.6136752136752137,12,9
"['10111', '0101011', '10110', '1000010', '00010']",1,5,15,14,5,29,5.8619047619047615,27,30
"['0101', '011', '0011100']",1,3,7,7,0,14,2.0025974025974023,9,7
"['0', '0101011', '1010011', '11100', '01011']",1,5,11,14,4,25,5.09047619047619,37,32
"['11110', '001', '011', '10111', '000101']",1,5,9,13,4,22,5.509090909090909,28,26
"['0010', '010', '011']",1,3,6,4,2,10,2.095238095238095,4,11
"['0', '0000101', '0010', '111']",1,4,9,6,0,15,2.062987012987013,23,11
"['0', '00100', '110100', '110111', '1110']",1,5,10,12,2,22,4.706782106782106,33,30
"['001', '10', '1001010']",1,3,7,5,0,12,1.4444444444444444,11,8
"['0100000', '01', '00111', '10100', '00110', '1010']",1,6,17,11,3,28,8.47085137085137,44,45
"['01', '1111101', '000011']",1,3,6,9,0,15,1.2521367521367521,14,8
"['01', '100100', '0111', '01011', '1110']",1,5,9,12,2,21,5.277994227994228,29,27
"['11010', '001111', '0010100', '0001000']",1,4,15,10,2,25,3.6461871461871462,20,24
"['00', '010111', '111']",1,3,4,7,0,11,1.1666666666666665,10,8
"['101010', '1100010', '01110']",1,3,9,9,0,18,1.4790209790209792,8,10
"['001', '11', '101011', '010011', '0110001']",1,5,11,13,2,24,5.619658119658119,33,31
"['11011', '1', '01100', '0100']",1,4,7,8,2,15,3.0,18,11
"['000110', '01', '011100', '0101010', '011001', '000100', '0111110']",1,7,22,18,6,40,12.870573870573871,64,89
"['011101', '001100', '111']",1,3,6,9,2,15,1.7777777777777777,9,4
['0100110'],1,1,4,3,0,7,0,0,0
"['0101101', '101', '01001', '1100']",1,4,9,10,0,19,3.9668831168831167,16,18
"['01', '1011101', '100', '1100001', '1101', '1011011']",1,6,12,18,3,30,8.953246753246752,52,59
"['000111', '10010', '0000']",1,3,10,5,0,15,1.812121212121212,8,10
"['11010', '010', '001110', '10011']",1,4,9,10,2,19,3.5893939393939394,16,15
"['1111110', '1111', '10100', '0111', '011000']",1,5,9,17,2,26,5.433760683760684,32,33
['0001101'],1,1,4,3,0,7,0,0,0
['101001'],1,1,3,3,0,6,0,0,0
"['0100000', '1101111', '011011', '1100010', '110111', '0111', '01001', '110']",1,8,19,26,5,45,17.11092241092241,90,103
"['0110001', '1110010', '0000110', '1']",1,4,12,10,3,22,2.4642857142857144,29,11
"['01', '111111', '10', '110111']",1,4,3,13,4,16,2.5,21,20
"['101', '1010', '110', '111011']",1,4,5,11,2,16,4.0285714285714285,13,19
"['00011', '1101010', '0010101', '0001011', '001001', '0100']",1,6,21,15,3,36,10.422266622266623,40,49
['101101'],1,1,2,4,0,6,0,0,0
"['11001', '0001100', '001010', '1']",1,4,11,8,0,19,2.8503996003996,26,10
"['0', '01', '00111']",1,3,4,4,0,8,1.5714285714285714,8,6
"['11010', '1', '0101101', '1000', '10010', '11100']",1,6,13,14,3,27,8.4510101010101,45,36
"['0001', '00', '10', '0101', '1100']",1,5,10,6,5,16,5.666666666666666,20,26
['000100'],1,1,5,1,0,6,0,0,0
"['011010', '110', '00101']",1,3,7,7,0,14,1.893939393939394,8,7
"['11', '0110', '1000', '01001', '1101']",1,5,9,10,3,19,5.765873015873016,23,22
"['00', '011', '11010']",1,3,5,5,0,10,1.4714285714285715,8,7
"['0', '101100', '10']",1,3,5,4,0,9,1.4523809523809523,10,7
"['1010110', '00', '001011', '1111']",1,4,8,11,0,19,2.4773115773115775,21,14
"['0', '1010001', '0111011']",1,3,7,8,2,15,1.0714285714285714,16,4
"['010100', '11', '0001', '1010111', '11100']",1,5,11,13,0,24,4.8999444999445,35,28
"['1000100', '11011', '001', '0001', '0000001', '101001']",1,6,20,12,2,32,9.43944943944944,46,53
"['01', '010', '100', '01111', '111011']",1,5,7,12,2,19,5.122438672438673,29,24
"['111000', '100', '1111']",1,3,5,8,0,13,1.5523809523809522,9,11
"['0111011', '00011', '0010011', '011111', '110']",1,5,11,17,2,28,5.6364191364191365,31,38
"['101', '100100', '1101100', '0001111', '00']",1,5,13,12,2,25,4.807203907203907,38,30
"['0100010', '1', '0000']",1,3,9,3,0,12,0.9772727272727273,13,4
"['00110', '00', '0111011']",1,3,7,7,0,14,1.6825396825396823,11,10
"['011', '001110', '000', '11100', '0100']",1,5,12,9,2,21,5.603463203463203,25,38
"['100000', '100', '1', '111010']",1,4,9,7,2,16,2.9047619047619047,21,15
"['0101000', '00000', '1011110', '0011010', '1111110']",1,5,17,16,4,33,5.095238095238095,33,39
"['0100010', '1001', '011']",1,3,8,6,0,14,1.8987012987012988,9,5
"['0', '0001001', '11110', '0111', '110']",1,5,9,11,0,20,4.75021645021645,35,26
"['1000111', '0101', '01100']",1,3,8,8,0,16,1.712121212121212,11,5
"['101', '0110', '110011', '110111', '000', '01011']",1,6,11,16,4,27,8.88073593073593,41,37
"['01', '1010010', '001010']",1,3,9,6,0,15,1.5598290598290598,11,8
"['1100', '1', '01000']",1,3,6,4,0,10,1.4,9,5
"['110101', '1010100', '0000']",1,3,10,7,0,17,1.5328671328671328,9,6
"['01', '11101', '000']",1,3,5,5,0,10,1.2214285714285715,9,5
"['01', '000001', '10', '1010011', '1100']",1,5,12,9,2,21,4.881546231546231,36,24
"['1000011', '1011', '10', '111']",1,4,6,10,0,16,3.2098124098124097,17,27
"['1011010', '11010', '011', '1000110', '0001', '0101']",1,6,15,15,4,30,8.96911976911977,42,40
"['000011', '0111', '000', '000010', '00010']",1,5,17,7,2,24,6.283189033189033,25,51
"['100', '100011', '10', '1']",1,4,6,6,0,12,3.419047619047619,16,18
"['0', '100', '1110']",1,3,4,4,0,8,1.4714285714285715,7,6
"['0111000', '10', '11']",1,3,5,6,2,11,1.3888888888888888,11,4
"['1011', '010', '10010', '111101']",1,4,7,11,0,18,3.577994227994228,16,14
"['1101', '11100', '011']",1,3,4,8,0,12,1.7380952380952381,7,9
"['110110', '11110', '001000', '10101', '0000010', '0101001', '01110']",1,7,22,19,7,41,11.561371961371961,63,58
['1100010'],1,1,4,3,0,7,0,0,0
"['11', '011011', '11101', '10010', '111001']",1,5,8,16,4,24,6.318614718614718,28,38
"['00111', '1011101', '1', '010100']",1,4,8,11,0,19,2.5147352647352648,24,11
"['1111101', '01000', '0110011']",1,3,8,11,2,19,1.5714285714285714,12,6
"['0000101', '1010', '1011', '011010', '11100']",1,5,13,13,2,26,6.028010878010878,29,25
"['1110111', '01', '00100', '010110', '000']",1,5,12,11,0,23,5.208530358530359,35,25
"['11001', '1', '01000']",1,3,6,5,2,11,1.2666666666666666,10,4
"['0010111', '100010', '0011111', '0000', '1000011']",1,5,17,14,3,31,6.13966033966034,33,31
"['101', '110001', '1011', '1110110', '0101', '11100', '01100']",1,7,14,20,4,34,13.595831945831947,55,60
"['00', '11010', '01110', '0100']",1,4,9,7,2,16,3.742857142857143,14,22
"['0', '001101', '01111', '10', '1110110', '11100']",1,6,10,16,2,26,7.492080142080142,53,39
"['0011', '1110110', '000']",1,3,7,7,0,14,1.516883116883117,11,9
"['1011011', '10', '001011', '01000']",1,4,10,10,0,20,3.1767121767121766,21,15
"['1101001', '101011', '010010', '0111', '0101', '01110', '011000']",1,7,18,20,5,38,14.204156954156954,54,58
"['0111000', '1011010', '0001', '1']",1,4,10,9,2,19,2.5233766233766235,26,12
"['1100010', '0011', '1']",1,3,6,6,0,12,1.1954545454545453,13,7
"['01', '000111', '011', '11']",1,4,5,8,2,13,3.7666666666666666,14,18
"['000101', '000', '000010']",1,3,12,3,2,15,2.1666666666666665,8,18
"['0001', '1', '10']",1,3,4,3,0,7,1.4,7,6
"['011011', '0001', '110111']",1,3,6,10,2,16,1.6333333333333333,9,8
"['101', '000100', '110', '11']",1,4,7,7,2,14,3.4055555555555554,17,12
"['010100', '0001001', '1', '101011', '10010', '000', '0110110']",1,7,20,15,4,35,11.010883560883562,74,48
"['110011', '1010100', '0']",1,3,7,7,0,14,1.151098901098901,15,4
"['0011001', '001', '111', '0000']",1,4,10,7,2,17,2.832034632034632,19,18
"['0100010', '011011', '1001', '111111', '0001010']",1,5,14,16,4,30,5.2998334998335,34,21
"['1001100', '111111', '0101', '1110']",1,4,7,14,2,21,3.0804195804195804,21,16
"['1110010', '010001', '101000', '1011', '01011']",1,5,14,14,2,28,6.443201243201243,27,29
"['0110101', '0001001', '01', '0011100']",1,4,13,10,3,23,3.4761904761904763,24,18
"['01', '00001', '00111', '1100010', '0001', '01111', '10', '101111']",1,8,17,19,5,36,15.015795315795316,88,79
"['11110', '00110', '1101', '11111']",1,4,5,14,3,19,3.8,13,21
"['0110', '00101', '1110']",1,3,6,7,2,13,1.8611111111111112,6,8
"['011111', '111', '011100']",1,3,4,11,2,15,2.0,8,11
"['110011', '0110011', '1101110']",1,3,7,13,2,20,2.2637362637362637,6,16
"['000110', '011', '00100', '0111', '11111']",1,5,10,13,2,23,5.525829725829726,28,29
"['0', '010', '10110']",1,3,5,4,0,9,1.5833333333333333,8,9
"['1001111', '11010', '011011', '1010', '001010', '01011', '01000']",1,7,18,20,5,38,14.04926184926185,52,63
"['100110', '010', '10', '010110']",1,4,9,8,2,17,3.7444444444444445,17,25
"['00', '010', '1']",1,3,4,2,0,6,1.3,5,4
"['0111010', '1101111', '10', '00011']",1,4,8,13,2,21,2.888888888888889,26,13
"['101100', '01011', '0010101']",1,3,9,9,0,18,2.175990675990676,8,7
"['0111000', '00101', '11', '1000110', '1111000', '001010', '1011']",1,7,19,19,3,38,12.396370296370296,76,58
"['1011', '0101000', '1', '01011']",1,4,8,9,0,17,3.084343434343434,21,16
"['0010', '1100010', '1111110', '10', '0000111', '1101', '1110', '1101010']",1,8,18,24,7,42,15.357503607503608,98,98
"['0110010', '1', '1110']",1,3,5,7,0,12,1.1954545454545453,12,5
"['0010', '01100', '0010011']",1,3,10,6,0,16,1.6717171717171717,8,13
"['0', '100000', '111', '1011100']",1,4,9,8,0,17,1.8194749694749695,26,12
"['1000110', '1101', '0101011', '111']",1,4,8,13,2,21,3.4623376623376623,19,19
"['001', '11', '101', '100101', '011001']",1,5,9,11,4,20,6.2,27,35
['1110110'],1,1,2,5,0,7,0,0,0
"['11011', '001101', '0011001', '111110', '001010', '10', '000000', '1110']",1,8,21,21,4,42,15.08055833055833,92,83
"['10111', '00', '011']",1,3,4,6,0,10,1.4357142857142857,8,5
"['11110', '00', '10000']",1,3,7,5,2,12,1.2571428571428571,10,8
"['101100', '01', '0011', '10100', '001100']",1,5,13,10,2,23,6.552236652236652,25,38
"['0001101', '101', '11']",1,3,5,7,0,12,1.8444444444444446,10,10
"['0010', '00', '011']",1,3,6,3,0,9,1.638095238095238,6,10
"['10110', '10', '0111', '111']",1,4,4,10,0,14,3.3285714285714283,13,18
"['110000', '111', '1111001', '11101', '100101', '110']",1,6,11,19,4,30,9.592385392385392,42,66
"['00100', '11010', '000']",1,3,9,4,2,13,1.85,8,12
"['0010', '10', '01110']",1,3,6,5,0,11,1.9047619047619047,7,11
"['011101', '0110111', '1']",1,3,4,10,0,14,1.151098901098901,13,8
"['0011011', '0000011', '101000', '111']",1,4,12,11,2,23,2.938949938949939,23,22
"['0100000', '0111001', '011', '00001', '1111', '110', '1110']",1,7,16,17,6,33,11.087301587301587,69,62
"['010', '1', '10110']",1,3,4,5,0,9,1.5833333333333333,8,5
"['1001100', '1000', '001011', '11001']",1,4,12,10,0,22,3.6214452214452213,20,18
"['1100', '0000011', '0011000']",1,3,12,6,2,18,1.6623376623376624,12,13
"['11010', '110', '010111']",1,3,5,9,0,14,1.7398989898989898,9,11
"['0001100', '00', '10']",1,3,8,3,2,11,1.3888888888888888,11,12
"['01', '010001', '111']",1,3,5,6,0,11,1.3444444444444446,10,8
"['0001001', '1', '000', '01110', '01100']",1,5,13,8,2,21,4.483333333333333,34,29
"['0', '1001011', '000010']",1,3,9,5,0,14,1.151098901098901,14,4
"['00100', '1000110', '11101']",1,3,9,8,2,17,1.7333333333333334,10,4
"['00111', '10111', '0010', '001011']",1,4,9,11,2,20,4.347474747474747,11,22
"['10011', '0000', '01001', '1100', '0100']",1,5,14,8,5,22,6.3277777777777775,20,28
"['101', '0001', '00011']",1,3,7,5,0,12,1.9603174603174602,6,10
"['101100', '1', '10101', '10000', '1000']",1,5,12,9,2,21,5.380663780663781,27,35
"['0', '11011', '1100']",1,3,4,6,0,10,1.4,9,7
"['001111', '11', '00111', '101111', '1101010']",1,5,8,18,2,26,6.062493062493062,31,45
"['110010', '10101', '0110', '1100100', '0011111', '0111', '0110011']",1,7,17,23,5,40,13.308030858030858,69,64
"['01', '0110100', '100', '10000', '0000', '1100']",1,6,17,8,2,25,8.221861471861471,40,56
"['1001100', '00110', '1000110', '0100010']",1,4,16,10,3,26,4.761904761904762,14,23
"['1110000', '011', '00000', '11']",1,4,10,7,0,17,2.561111111111111,23,21
"['11110', '101101', '00110', '1011', '1100']",1,5,9,15,4,24,6.398989898989899,23,27
"['011', '101', '1111', '000111', '0000', '001001']",1,6,13,13,6,26,7.892063492063492,44,43
"['11010', '000100', '11']",1,3,7,6,0,13,1.3668831168831168,11,6
"['01', '001', '0000000']",1,3,10,2,0,12,1.4222222222222223,12,9
"['01', '0101111', '110', '1111', '00', '1101', '1100']",1,7,9,17,5,26,10.844300144300144,57,65
"['00110', '010101', '110111', '000']",1,4,10,10,2,20,3.5782828282828283,18,12
"['000111', '1110', '1111']",1,3,4,10,2,14,1.95,8,16
"['0010', '10001', '1', '0100']",1,4,9,5,2,14,3.216666666666667,18,9
"['1000', '00010', '10010', '11']",1,4,10,6,2,16,3.546031746031746,14,17
"['0101', '1', '010010']",1,3,6,5,0,11,1.4857142857142858,10,6
"['01', '011', '1111']",1,3,2,7,0,9,1.7047619047619047,6,9
"['1', '0000', '01010', '1100110', '010011']",1,5,13,10,0,23,4.6443389943389946,35,22
"['010', '11', '00000', '1100', '1110']",1,5,10,8,2,18,4.792857142857143,26,26
"['1000', '10110', '11']",1,3,5,6,0,11,1.5714285714285714,8,7
"['0', '101', '110010']",1,3,5,5,0,10,1.4523809523809523,10,4
"['0', '010', '1110', '1101110']",1,4,6,9,0,15,3.0487012987012987,20,20
"['1110101', '110111', '010010', '111']",1,4,7,15,2,22,3.595726495726496,19,25
"['100010', '1010010', '1111']",1,3,8,9,0,17,1.8685314685314687,9,10
"['0', '0010', '011110']",1,3,6,5,0,11,1.2857142857142856,11,13
"['1001110', '0101010', '11101', '1']",1,4,8,12,2,20,2.7142857142857144,26,11
"['0101110', '0011110', '1']",1,3,6,9,2,15,1.3571428571428572,14,7
"['11011', '1111101', '0011001', '0111', '01100']",1,5,10,18,4,28,6.444155844155844,29,28
"['0001', '1010101', '110011', '10011', '0111110']",1,5,12,17,2,29,5.752847152847153,31,27
"['11001', '10001', '111']",1,3,5,8,2,13,2.05,6,16
"['11110', '100', '11100']",1,3,5,8,2,13,2.05,6,10
"['0', '01101', '1111']",1,3,3,7,0,10,1.0,10,4
"['0001110', '00', '10', '0101', '01100']",1,5,12,8,2,20,5.743867243867244,30,33
"['1011110', '101', '11110']",1,3,4,11,0,15,1.9333333333333333,9,12
"['0', '0011', '101', '1111001', '1101100', '10011']",1,6,11,16,2,27,8.425036075036076,52,41
"['00111', '01', '110', '01011']",1,4,6,9,2,15,3.342857142857143,16,16
"['0010010', '10', '011', '01100']",1,4,10,7,0,17,3.4325396825396823,19,18
"['1000100', '010000', '01101', '11', '10110', '000', '0101001', '11100', '01100']",1,9,26,19,6,45,21.153807303807305,104,105
"['01', '1100101', '10']",1,3,5,6,2,11,1.3888888888888888,12,7
"['0101', '111', '0011', '00', '1110100', '1011000', '000100']",1,7,18,15,4,33,11.125213675213676,71,69
"['1001000', '0101111', '111100', '00011']",1,4,12,13,2,25,3.0357975357975358,24,21
"['1000001', '1', '000011']",1,3,9,5,0,14,1.304945054945055,13,8
"['101', '01001', '1001000']",1,3,9,6,0,15,2.0166666666666666,9,8
"['11', '1001', '01111', '0011010', '0110000', '1101', '0100101']",1,7,17,19,5,36,12.671356421356421,68,52
"['1100', '000001', '00000']",1,3,12,3,0,15,1.7535353535353535,8,17
"['0010', '010000', '110010', '101', '0001011']",1,5,16,10,2,26,5.986735486735487,31,26
"['0', '1000100', '0011000']",1,3,11,4,2,15,1.0714285714285714,15,10
"['0111000', '011101', '11111']",1,3,6,12,0,18,1.9965034965034967,8,8
"['11', '110111', '1101100']",1,3,4,11,0,15,1.7136752136752138,11,19
"['110000', '010', '1101011', '01100']",1,4,11,10,0,21,3.8037684537684537,20,15
"['0010', '1', '00000', '11000', '10101']",1,5,13,7,3,20,4.666666666666666,31,23
"['00', '1', '011100']",1,3,5,4,0,9,0.7857142857142857,11,6
"['0', '101011', '101', '1111']",1,4,4,10,0,14,2.4238095238095236,18,16
"['11001', '00001', '101', '010010', '0001111', '10', '0000']",1,7,19,13,2,32,11.630463980463981,65,57
"['010001', '111', '101', '100', '1101011', '0100011']",1,6,13,16,5,29,8.874969474969475,44,52
"['100', '0101011', '1010', '10011', '011000']",1,5,13,12,0,25,6.708075258075258,27,26
"['11110', '11', '10110', '1010', '0010010']",1,5,10,13,2,23,5.932756132756133,27,30
"['1100111', '110', '100001', '0100']",1,4,10,10,0,20,3.376712176712177,20,13
"['0011', '1000110', '0110000', '000', '1101', '11100']",1,6,17,13,4,30,8.412842712842712,52,42
"['0011', '0001', '1000000', '00', '010101', '1011000']",1,6,20,10,4,30,8.120573870573871,50,49
"['01', '10010', '1001010']",1,3,8,6,0,14,1.8492063492063493,10,12
"['01', '00', '111', '1110']",1,4,4,7,2,11,2.4238095238095236,13,14
"['1010111', '1011100', '101101']",1,3,7,13,2,20,2.2527472527472527,7,15
"['001101', '011', '010111', '10', '1011', '1100']",1,6,10,15,4,25,9.228571428571428,41,40
"['010', '0101000', '11']",1,3,7,5,0,12,1.4444444444444444,11,6
"['100001', '010010', '11']",1,3,8,6,2,14,1.6666666666666665,11,4
"['01', '1000', '1100', '0100']",1,4,9,5,3,14,3.583333333333333,12,17
"['100000', '10100', '0001', '110010']",1,4,14,7,2,21,3.583838383838384,16,17
"['1001010', '11', '101010', '00001', '000']",1,5,14,9,0,23,5.0335386835386835,32,27
"['101', '000101', '101110']",1,3,7,8,2,15,1.8333333333333333,10,10
"['110', '1', '0011111']",1,3,3,8,0,11,1.15,13,7
"['11110', '1100', '10', '011001']",1,4,7,10,0,17,3.75021645021645,16,14
"['110000', '01', '0101110', '001000', '1101011', '000100']",1,6,20,14,5,34,8.083943833943835,55,45
"['0', '010001', '010101', '100111', '01110', '01100']",1,6,15,14,5,29,8.49047619047619,47,39
"['0100000', '101101', '1001', '0000000', '0110000', '1100']",1,6,24,11,5,35,8.768381618381618,49,50
"['1000100', '1100', '001111']",1,3,9,8,0,17,1.406993006993007,11,11
"['1', '10', '00101']",1,3,4,4,0,8,1.5714285714285714,8,6
"['001100', '010', '11100']",1,3,8,6,0,14,1.893939393939394,8,12
"['0', '1001', '11']",1,3,3,4,0,7,1.0666666666666667,7,4
"['1000100', '01', '1101100']",1,3,9,7,2,16,1.3174603174603174,12,8
"['11010', '0001110', '001011', '11111']",1,4,9,14,2,23,3.2783216783216784,19,17
"['0', '00111', '101', '1101000', '1001', '011111']",1,6,11,15,0,26,7.3049006549006545,55,35
"['0010', '1001', '1011111']",1,3,6,9,2,15,1.6590909090909092,11,5
"['00', '0010', '00101']",1,3,8,3,0,11,2.126984126984127,6,15
"['11', '011', '000', '1101010']",1,4,7,8,2,15,2.7777777777777777,19,15
"['0', '1010', '1001']",1,3,5,4,2,9,1.55,8,5
"['0110000', '101', '001', '1011010']",1,4,11,9,4,20,3.180952380952381,22,14
"['01', '1101000', '100', '1111', '10']",1,5,8,10,2,18,4.686724386724387,32,24
"['1000101', '1', '1101011']",1,3,6,9,2,15,1.2142857142857144,15,12
"['0010', '0110', '0001111']",1,3,8,7,2,15,1.8409090909090908,9,10
"['10100', '11101', '000', '11']",1,4,7,8,2,15,2.492857142857143,17,14
"['101', '01101', '10010', '010010']",1,4,10,9,2,19,4.403030303030303,13,18
"['10100', '1101', '0011010']",1,3,8,8,0,16,2.0606060606060606,8,5
"['110110', '00100', '1', '110100']",1,4,9,9,2,18,3.0108225108225106,20,17
"['010', '101', '1100001', '110100', '1111010', '1010001']",1,6,16,17,5,33,9.707692307692307,50,43
"['0', '010010', '11']",1,3,5,4,0,9,0.7857142857142857,11,4
"['101', '100101', '11']",1,3,4,7,0,11,1.9666666666666668,8,15
"['0110000', '0111001', '1110010', '110']",1,4,12,12,3,24,4.085714285714285,18,16
"['1101000', '1', '10']",1,3,5,5,0,10,1.3611111111111112,12,6
"['010011', '01010', '0111011', '000']",1,4,11,10,0,21,3.4499222999223,17,20
"['01', '011100', '11', '00001', '110']",1,5,9,9,2,18,4.837445887445887,30,23
"['1', '1001010', '0110011']",1,3,7,8,2,15,1.2142857142857144,16,6
"['01001', '1', '0011010', '000']",1,4,10,6,0,16,2.183333333333333,22,12
"['001000', '11000', '101', '100', '1010', '110']",1,6,14,10,3,24,9.835209235209234,32,42
"['10010', '011', '10011']",1,3,6,7,2,13,2.05,6,11
"['1000', '001', '100']",1,3,7,3,2,10,2.095238095238095,5,11
"['100001', '000', '0110001']",1,3,11,5,0,16,2.0358974358974358,9,7
"['1011110', '00100', '01', '0001001']",1,4,12,9,2,21,3.2222222222222223,24,15
"['11011', '011', '0001', '100010', '00110', '010111', '10010', '1100111', '001001']",1,9,23,24,6,47,23.254256854256855,96,101
"['110110', '1', '100', '1010101', '1000']",1,5,10,11,0,21,5.656027306027306,33,27
"['010100', '01', '01101', '0000', '1000011']",1,5,15,9,0,24,5.10973470973471,33,24
"['01', '1101111', '00101', '000011', '1101100']",1,5,12,15,2,27,5.324952824952825,38,32
"['101', '11101', '000']",1,3,5,6,2,11,1.3333333333333333,8,6
"['1', '010010', '00001']",1,3,8,4,0,12,1.3463203463203464,11,4
"['0010111', '1', '0001', '1101101', '0000000', '1011', '010011']",1,7,19,17,5,36,9.743656343656344,80,57
"['0010', '011', '111111']",1,3,4,9,0,13,1.2158730158730158,11,6
"['0', '11000', '0100011', '011111', '0101']",1,5,11,12,0,23,4.532606282606283,37,27
"['101011', '0001', '1001', '000010', '0000', '1101', '110']",1,7,18,13,6,31,11.688888888888888,51,60
"['110000', '011', '111', '10001', '100', '1011000', '0100']",1,7,17,14,3,31,12.11028416028416,60,58
"['00110', '011010', '0000']",1,3,10,5,0,15,1.993939393939394,7,15
"['01111', '000', '1101110']",1,3,6,9,0,15,1.3166666666666667,12,7
"['0111000', '01', '011', '00000', '1111110', '1100100', '1101']",1,7,17,18,3,35,10.172943722943723,79,59
['101010'],1,1,3,3,0,6,0,0,0
"['0', '0101111', '111', '0101010', '11101', '0001011']",1,6,12,18,3,30,7.076190476190476,55,43
"['01', '1001', '0111100', '11111']",1,4,6,12,0,18,3.0533910533910533,22,12
"['101010', '100', '011110', '1111']",1,4,7,12,2,19,3.13015873015873,18,12
"['111', '101101', '00011', '110001', '010101']",1,5,11,15,3,26,6.484848484848484,27,35
"['1100010', '1', '10']",1,3,5,5,0,10,1.3611111111111112,12,7
"['1101', '00010', '10000']",1,3,9,5,2,14,1.6888888888888889,8,6
"['010', '100', '1']",1,3,4,3,2,7,1.6666666666666665,6,4
"['1110', '000', '11']",1,3,4,5,0,9,0.9523809523809523,8,6
"['11110', '010', '001', '0010000', '100', '1101100', '0111']",1,7,17,15,5,32,11.059090909090909,70,61
"['011111', '00', '01111', '110111']",1,4,5,14,2,19,3.088744588744589,19,23
"['11110', '00', '011']",1,3,4,6,0,10,1.1857142857142857,9,7
"['00100', '001001', '011', '0100']",1,4,12,6,0,18,4.3360750360750355,12,25
"['101', '1000', '00', '010111', '100011']",1,5,11,10,2,21,5.838095238095238,29,26
"['0011', '011', '101110']",1,3,5,8,0,13,2.123809523809524,7,8
"['0110', '111', '0000']",1,3,6,5,2,11,1.0714285714285714,8,4
"['1010111', '010011', '0']",1,3,6,8,0,14,1.304945054945055,13,5
"['00', '100100', '00001']",1,3,10,3,0,13,1.6168831168831168,10,11
"['001100', '001111', '00011']",1,3,9,8,2,17,2.121212121212121,7,14
"['0', '0001', '1111']",1,3,4,5,2,9,0.65,10,4
"['0', '101010', '000101', '01011']",1,4,10,8,2,18,3.0259740259740258,21,12
"['000110', '01', '101', '001010', '1110']",1,5,11,10,2,21,5.64920634920635,29,24
"['001', '0000011', '01100', '11']",1,4,10,7,0,17,3.015873015873016,21,15
"['010', '111', '1011110', '1110101', '011010']",1,5,9,17,4,26,6.022710622710623,31,25
"['1100', '11100', '100111', '000011']",1,4,10,11,2,21,3.4646464646464645,20,24
['0001001'],1,1,5,2,0,7,0,0,0
"['01', '10011', '10', '0111']",1,4,5,8,2,13,3.3095238095238093,15,15
"['100', '000101', '0000']",1,3,10,3,0,13,1.8158730158730159,8,13
"['1011010', '0000000', '11111']",1,3,10,9,2,19,0.9285714285714286,14,4
"['10110', '010010', '0111']",1,3,7,8,0,15,1.993939393939394,7,8
"['1011', '001111', '101001']",1,3,6,10,2,16,1.9,8,11
"['001110', '1110', '00011']",1,3,7,8,0,15,1.9717171717171718,8,11
"['010001', '011', '1101010']",1,3,8,8,0,16,1.882051282051282,10,8
"['011011', '0000110', '101001']",1,3,10,9,2,19,1.8974358974358974,10,4
"['1111010', '01011', '000000']",1,3,10,8,0,18,1.1713286713286712,13,7
"['1001110', '0100010', '1110', '11']",1,4,9,11,2,20,3.3607503607503606,22,17
"['01', '1001010', '100', '1000', '111101']",1,5,11,11,0,22,5.322022422022422,33,28
"['11000', '0000100', '011100']",1,3,12,6,0,18,1.8426573426573427,9,15
"['1101111', '10', '11']",1,3,2,9,2,11,1.3888888888888888,11,12
"['00100', '110', '10']",1,3,6,4,0,10,1.8714285714285714,7,7
"['010100', '11010', '0010011', '1000', '1101']",1,5,14,12,2,26,6.161149961149961,27,26
"['0001101', '1100010', '01', '00']",1,4,11,7,4,18,2.992063492063492,25,15
['001111'],1,1,2,4,0,6,0,0,0
"['01001', '011', '1111']",1,3,4,8,0,12,1.7658730158730158,7,9
"['10101', '1100001', '10110', '11']",1,4,8,11,2,19,3.5539682539682538,20,23
"['0', '00110', '10010', '0111']",1,4,8,7,2,15,2.977777777777778,18,15
"['0110111', '0101', '111000', '111101']",1,4,8,15,2,23,3.470862470862471,19,21
"['1010', '0101011', '000']",1,3,8,6,0,14,1.8987012987012988,9,6
"['0110101', '011', '0010000', '0010011', '110111', '1100110', '110101']",1,7,20,23,6,43,13.168864468864468,67,71
"['00000', '1001000', '1001101', '00001']",1,4,17,7,4,24,3.5142857142857142,15,26
"['00', '001000', '11']",1,3,7,3,2,10,0.75,11,8
"['0001101', '01', '0111100']",1,3,8,8,2,16,1.4603174603174602,13,9
"['0111001', '010111', '10', '1110']",1,4,7,12,0,19,3.5537684537684537,20,16
"['1111010', '1000101', '10', '00000']",1,4,12,9,2,21,2.746031746031746,26,12
"['00111', '0000011', '00011']",1,3,10,7,2,17,2.3,6,16
"['1011010', '1010100', '11100', '0111']",1,4,10,13,2,23,4.177489177489178,16,18
"['0000', '0100000', '00001']",1,3,14,2,0,16,2.282828282828283,7,23
"['101', '00', '101100']",1,3,6,5,0,11,1.5666666666666667,9,8
"['101', '1010', '1']",1,3,3,5,0,8,1.7571428571428571,6,10
"['0001011', '0101', '0', '11']",1,4,7,7,0,14,2.4883838383838386,21,12
"['1001101', '010101', '10', '000', '110']",1,5,11,10,2,21,5.404273504273505,31,22
"['101', '000101', '0110100', '0100']",1,4,12,8,0,20,3.780752580752581,18,18
"['101', '10010', '10110']",1,3,6,7,2,13,2.3,5,11
"['01', '001111', '00', '1100111', '110', '01011']",1,6,10,15,2,25,8.03936063936064,48,42
"['11', '10101', '10000', '00', '111000']",1,5,11,9,4,20,4.872727272727273,30,27
"['10111', '0010', '1110']",1,3,5,8,2,13,1.6111111111111112,7,7
"['1001010', '011110', '0000']",1,3,10,7,0,17,1.434965034965035,10,9
"['00100', '01', '100', '100110']",1,4,10,6,0,16,3.615367965367965,16,17
"['101', '0010', '111010', '11']",1,4,6,9,0,15,3.4714285714285715,16,14
"['10100', '10', '000', '1100', '011000']",1,5,13,7,0,20,6.292352092352092,24,35
"['01', '000', '1101', '01110', '0100']",1,5,10,8,2,18,5.495238095238095,23,26
"['10100', '0110110', '110101']",1,3,8,10,0,18,2.163170163170163,8,4
"['1010111', '010000', '001011', '011100']",1,4,13,12,3,25,3.5128205128205128,20,15
"['0', '10111', '100011']",1,3,5,7,0,12,1.3463203463203464,11,6
"['110000', '1101', '111', '0100']",1,4,8,9,2,17,3.287301587301587,16,17
"['1000001', '1011001', '001101', '0001', '1001', '0100', '001100', '1100', '0110011']",1,9,28,21,9,49,24.043123543123542,97,113
"['0101011', '011', '110100']",1,3,7,9,0,16,1.6598290598290597,11,11
"['11', '00011', '0111', '0001011', '1110110']",1,5,10,15,2,25,5.789321789321789,34,39
"['01', '0010', '100100', '000', '1010000']",1,5,16,6,0,22,6.249605949605949,29,34
"['0010', '111010', '11']",1,3,5,7,0,12,1.4333333333333333,10,8
"['1001', '000001', '111']",1,3,7,6,0,13,1.3936507936507936,10,10
"['0100111', '00011', '10110', '0110', '000', '001001']",1,6,17,13,2,30,9.73106338106338,41,44
"['000100', '011', '0011000']",1,3,11,5,0,16,1.505982905982906,10,13
"['01', '1111', '00', '1100101', '0011011']",1,5,9,13,4,22,4.77994227994228,38,26
"['01101', '001', '11', '00010', '000100', '110']",1,6,14,10,4,24,8.306132756132756,41,40
"['11010', '0101111', '1000010', '1000', '00', '010101', '100111']",1,7,19,18,4,37,12.234576534576535,70,58
"['01', '0010000', '0011', '1000', '000', '1010001']",1,6,19,8,4,27,8.677200577200576,47,49
"['0111101', '10', '101101']",1,3,5,10,0,15,1.7136752136752138,11,10
"['110011', '10111', '100', '10']",1,4,6,10,0,16,3.7653679653679655,16,19
"['101011', '001', '1', '101']",1,4,5,8,2,13,3.0634920634920633,16,21
"['0010', '0001', '1100', '01011', '0100']",1,5,13,8,4,21,5.972222222222222,22,32
"['1011', '0001', '0111', '11']",1,4,5,9,3,14,3.4166666666666665,13,19
"['01', '10100', '001', '10011']",1,4,8,7,2,15,3.7928571428571427,15,15
"['0010', '110001', '0010011', '1010', '011001']",1,5,15,12,4,27,6.640675990675991,29,26
"['00100', '1111101', '10', '11']",1,4,6,10,2,16,2.579365079365079,23,12
"['101', '110010', '000']",1,3,7,5,2,12,1.6666666666666665,8,4
"['0000100', '00011', '1000', '10', '111000']",1,5,16,8,0,24,5.5826062826062826,36,38
"['0101111', '1100', '1', '011010']",1,4,7,11,0,18,2.5608891108891108,24,12
"['11001', '110', '11', '0100010', '1100']",1,5,10,11,0,21,6.590692640692641,26,32
"['0', '0101100', '011110']",1,3,7,7,0,14,1.151098901098901,13,13
"['1', '01000', '101101']",1,3,6,6,0,12,1.1645021645021645,12,4
"['011011', '10101', '10']",1,3,5,8,0,13,1.7987012987012987,10,7
"['1001011', '0010', '00', '1101']",1,4,9,8,2,17,3.398989898989899,19,11
"['010', '1', '00101', '11000', '00100']",1,5,12,7,3,19,5.5,29,25
"['01', '01101', '011100', '00110', '0111']",1,5,10,12,2,22,6.919624819624819,23,34
"['0011', '010', '0000110']",1,3,9,5,0,14,1.8987012987012988,9,10
"['1010101', '001101', '01100']",1,3,9,9,0,18,1.6888111888111887,7,7
"['011010', '11101', '0111', '00000']",1,4,10,10,2,20,3.1616161616161618,17,14
"['011011', '1001', '10110', '111011', '0001111', '0000101', '10011']",1,7,17,23,6,40,13.516228216228216,60,71
"['101', '10001', '100', '0010111']",1,4,9,9,2,18,3.6666666666666665,18,20
"['011111', '1001001', '0110', '0']",1,4,8,10,0,18,2.360889110889111,25,12
"['1', '00110', '10', '001001', '001011']",1,5,11,9,2,20,5.43073593073593,31,26
"['0', '0011', '111110', '101']",1,4,5,9,0,14,2.6015873015873017,20,11
"['0110101', '0110', '0000']",1,3,9,6,2,15,1.7727272727272727,9,11
"['00111', '1001', '1010', '100011', '0000', '1101', '111101', '0100']",1,8,18,19,7,37,16.017171717171717,75,75
"['01', '01111', '10']",1,3,3,6,2,9,1.3571428571428572,9,7
"['111', '0011', '10000', '110100', '001011', '101111']",1,6,13,17,3,30,7.783044733044733,47,57
"['01', '1000000', '0111111', '011110', '0000111', '00010']",1,6,18,16,3,34,7.372682872682873,62,48
"['001', '11', '100100', '000000', '01000']",1,5,16,6,2,22,4.736219336219336,33,29
"['0', '100100', '1000', '110', '1011111']",1,5,10,11,0,21,4.476762126762127,37,24
"['1', '011', '0000']",1,3,5,3,0,8,0.7857142857142857,9,4
"['100', '100111', '10', '000011']",1,4,9,8,2,17,3.3277777777777775,19,18
"['00111', '1101110', '00110', '0111', '0100']",1,5,11,14,4,25,6.183838383838384,24,35
"['0100001', '1010000', '1110111', '10100']",1,4,14,12,3,26,3.7142857142857144,19,17
"['00111', '101', '1101011', '10100', '000001']",1,5,13,13,2,26,5.244560994560994,32,30
"['010', '0111011', '100111', '0000', '111000', '1001011']",1,6,16,17,4,33,8.552924852924853,54,43
"['011', '11', '10111', '0010011', '1000', '000010', '01001', '110101']",1,8,19,19,4,38,16.20024975024975,85,78
"['0', '1101', '111']",1,3,2,6,0,8,1.2571428571428571,7,6
"['01', '010001', '111100', '11', '0110']",1,5,9,11,4,20,5.283333333333333,32,24
"['000110', '0010', '1', '10011', '000']",1,5,12,7,0,19,5.236796536796537,28,24
"['11001', '00', '1011000']",1,3,8,6,0,14,1.6825396825396823,11,6
"['11110', '10', '011']",1,3,3,7,0,10,1.4714285714285715,8,8
"['01', '010111', '001111']",1,3,5,9,2,14,1.8333333333333335,10,9
"['00111', '110000', '11']",1,3,6,7,0,13,1.435064935064935,12,12
"['000000', '100', '1', '010000']",1,4,13,3,2,16,2.5634920634920633,21,19
"['0010', '01', '0001110', '1010111', '1010', '00', '0110011']",1,7,17,16,7,33,12.219696969696969,72,56
"['111000', '110', '10010', '1']",1,4,7,8,0,15,3.012987012987013,19,14
"['101', '001110', '1', '100010']",1,4,8,8,2,16,2.849206349206349,22,12
"['00100', '0101', '000']",1,3,9,3,0,12,1.9880952380952381,6,12
"['0100000', '10', '001100', '101001', '1110']",1,5,15,10,2,25,5.205516705516706,35,22
"['101100', '10', '11']",1,3,4,6,2,10,1.5,9,7
"['011', '0100', '00011']",1,3,7,5,0,12,1.7658730158730158,7,10
"['0101', '1', '000']",1,3,5,3,0,8,0.9714285714285714,8,4
"['0', '100110', '10']",1,3,5,4,0,9,1.4523809523809523,10,8
"['1011', '10001', '110', '11']",1,4,5,9,0,14,3.776190476190476,13,24
"['00110', '1', '00001']",1,3,7,4,2,11,1.2666666666666666,11,5
"['11001', '01101', '111', '11101', '10', '000']",1,6,9,14,5,23,8.414285714285715,36,42
"['010', '011', '000']",1,3,6,3,3,9,1.6666666666666665,4,9
"['001', '0001', '1010', '1000', '1100011']",1,5,13,9,3,22,6.6,25,27
"['011100', '00001', '100100', '1010', '00', '1001100', '1011']",1,7,20,14,4,34,12.310705960705961,63,67
"['00011', '10111', '0001', '101', '00', '1110']",1,6,11,12,4,23,7.944444444444444,39,42
"['110000', '00001', '11', '10100', '001110', '010110', '011110', '1100101']",1,8,22,21,6,43,15.178277278277278,89,76
"['1000000', '010', '00000']",1,3,13,2,0,15,1.7333333333333334,10,16
"['001100', '00', '110', '0100100']",1,4,12,6,0,18,3.1803418803418806,20,27
"['1', '0011001', '10001', '10100', '10']",1,5,11,9,2,20,4.937301587301587,34,28
"['1110110', '0001', '00101']",1,3,8,8,0,16,1.5303030303030303,10,8
"['110010', '0100110', '11']",1,3,7,8,0,15,1.7136752136752138,11,7
"['01001', '10001', '0001', '00001']",1,4,13,6,3,19,5.066666666666666,7,29
"['01', '1010', '0000']",1,3,7,3,2,10,1.5,7,6
"['1100011', '1100100', '0']",1,3,8,7,2,15,1.2142857142857144,15,8
"['00111', '0111101', '1000', '100']",1,4,9,10,0,19,3.231890331890332,22,17
"['100', '011', '1110', '101101']",1,4,6,10,2,16,3.6095238095238096,15,14
"['01100', '01', '100100', '01010']",1,4,11,7,2,18,3.7155844155844155,17,19
"['101011', '1101', '001000']",1,3,8,8,2,16,1.5,9,5
"['011111', '11010', '011011', '0']",1,4,6,12,2,18,2.829004329004329,20,17
"['011011', '0', '0100']",1,3,6,5,0,11,1.2857142857142856,11,9
"['1100010', '11110', '100', '000']",1,4,10,8,2,18,3.1166666666666667,19,16
"['010100', '1101111', '1', '0110100', '101101', '0000001']",1,6,17,17,5,34,6.5155677655677655,61,34
"['10111', '00', '10000']",1,3,7,5,2,12,1.2571428571428571,10,7
"['0', '10111', '1100100', '1111', '0101']",1,5,8,13,2,21,4.407575757575757,34,25
"['111000', '10110', '11']",1,3,5,8,0,13,1.7987012987012987,10,8
"['0', '1010', '1111']",1,3,3,6,2,9,0.9,9,4
"['0', '010', '110']",1,3,4,3,2,7,1.6666666666666665,5,9
"['01', '011', '11']",1,3,2,5,2,7,2.1,3,9
"['0010010', '1', '0010']",1,3,8,4,0,12,1.3772727272727274,12,10
"['0', '0101', '110']",1,3,4,4,0,8,1.4714285714285715,7,6
"['0', '111000', '0110011']",1,3,7,7,0,14,1.151098901098901,14,7
['0001000'],1,1,6,1,0,7,0,0,0
"['100000', '0101111', '1100', '01000']",1,4,13,9,0,22,3.1652680652680654,21,19
"['1010111', '1010', '011', '101101']",1,4,7,13,0,20,4.134598734598734,16,22
"['01', '001111', '00011', '00100', '0010100', '0000000']",1,6,22,10,4,32,8.343423243423244,51,70
"['001100', '0111001', '11']",1,3,7,8,0,15,1.7136752136752138,11,4
"['11001', '010', '1', '001101', '000101']",1,5,11,10,2,21,5.344155844155844,32,23
"['01', '000111', '110111']",1,3,5,9,2,14,1.6666666666666665,10,10
"['0111001', '1', '101010', '11101', '1110100', '000']",1,6,13,16,2,29,7.146736596736597,54,35
"['111100', '0101110', '0011000', '00111', '0001', '1011011', '1100']",1,7,19,21,5,40,12.614141414141415,69,66
"['10111', '0010010', '000001']",1,3,11,7,0,18,1.3251748251748252,10,5
"['00', '111', '1101010']",1,3,5,7,0,12,1.0444444444444443,12,6
"['1110010', '001', '0101001', '11']",1,4,9,10,2,19,3.2031746031746033,23,16
"['0100000', '1101111', '1011101', '010111', '000000']",1,5,17,16,5,33,5.135531135531136,37,29
"['101', '00', '1001']",1,3,5,4,0,9,1.9238095238095236,5,6
"['1111100', '0010', '1001', '110']",1,4,8,10,2,18,3.401948051948052,20,13
"['1', '00001', '0100010', '10001', '0010010', '110']",1,6,18,10,4,28,7.707142857142857,49,35
"['010000', '10', '00010', '1100', '1110']",1,5,13,8,2,21,5.589105339105339,27,30
"['00', '01101', '001110']",1,3,7,6,0,13,1.7987012987012987,10,10
"['011111', '0111101', '10']",1,3,4,11,0,15,1.6175213675213675,11,10
"['11001', '001111', '111010', '00001', '0001', '100', '0010101', '1110110']",1,8,21,22,6,43,16.386330336330335,87,90
"['01', '111100', '1']",1,3,3,6,0,9,1.2023809523809523,11,6
"['100', '1', '1101111']",1,3,3,8,0,11,1.15,13,8
"['0100111', '1', '000']",1,3,6,5,0,11,0.65,13,4
"['00111', '100100', '010111', '10', '10011']",1,5,11,13,4,24,6.066233766233767,29,31
"['1011001', '111010', '0111011', '1000110', '1100001', '10000', '1111', '101111']",1,8,20,29,6,49,17.16771006771007,88,102
"['1000', '100', '01111', '1110']",1,4,7,9,2,16,3.067460317460317,15,17
"['010', '011', '0011010']",1,3,7,6,2,13,1.8666666666666667,9,11
['001101'],1,1,3,3,0,6,0,0,0
"['01', '11011', '00', '0100001', '001001']",1,5,13,9,2,22,5.06071706071706,35,25
"['1000110', '011', '10']",1,3,6,6,0,12,1.4444444444444444,11,8
"['1101', '001', '10000']",1,3,7,5,0,12,1.5158730158730158,8,8
"['0', '1101', '00010', '11']",1,4,6,6,0,12,2.13015873015873,18,10
"['01111', '100111', '000']",1,3,6,8,0,14,1.4217171717171717,10,6
"['0101101', '110', '111']",1,3,4,9,2,13,1.8666666666666667,9,8
"['11110', '01', '001111', '101010', '1000000']",1,5,13,13,2,26,4.355255855255855,39,26
"['101', '0010', '10011', '0011000']",1,4,11,8,0,19,3.782034632034632,18,12
"['011100', '101010', '1111', '0111', '011001', '01001', '110', '111001']",1,8,16,24,6,40,18.939321789321788,70,89
"['0111000', '0010', '01101', '011', '010111', '01000']",1,6,16,14,2,30,9.554995004995005,41,56
"['010000', '0100', '1001']",1,3,10,4,2,14,2.15,7,8
"['000100', '01001', '00010', '010']",1,4,14,5,2,19,4.403030303030303,13,27
"['11000', '0101011', '011', '0110']",1,4,9,10,0,19,3.5025974025974023,19,20
"['1001110', '101', '011010', '111011']",1,4,8,14,2,22,3.9846153846153847,19,12
"['0', '100001', '1101000', '0011011', '01001']",1,5,15,11,2,26,4.661338661338661,41,22
"['1000100', '01', '01101']",1,3,8,6,0,14,1.5158730158730158,12,8
"['101011', '110001', '101', '101111']",1,4,7,14,3,21,3.833333333333333,17,34
"['10', '011110', '00001']",1,3,7,6,0,13,1.1493506493506493,12,7
"['001', '101', '100000', '1011100', '000001', '011110', '0001011', '1110']",1,8,23,19,7,42,14.405805305805305,102,81
"['0', '1100101', '1111']",1,3,4,8,0,12,0.9772727272727273,13,6
"['00100', '1', '1111000']",1,3,7,6,0,13,1.0833333333333333,14,6
"['0101', '100', '0110', '01100']",1,4,9,7,2,16,4.198412698412699,11,21
"['0001101', '00100', '110', '01000']",1,4,13,7,2,20,3.5666666666666664,19,20
"['0011001', '01001', '100', '01000']",1,4,13,7,2,20,4.4,14,21
"['1001110', '1', '1001', '1010001', '001001']",1,5,13,12,2,25,5.396303696303696,38,38
"['1110111', '1', '10001', '100', '000100']",1,5,11,11,0,22,4.720679320679321,39,25
"['11111', '11011', '110', '0000']",1,4,6,11,2,17,2.5579365079365077,18,19
"['010', '1', '001101', '00001']",1,4,9,6,0,15,2.831168831168831,19,12
"['110010', '0001110', '1', '001101', '011011']",1,5,12,14,3,26,5.11996336996337,41,21
"['0', '1110011', '11']",1,3,3,7,0,10,0.6944444444444444,13,8
"['0', '01101', '110']",1,3,4,5,0,9,1.5833333333333333,8,6
"['001', '10', '1001']",1,3,5,4,0,9,1.9238095238095236,5,9
"['01', '110111', '0011000']",1,3,7,8,0,15,1.4059829059829059,14,4
"['000001', '1', '10']",1,3,6,3,0,9,1.2023809523809523,11,6
"['0', '101', '111110', '000010']",1,4,8,8,2,16,2.2936507936507935,24,11
"['1000001', '100', '1101011', '00', '011010']",1,5,14,11,2,25,5.857753357753357,37,20
"['1000', '0100111', '10011']",1,3,8,8,0,16,2.0454545454545454,8,9
"['10001', '001', '0110011']",1,3,8,7,0,15,2.0166666666666666,9,8
"['11110', '011', '01001', '011001', '1010001', '00010', '001001', '0110011']",1,8,23,21,7,44,18.476873126873127,76,88
"['00', '0000001', '10', '11']",1,4,9,4,3,13,1.8888888888888888,21,12
"['0111', '100', '00101', '01010']",1,4,9,8,2,17,3.669047619047619,14,14
"['100000', '1100', '1']",1,3,7,4,0,11,1.2857142857142856,11,7
"['110110', '1101', '010000', '1']",1,4,8,9,2,17,2.6714285714285717,22,13
"['101', '000100', '010010']",1,3,10,5,2,15,1.9444444444444444,9,4
"['110110', '010', '1', '111011']",1,4,5,11,2,16,2.7936507936507935,21,13
"['1000110', '110010', '0101', '0100110']",1,4,13,11,2,24,4.268331668331668,16,20
"['1', '10', '01000']",1,3,5,3,0,8,1.5714285714285714,8,4
"['01', '001101', '1001010', '10001', '01111', '10100', '100011', '100000']",1,8,23,19,6,42,16.222483072483072,85,86
"['0010', '01', '1100010', '0011', '0001100', '0111']",1,6,16,12,5,28,9.278499278499279,46,45
"['10001', '00', '10']",1,3,6,3,2,9,1.6428571428571428,7,5
"['0000', '01010', '00011']",1,3,10,4,2,14,1.9333333333333331,6,12
"['01', '00', '00111', '110010']",1,4,8,7,2,15,3.188311688311688,19,15
"['011100', '010001', '1', '0111']",1,4,8,9,2,17,3.038095238095238,21,15
"['11001', '11110', '110010', '111', '00111', '00100', '100', '0000000', '0011010', '1101010']",1,10,28,25,9,53,26.295404595404595,144,150
"['1101111', '11', '010010', '001110', '1110100', '0101']",1,6,13,19,4,32,8.592252192252193,54,39
"['1110101', '01', '010100', '000']",1,4,10,8,0,18,2.804273504273504,22,14
"['1000001', '1100010', '1']",1,3,9,6,2,15,1.2142857142857144,15,8
"['0010001', '0011101', '01111', '1111', '111110', '0000110', '0000011', '110']",1,8,21,25,4,46,16.426651126651127,98,94
"['1', '0011111', '01000']",1,3,6,7,0,13,0.9166666666666666,15,5
"['101011', '1101', '0011', '11111']",1,4,5,14,2,19,3.374747474747475,14,28
"['011101', '1011010', '01', '001101']",1,4,9,12,2,21,3.8162393162393164,19,18
"['11101', '001110', '1110100', '000011']",1,4,11,13,2,24,3.513986013986014,21,19
"['11001', '001', '111', '011', '110111', '000']",1,6,9,14,4,23,7.893939393939394,37,50
"['0010110', '0001', '0110', '1010111', '10', '0101100', '01001', '110', '1111111']",1,9,20,26,6,46,18.895959595959596,123,95
"['0001010', '0111011', '1', '000010']",1,4,12,9,2,21,2.587912087912088,25,14
"['00111', '0100111', '1011000']",1,3,9,10,2,19,1.9047619047619047,11,11
"['010', '10110', '111101']",1,3,5,9,0,14,1.7398989898989898,8,5
"['101000', '01', '100', '000001']",1,4,12,5,2,17,3.011111111111111,20,18
"['1000001', '010', '001', '011100', '110001', '0110', '100', '1111111']",1,8,19,20,7,39,14.98905538905539,101,70
"['1101', '010', '100101']",1,3,6,7,0,13,2.038095238095238,7,6
"['110000', '0010', '111100', '01111', '00', '01001']",1,6,15,13,4,28,7.883405483405483,49,47
"['01', '0110001', '00011']",1,3,8,6,0,14,1.6825396825396823,11,8
"['001', '1111011', '100101', '01110', '110101']",1,5,10,17,2,27,5.804817404817404,30,27
"['01', '11100', '10', '11']",1,4,4,7,3,11,2.9285714285714284,14,14
"['1101000', '100', '010011']",1,3,9,7,0,16,1.882051282051282,11,8
"['011', '11', '101011', '110001', '00']",1,5,8,11,4,19,4.977777777777778,31,30
"['00', '0100111', '11010', '11']",1,4,7,9,2,16,2.5317460317460316,22,15
"['110110', '001', '00101', '000']",1,4,10,7,2,17,3.6010101010101008,17,19
"['011011', '0111000', '00', '001']",1,4,10,8,0,18,3.2042735042735044,21,21
"['11001', '100111', '0']",1,3,5,7,0,12,1.3463203463203464,12,5
"['011', '10110', '1000010', '10100', '1011', '1110']",1,6,13,15,4,28,9.343217893217894,36,48
"['000011', '10001', '1001', '0000001', '111111', '0100001', '1010000']",1,7,25,17,5,42,12.506771006771007,67,79
"['1000100', '110', '01100', '11']",1,4,9,8,0,17,3.465873015873016,18,14
"['0101011', '1', '0100']",1,3,6,6,0,12,1.3772727272727274,12,6
"['11000', '0101110', '011', '0111']",1,4,8,11,0,19,3.6288600288600286,20,19
"['11001', '100100', '1001', '10000', '0000001', '11101', '0100']",1,7,22,14,5,36,13.202447552447552,54,70
"['1011001', '100011', '1']",1,3,6,8,0,14,1.151098901098901,14,13
"['000100', '010101', '1110100']",1,3,11,8,2,19,1.8974358974358974,8,10
"['1011', '1100', '0011000']",1,3,8,7,2,15,1.7727272727272727,10,7
"['01', '01101', '1110011', '11011']",1,4,6,13,2,19,3.7206349206349207,18,21
"['1010', '0101', '110', '010111']",1,4,7,10,2,17,3.7373015873015873,14,17
"['000110', '1', '011101', '00', '111110']",1,5,9,12,3,21,3.9404761904761902,39,22
"['010100', '0101', '1100']",1,3,8,6,2,14,2.1,6,11
"['0', '01111', '0111', '001010']",1,4,7,9,0,16,3.0533910533910533,19,19
"['0', '0010010', '0101110', '100010']",1,4,13,8,2,21,2.576923076923077,25,23
"['1', '1110110', '1100', '000']",1,4,7,8,0,15,2.3487012987012985,22,13
"['0010', '100', '00', '111110']",1,4,8,7,0,15,3.1325396825396825,18,20
"['0010110', '0011011', '011010']",1,3,10,10,2,20,2.241758241758242,6,11
"['0', '111111', '01', '1101100']",1,4,5,11,0,16,2.2264957264957266,26,12
"['11001', '110010', '00100', '10', '1000011']",1,5,14,11,2,25,6.105716505716505,32,26
"['1101001', '1', '100100', '10010', '110']",1,5,11,11,0,22,5.258480408480408,32,29
"['11110', '001', '1', '0000001', '0101001']",1,5,13,10,2,23,3.9976190476190476,42,27
"['1110001', '11011', '000010']",1,3,9,9,0,18,1.6456876456876457,11,6
"['1100011', '110010', '10001', '10']",1,4,10,10,0,20,3.8457098457098455,18,20
"['0', '00100', '11000']",1,3,8,3,2,11,1.2666666666666666,11,10
"['0', '00010', '11']",1,3,5,3,0,8,0.6190476190476191,10,4
"['101', '1101000', '01111']",1,3,6,9,0,15,1.6,12,7
"['11000', '11101', '101', '011110']",1,4,7,12,2,19,3.567171717171717,17,13
"['0', '10100', '001', '11']",1,4,6,5,0,11,2.3047619047619046,16,11
"['0', '0011101', '10111', '0111111', '01100']",1,5,9,16,4,25,4.980952380952381,38,23
"['0', '010', '011010', '01011']",1,4,8,7,0,15,3.081168831168831,18,24
"['1001110', '01', '010', '00011', '00']",1,5,11,8,2,19,5.698412698412699,29,26
"['100110', '00', '0111', '001000']",1,4,11,7,2,18,3.0,21,18
"['01', '01101', '111', '000', '01110']",1,5,8,10,4,18,5.242857142857143,25,23
"['0', '100110', '001001', '111000']",1,4,11,8,3,19,2.6904761904761902,25,13
"['100011', '10', '00101', '1101110']",1,4,9,11,0,20,3.3585303585303583,22,15
"['11001', '111010', '111', '0101101', '0001', '1101011', '1100100', '010110']",1,8,19,26,5,45,17.42048507048507,81,93
"['1', '011011', '10111', '1001101', '10100', '0101']",1,6,11,17,2,28,8.104945054945055,48,44
"['101', '00010', '001001']",1,3,9,5,0,14,1.893939393939394,9,6
"['0100111', '001101', '110011', '1000', '10011', '01110', '011000']",1,7,19,20,5,39,14.092229992229992,61,57
"['000110', '0111001', '010', '11', '0010100', '001110']",1,6,17,14,4,31,9.292918192918194,49,45
"['11001', '1000000', '0110111', '0']",1,4,11,9,2,20,2.2857142857142856,29,11
"['000101', '000', '1010010', '1110', '0100']",1,5,15,9,2,24,5.483949383949384,29,30
"['11011', '11', '101', '110001', '0010010', '0110001']",1,6,14,16,2,30,9.237956487956488,48,50
"['01', '001000', '10110', '000', '1101']",1,5,12,8,0,20,5.202597402597402,30,25
"['0', '00011', '1010', '010111', '01000']",1,5,12,9,2,21,4.936219336219336,32,27
"['00111', '1', '00101']",1,3,5,6,2,11,1.4666666666666668,9,8
"['011011', '10111', '111']",1,3,3,11,0,14,2.143939393939394,8,15
"['0', '01', '10011', '01110']",1,4,6,7,2,13,3.076190476190476,18,11
"['1001', '10', '11']",1,3,3,5,2,8,1.8333333333333333,5,9
"['1000000', '1010', '11101', '000', '11111', '0100']",1,6,15,13,4,28,6.911544011544011,50,38
"['1011', '100', '10']",1,3,4,5,0,9,2.038095238095238,5,9
"['01001', '1', '011', '010111']",1,4,6,9,0,15,3.262987012987013,18,17
"['1110101', '1', '10110']",1,3,4,9,0,13,1.25,13,8
"['1011', '10101', '11']",1,3,3,8,0,11,2.126984126984127,6,16
"['0010', '11011', '11', '11000', '000010']",1,5,12,10,2,22,5.1463924963924965,31,32
"['0011110', '1010', '010', '01000']",1,4,11,8,0,19,3.9192640692640692,17,25
"['001100', '01', '0100']",1,3,8,4,0,12,1.9666666666666668,8,12
"['01', '0001', '0000', '1011', '111001']",1,5,11,9,3,20,5.266666666666667,27,27
"['0', '1111101', '1111010', '1101', '01011']",1,5,7,17,2,24,5.211688311688311,37,29
"['000110', '101', '0001001', '11']",1,4,10,8,0,18,3.558119658119658,20,14
"['0', '101', '0010010']",1,3,7,4,0,11,1.35,12,4
"['111', '00', '10011', '0101', '110', '111001']",1,6,9,14,2,23,8.074891774891775,39,42
['000101'],1,1,4,2,0,6,0,0,0
"['0111000', '11', '0011', '10001', '011110', '1010010']",1,6,15,16,2,31,8.78043068043068,51,34
"['1010000', '01010', '11']",1,3,8,6,0,14,1.6825396825396823,11,4
"['0', '101', '1100']",1,3,4,4,0,8,1.4714285714285715,7,4
"['01', '11101', '11']",1,3,2,7,2,9,1.6428571428571428,7,11
"['00010', '110001', '1', '1001010']",1,4,11,8,0,19,3.0322177822177823,23,12
"['1000101', '10000', '1110']",1,3,9,7,0,16,1.6414141414141414,9,9
"['1001110', '001', '011011', '0001', '1000', '0100']",1,6,16,12,3,28,8.878010878010878,43,42
"['001', '010111', '1110']",1,3,5,8,0,13,1.33015873015873,9,8
"['101010', '10101', '1001010', '1010011']",1,4,12,13,2,25,4.815684315684316,11,31
"['010', '001', '0011', '1001000', '0111111']",1,5,12,12,4,24,5.471861471861471,37,26
"['1001', '0111', '0101001']",1,3,7,8,2,15,1.9545454545454546,9,10
"['0011101', '010', '011', '001', '1000110', '0001', '1110101', '1010', '1100', '1111011']",1,10,22,27,10,49,27.116233766233766,143,120
"['0', '10010', '011']",1,3,5,4,0,9,1.3333333333333333,9,6
"['0101', '1101101', '10', '11']",1,4,5,10,2,15,3.2676767676767673,18,18
"['1011', '0101', '011']",1,3,4,7,2,11,2.4642857142857144,4,9
"['0001101', '00', '00101', '1111011']",1,4,10,11,2,21,3.142857142857143,24,17
"['010001', '11', '00001', '01111', '101110', '1001111']",1,6,13,18,4,31,8.464990564990565,49,45
"['101', '1110010', '0011000']",1,3,9,8,2,17,1.7142857142857144,12,4
"['01', '100', '000000', '11']",1,4,9,4,2,13,1.9944444444444445,20,12
"['0', '100110', '11']",1,3,4,5,0,9,0.7857142857142857,11,4
"['00111', '10011', '1011', '0110010', '110']",1,5,10,14,2,24,6.239105339105339,28,27
"['011011', '00', '10']",1,3,5,5,2,10,1.5,9,6
"['0111', '1', '0100100']",1,3,6,6,0,12,1.1954545454545453,13,5
['1111000'],1,1,3,4,0,7,0,0,0
"['001', '11', '1100010', '1010', '0000', '000100', '1110']",1,7,18,12,3,30,10.942246642246642,61,59
"['0011', '00', '10101']",1,3,6,5,0,11,1.9047619047619047,7,6
"['1100011', '01', '011001']",1,3,7,8,0,15,1.7136752136752138,12,8
"['1000011', '1110101', '01001', '01011']",1,4,11,13,4,24,4.038095238095238,17,21
"['11011', '1', '0000']",1,3,5,5,0,10,0.5555555555555556,12,4
"['1011', '101', '0011100', '000']",1,4,9,8,2,17,3.0216450216450217,19,14
"['101', '01100', '1111', '0000', '01011', '101001']",1,6,13,14,4,27,7.606132756132756,41,34
"['0001100', '100110', '11']",1,3,8,7,0,15,1.7136752136752138,11,4
"['10101', '001', '00011']",1,3,7,6,2,13,1.85,7,8
"['0000', '1001', '100010']",1,3,10,4,2,14,2.1,6,6
"['001001', '101000', '100', '011111', '011010', '110']",1,6,15,15,6,30,8.38888888888889,47,38
"['001', '10110', '011100', '11']",1,4,7,9,0,16,3.1431457431457432,19,11
"['0010110', '101', '011']",1,3,6,7,2,13,1.8666666666666667,10,4
"['1000110', '11101', '110', '100111']",1,4,8,13,0,21,3.775796425796426,19,22
"['10101', '110', '10010', '1001111']",1,4,8,12,2,20,3.533333333333333,17,21
"['110010', '010', '11', '10', '01100']",1,5,9,9,2,18,5.986796536796537,26,25
"['0101', '011', '101001']",1,3,6,7,0,13,2.3238095238095235,6,8
"['01', '010', '100001', '00000']",1,4,12,4,0,16,3.2574314574314576,18,12
"['01', '0001', '11111']",1,3,4,7,0,11,1.1746031746031744,10,7
"['1110101', '01', '010', '00010']",1,4,9,8,0,17,3.6658730158730157,19,14
"['11000', '010', '1111']",1,3,5,7,0,12,1.2301587301587302,9,6
"['001100', '011001', '1011', '11']",1,4,8,10,2,18,3.7,18,12
"['101', '01', '00', '0111']",1,4,5,6,2,11,3.2714285714285714,11,12
"['1101001', '010011', '0001', '0110100']",1,4,13,11,2,24,4.132667332667332,17,15
"['1101000', '0101000', '0010100']",1,3,14,7,3,21,2.4285714285714284,6,17
"['0', '1011', '10']",1,3,3,4,0,7,1.7333333333333334,6,5
"['1001100', '11110', '1', '000']",1,4,8,8,0,16,2.1,24,12
"['01101', '001', '100', '10000', '100011', '000', '0011011', '000111']",1,8,22,16,7,38,17.20784770784771,82,92
"['0011011', '11010', '1101011', '10']",1,4,8,13,2,21,3.6746031746031744,21,23
"['0', '11011', '0111']",1,3,3,7,0,10,1.4,9,6
"['0011101', '1', '011', '1010101']",1,4,7,11,2,18,2.6285714285714286,24,16
"['00011', '11000', '100', '000111', '0111101']",1,5,13,13,2,26,5.764374514374515,35,34
"['010', '001', '1000101', '1010', '1001100']",1,5,14,10,4,24,6.664069264069264,29,26
"['0010001', '11', '0100010', '1101', '101110']",1,5,13,13,2,26,5.316894216894217,36,22
"['0101000', '001111', '1110000', '00001', '1011', '1100']",1,6,18,15,4,33,8.102009102009102,54,49
"['11010', '001', '1001', '000', '110']",1,5,10,8,3,18,5.75,21,25
"['0', '10100', '01001', '11']",1,4,7,6,2,13,2.6095238095238096,18,10
"['01101', '010', '000']",1,3,7,4,2,11,1.9166666666666665,6,9
"['0', '1001', '10110', '1111']",1,4,5,9,2,14,2.3444444444444446,17,11
"['110', '111', '111101']",1,3,2,10,2,12,2.0,7,15
"['0100000', '001', '00001', '1111', '10100', '001110', '0000', '001100']",1,8,26,14,6,40,14.974975024975025,84,111
"['10001', '1010100', '10000', '100111', '10', '1001111']",1,6,16,16,4,32,8.584326784326784,46,64
"['0', '1110010', '0100', '11']",1,4,7,7,0,14,1.9732323232323232,23,12
"['0011', '1101000', '100', '1100101', '01001']",1,5,14,12,2,26,6.326623376623377,32,28
"['1011110', '1101', '0010', '1110']",1,4,7,12,3,19,3.3863636363636362,18,16
"['11000', '1101', '0000110', '11']",1,4,9,9,0,18,3.3946608946608947,21,18
"['01', '010', '100001', '11', '1000000']",1,5,13,7,2,20,4.758119658119658,35,24
"['11001', '01101', '00000', '00100', '0001', '100101', '100000', '0111']",1,8,25,15,8,40,16.524242424242424,69,87
"['0010110', '1000101', '11', '11101', '100011']",1,5,12,15,2,27,5.7433677433677435,35,35
"['1100011', '0010', '011110']",1,3,8,9,0,17,1.606993006993007,12,5
"['10111', '0010100', '101111', '01110']",1,4,9,14,2,23,4.064568764568764,16,14
"['1101101', '100', '011100']",1,3,7,9,0,16,1.882051282051282,10,6
"['1010', '1001', '1110']",1,3,5,7,3,12,1.75,6,8
"['01', '100010', '10011', '1100011', '01011']",1,5,12,13,2,25,6.429259629259629,29,34
"['11010', '011', '11', '100', '0000101', '001011']",1,6,13,13,2,26,8.225002775002775,48,43
"['10111', '1101101', '100', '10100', '1011000', '1001001', '00010', '0100011']",1,8,24,22,7,46,17.75,86,83
"['1000110', '1101', '111111']",1,3,5,12,0,17,1.453146853146853,11,10
"['0011001', '01', '0010001', '01110']",1,4,12,9,2,21,3.484126984126984,21,19
"['101', '0011', '1']",1,3,3,5,0,8,1.4714285714285715,7,8
"['1101', '1001', '01110', '11']",1,4,5,10,2,15,3.765873015873016,15,15
"['110', '1110', '01110']",1,3,4,8,0,12,2.496031746031746,4,14
"['0101101', '00111', '110101']",1,3,7,11,0,18,1.9941724941724943,7,9
"['00', '1010101', '11100', '10']",1,4,8,8,2,16,3.0317460317460316,20,13
"['000110', '1010', '11']",1,3,6,6,0,12,1.7666666666666666,9,5
"['110100', '111011', '100011', '000', '110']",1,5,11,13,5,24,5.277777777777778,32,31
"['01', '10', '000']",1,3,5,2,2,7,1.3,6,6
"['011101', '10', '11001']",1,3,5,8,0,13,1.7987012987012987,9,7
"['0001', '1', '101110', '0000']",1,4,9,6,2,15,2.2357142857142858,21,14
"['1011', '00', '01101', '111']",1,4,5,9,0,14,2.892857142857143,15,12
"['0111000', '0001', '0110000', '1110001', '00', '10', '1101', '111101']",1,8,20,19,7,39,15.527755577755578,94,78
"['0011110', '011', '01110', '00001']",1,4,10,10,2,20,3.5833333333333335,19,20
"['010', '001101', '100', '01111', '11101', '0111', '1011', '110']",1,8,12,21,7,33,17.214069264069263,65,78
"['00010', '00', '100', '1100110']",1,4,11,6,0,17,3.5825396825396822,19,20
"['0', '1100000', '111']",1,3,6,5,0,11,0.65,14,6
"['0000100', '1011110', '1001', '110011', '00', '01110', '1011000', '01011', '1110']",1,9,23,24,7,47,20.744977244977246,121,98
"['11110', '100', '00011']",1,3,6,7,2,13,1.4,10,8
"['0011001', '010111', '001101']",1,3,9,10,2,19,2.358974358974359,6,11
"['01', '101010', '00111', '0011110', '110']",1,5,10,13,0,23,5.146797646797647,32,29
"['0', '10111', '011010']",1,3,5,7,0,12,1.1645021645021645,12,4
"['100100', '00101', '01000']",1,3,11,5,2,16,2.0545454545454547,8,9
"['00111', '00', '1110100']",1,3,7,7,0,14,1.5158730158730158,13,13
"['111', '101101', '0110000', '111110', '010011']",1,5,11,17,3,28,5.382905982905982,35,26
"['0101', '0011100', '1011000']",1,3,10,8,2,18,1.8051948051948052,10,8
"['0010000', '0111011', '101', '110', '1110']",1,5,11,13,4,24,5.6147186147186146,35,23
"['0', '0010', '0010101', '11']",1,4,8,6,0,14,2.155050505050505,22,13
"['0', '010001', '001111', '1101', '01011']",1,5,10,12,2,22,4.725974025974026,33,24
"['1', '1111101', '0100010', '0101010', '0010010']",1,5,15,14,4,29,4.857142857142857,43,25
"['110110', '111', '00111', '101', '01011']",1,5,7,15,4,22,6.572727272727272,23,33
"['00', '00010', '001110', '1000']",1,4,12,5,0,17,3.732034632034632,17,29
"['0110101', '11', '0110', '0000001', '01010']",1,5,14,11,2,25,5.336940836940837,34,25
"['0011110', '00', '11011', '01000']",1,4,10,9,2,19,2.7015873015873018,23,17
"['010', '10', '10000']",1,3,7,3,0,10,1.8714285714285714,7,8
"['0100010', '1101001', '0111', '0']",1,4,10,9,2,19,2.705194805194805,26,12
"['0101111', '11011', '01110', '111001']",1,4,7,16,2,23,4.003263403263404,18,17
"['01001', '10', '1111']",1,3,4,7,0,11,1.349206349206349,9,6
"['010100', '011110', '00001']",1,3,10,7,2,17,1.393939393939394,9,10
"['01', '1100000', '010111', '10']",1,4,9,8,2,17,2.4743589743589745,26,14
"['11000', '0101', '110']",1,3,6,6,0,12,1.7658730158730158,7,8
"['010000', '11', '00100', '01111', '10110']",1,5,12,11,3,23,4.914935064935065,32,23
"['0101', '100', '01100', '00000']",1,4,12,5,2,17,3.3325396825396822,14,21
"['1100', '10111', '100', '10010']",1,4,8,9,2,17,3.818253968253968,13,19
"['00', '0000011', '0100', '11']",1,4,10,5,2,15,2.2525252525252526,21,17
"['001', '100001', '00101', '1101110', '000111']",1,5,14,13,2,27,5.9996503496503495,31,29
"['1100111', '11110', '111001']",1,3,5,13,0,18,1.9965034965034967,8,16
"['0010', '0111101', '111']",1,3,5,9,0,14,1.431168831168831,11,4
"['0011011', '1', '100010']",1,3,7,7,0,14,1.151098901098901,15,6
"['01', '111100', '10010', '111000', '0100']",1,5,12,11,2,23,5.710822510822511,31,27
"['0000101', '1111010', '100011']",1,3,10,10,2,20,1.5054945054945055,11,7
"['001', '0100', '0000']",1,3,9,2,2,11,1.6428571428571428,5,13
"['1110111', '0001110', '0101101', '0011', '00110', '001100', '11100']",1,7,19,22,5,41,14.536363636363637,60,75
"['11110', '001111', '101', '0001', '1111010', '110111', '0100011']",1,7,14,24,4,38,11.691841491841492,71,71
"['01', '001', '11', '1001000', '111000']",1,5,11,9,2,20,5.152564102564103,33,28
"['1111100', '1101000', '0010']",1,3,9,9,2,18,1.4805194805194803,11,10
"['011011', '1110110', '01000']",1,3,8,10,0,18,1.8146853146853146,9,8
"['11001', '1001', '001']",1,3,6,6,0,12,2.496031746031746,4,15
"['0010001', '010', '10110', '010110']",1,4,12,9,0,21,4.041142191142191,18,22
"['010', '010000', '11', '1100', '0100']",1,5,12,7,2,19,5.895238095238095,24,33
"['0101', '100100', '10', '01100']",1,4,10,7,0,17,3.55021645021645,16,16
"['111', '011', '10101', '0100100', '000100', '1001011']",1,6,16,15,4,31,9.13153513153513,46,39
['0011001'],1,1,4,3,0,7,0,0,0
"['01', '111100', '11', '1000', '1011', '101001']",1,6,10,14,6,24,7.816666666666666,43,47
"['0101000', '0110111', '0001111', '00', '101001']",1,5,15,14,3,29,5.5476190476190474,40,27
"['1000000', '101', '0101']",1,3,9,5,0,14,1.6207792207792209,11,9
"['0010001', '1010001', '10010', '011101']",1,4,14,11,2,25,3.8128538128538128,18,20
"['010', '1', '110001', '10100', '1101', '000100']",1,6,14,11,2,25,8.225180375180376,47,33
"['01101', '00010', '010']",1,3,8,5,2,13,2.1,7,11
"['0111111', '001', '11']",1,3,3,9,0,12,1.2444444444444445,12,8
"['001101', '11', '101', '110111', '10011', '001100', '01011']",1,7,13,20,5,33,13.884271284271284,59,68
"['0110101', '0101', '001111', '1011', '0111101']",1,5,10,18,4,28,6.748201798201798,27,32
"['0', '0001', '0111101', '01110']",1,4,8,9,0,17,2.624747474747475,22,18
"['100', '00101', '00000']",1,3,10,3,2,13,1.6,8,11
"['1000100', '111', '1011110', '00100', '110001', '100010']",1,6,18,16,4,34,9.141164391164391,50,43
['1000001'],1,1,5,2,0,7,0,0,0
"['01100', '001', '1110', '00000']",1,4,11,6,2,17,2.5746031746031743,17,19
"['1101', '1000', '111']",1,3,4,7,2,11,1.6428571428571428,6,10
"['1011', '00', '011']",1,3,4,5,0,9,1.5904761904761904,6,6
"['1', '1110', '1101100']",1,3,4,8,0,12,1.1954545454545453,12,7
"['0010110', '101', '01101', '001001']",1,4,11,10,0,21,4.17983682983683,16,17
"['00110', '0101', '100111', '10']",1,4,8,9,0,17,3.732034632034632,17,12
"['1000001', '11001', '110010', '111100', '000', '1101', '001011', '01110']",1,8,21,21,5,42,16.56963036963037,87,77
"['0100010', '0010', '1110', '11']",1,4,9,8,2,17,3.0353535353535355,19,17
"['10000', '0100', '0001111', '1111', '1010011', '110101']",1,6,15,18,4,33,8.211216561216562,50,48
"['10', '111', '0100']",1,3,4,5,0,9,1.3523809523809525,7,4
"['01', '11010', '00000', '00001', '110011', '1111010', '110']",1,7,17,16,3,33,10.64143079143079,70,65
"['001', '1', '00000']",1,3,7,2,0,9,1.0,10,6
"['1110001', '01', '100000', '1']",1,4,9,7,0,16,2.512210012210012,25,15
"['11001', '1010', '000']",1,3,7,5,0,12,1.7380952380952381,8,4
"['101', '100', '0000', '0101', '110', '101001']",1,6,13,10,5,23,8.62063492063492,33,38
"['01', '10100', '100', '011000']",1,4,10,6,0,16,3.615367965367965,17,18
"['0011011', '100', '11111']",1,3,5,10,0,15,1.3166666666666667,12,9
"['000110', '111100', '101', '00011']",1,4,10,10,2,20,3.1616161616161618,21,17
"['0010001', '00101', '110011', '000000', '01110', '01011', '111101']",1,7,21,19,6,40,11.642191142191143,65,56
"['01', '1101110', '00011']",1,3,6,8,0,14,1.5158730158730158,12,7
"['00100', '111100', '010110']",1,3,9,8,2,17,1.9393939393939394,8,11
"['0011011', '10100', '1', '010110']",1,4,9,10,0,19,2.8655511155511157,24,11
"['110000', '1', '10100', '001110', '1100101']",1,5,13,12,2,25,4.63028638028638,39,24
"['11010', '00000', '101010', '101', '011101']",1,5,13,12,4,25,5.596969696969697,29,25
"['00111', '111100', '000001', '1110']",1,4,10,11,2,21,3.090909090909091,22,21
"['011111', '100101', '00101', '0110']",1,4,9,12,2,21,3.621212121212121,16,16
"['101', '00', '10010']",1,3,6,4,0,10,1.7214285714285715,7,5
"['10101', '1', '011110']",1,3,4,8,0,12,0.9826839826839826,13,4
"['0', '001', '10111', '0011', '10100']",1,5,9,9,2,18,5.134920634920634,27,25
"['101', '0010', '1']",1,3,4,4,0,8,1.4714285714285715,7,4
"['11010', '11000', '100', '0011010', '10', '011111', '01011']",1,7,15,18,3,33,12.067549117549117,62,60
"['0', '011', '1110']",1,3,3,5,0,8,1.4714285714285715,7,7
"['1000', '111', '0111']",1,3,4,7,2,11,1.3928571428571428,8,10
"['010', '001', '10110']",1,3,6,5,2,11,1.9166666666666665,7,7
"['01', '100011', '0000000']",1,3,11,4,0,15,1.1837606837606838,14,4
"['0', '11001', '111111', '100000', '0111', '01010']",1,6,12,15,4,27,6.252380952380952,56,34
"['1011001', '0001', '0001101', '1011100', '011110']",1,5,15,16,3,31,6.361038961038961,32,30
"['1000', '0001', '011', '111']",1,4,7,7,4,14,2.845238095238095,14,16
"['0010', '010', '0000']",1,3,9,2,2,11,2.1785714285714284,4,16
"['0101', '010', '000101', '111001']",1,4,10,9,2,19,3.668253968253968,17,17
"['11001', '101100', '0001']",1,3,8,7,0,15,1.793939393939394,9,9
"['01', '010010', '01000']",1,3,9,4,0,13,1.9805194805194803,8,13
"['00', '10011', '01010', '0110110', '1011111']",1,5,11,15,4,26,5.480952380952381,35,20
"['010', '0110111', '000', '11']",1,4,7,8,2,15,2.511111111111111,20,13
"['11110', '100001', '0111011', '0001101', '00', '1101', '1110']",1,7,15,20,4,35,11.695609945609945,70,57
"['0000110', '111', '1000111']",1,3,8,9,2,17,1.7142857142857144,11,8
"['010', '011', '111', '1010111', '00', '0010010', '1100']",1,7,14,15,5,29,11.1988455988456,65,57
"['0', '1110010', '100010', '1111', '11100']",1,5,10,13,0,23,4.811005661005661,35,33
"['011', '000011', '000101', '00', '011010', '101110']",1,6,16,13,4,29,8.9,48,43
"['1', '000', '1101010']",1,3,6,5,0,11,0.85,13,4
"['0011', '1001001', '00010', '1']",1,4,10,7,0,17,3.043939393939394,21,11
"['1010110', '11', '100', '10000', '110111']",1,5,10,13,0,23,5.224136974136974,34,31
"['110', '10001', '10000', '01001', '1100', '0001000']",1,6,19,10,3,29,9.502597402597402,41,42
"['1100', '100111', '01100']",1,3,7,8,0,15,2.0343434343434343,9,8
"['0', '11110', '010101', '111011']",1,4,6,12,2,18,2.6623376623376624,22,13
"['11', '01', '01110', '0110011']",1,4,6,10,2,16,3.198412698412698,20,16
"['101', '1000', '1101110']",1,3,6,8,0,14,1.7168831168831167,10,7
"['11010', '1', '1110']",1,3,3,7,0,10,1.4,8,8
"['00110', '0001', '010']",1,3,8,4,0,12,1.9880952380952381,6,10
"['01101', '1011', '10111', '011010']",1,4,7,13,2,20,4.41010101010101,13,18
"['1000', '10', '01100', '11']",1,4,7,6,2,13,3.3095238095238093,14,12
"['110000', '001000', '100010']",1,3,13,5,3,18,2.1666666666666665,8,9
"['11', '10101', '10001', '10100', '0000', '1011', '1101', '0100']",1,8,17,16,7,33,16.33095238095238,61,84
"['0000101', '1100', '011', '10']",1,4,9,7,0,16,3.046176046176046,21,14
"['1101', '0100000', '1100', '10000']",1,4,13,7,2,20,3.6035353535353534,17,17
"['1100010', '0011', '1001', '10100', '1100101', '10', '011110']",1,7,17,18,4,35,11.859224109224108,68,53
"['0011010', '111', '001000']",1,3,9,7,0,16,1.5914529914529916,11,7
"['011101', '1', '00101', '101101']",1,4,7,11,2,18,3.0108225108225106,20,21
"['111', '11000', '101', '100111', '10']",1,5,7,12,2,19,5.816883116883117,27,36
"['01', '0101111', '0110']",1,3,5,8,0,13,1.6565656565656566,11,9
"['1110010', '1111101', '11011', '01010', '1100', '110101']",1,6,12,22,4,34,10.074658674658675,39,53
"['0100101', '110', '111', '1000111']",1,4,8,12,4,20,3.380952380952381,21,21
"['010', '10011', '010110', '01110', '111001']",1,5,11,14,4,25,6.5368686868686865,29,25
"['1001011', '01100', '01', '01110']",1,4,9,10,2,19,3.3873015873015873,20,14
"['00', '1', '011']",1,3,3,3,0,6,0.9,6,4
"['0111001', '1', '10111', '1010', '1000']",1,5,9,12,2,21,5.002020202020202,34,26
"['10111', '1010100', '00101', '10']",1,4,9,10,2,19,3.5206349206349206,19,17
"['0', '111010', '1001', '1000111', '010011']",1,5,11,13,2,24,5.079470529470529,37,24
"['011', '111', '101000', '0001', '110100', '10', '11100']",1,7,14,15,4,29,11.210894660894661,60,62
"['01', '000101', '1111110', '111011']",1,4,7,14,2,21,2.6452991452991452,25,16
"['0011', '01', '001001', '00']",1,4,9,5,2,14,3.6333333333333333,15,19
"['100101', '1001000', '1']",1,3,8,6,0,14,1.304945054945055,13,12
"['1010110', '001', '110']",1,3,6,7,2,13,1.3333333333333333,11,8
"['11011', '101000', '000001', '011111', '110', '01110']",1,6,14,17,5,31,7.2868686868686865,49,41
"['01101', '00101', '10100', '0111', '0000']",1,5,13,10,5,23,5.805555555555555,22,29
"['001', '100011', '011', '111011']",1,4,7,11,4,18,3.7777777777777777,16,22
"['11010', '0110', '10011']",1,3,6,8,2,14,1.7333333333333334,7,6
"['1111100', '1011001', '0010111', '100110', '10', '0101', '0001000']",1,7,20,20,4,40,11.77021867021867,80,52
"['0111101', '0110', '111101']",1,3,5,12,0,17,2.2503496503496505,7,11
"['1000101', '11', '110', '1110', '0100']",1,5,9,11,2,20,5.482106782106782,28,25
"['0', '1010', '011', '0101100']",1,4,8,7,0,15,3.0487012987012987,20,15
"['1110101', '100010', '111001']",1,3,8,11,2,19,2.2051282051282053,7,12
"['0', '101', '01111', '010111', '1111111']",1,5,5,17,0,22,4.541192141192141,36,31
"['10100', '0100000', '011']",1,3,10,5,0,15,1.5666666666666667,11,8
"['0', '111', '1101000', '000101', '110']",1,5,10,10,2,20,4.252808302808303,37,26
"['0010', '000011', '101', '00', '110']",1,5,11,7,2,18,5.265079365079365,28,25
"['0010101', '01111', '111', '01010']",1,4,8,12,2,20,3.95,16,15
"['01', '010111', '0100110', '1111110']",1,4,8,14,2,22,2.968864468864469,23,20
"['11010', '11011', '1', '0010000']",1,4,9,9,2,18,2.55,24,14
"['0', '11101', '011']",1,3,3,6,0,9,1.3333333333333333,9,5
"['10111', '10100', '1', '011000']",1,4,8,9,2,17,2.825108225108225,22,13
"['0', '1001', '0110', '01110']",1,4,7,7,2,14,2.966666666666667,18,16
"['0', '10111', '100', '001100']",1,4,8,7,0,15,2.831168831168831,20,14
"['110011', '101', '010']",1,3,5,7,2,12,1.7777777777777777,9,4
"['001', '10', '11']",1,3,3,4,2,7,1.3,5,6
"['1111100', '01', '110010', '10110', '1000', '1011']",1,6,12,16,2,28,8.285803085803085,44,40
"['00001', '0110101', '1', '111001']",1,4,9,10,0,19,2.517066267066267,23,18
"['01', '100', '01110']",1,3,5,5,0,10,1.4714285714285715,8,7
"['01111', '010011', '001010', '0111']",1,4,9,12,2,21,3.8464646464646464,14,21
"['1011010', '0001', '1']",1,3,6,6,0,12,1.0136363636363637,13,6
"['0010110', '1000', '0111011', '1101010']",1,4,12,13,3,25,3.779220779220779,21,15
"['101', '1010', '1001', '000001']",1,4,10,7,2,17,3.9087301587301586,15,22
"['0101', '001', '011']",1,3,5,5,2,10,2.095238095238095,3,8
"['11011', '1100', '0101100']",1,3,7,9,0,16,2.0606060606060606,8,10
"['0011', '001', '11']",1,3,4,5,0,9,1.9238095238095236,5,10
"['010100', '1010', '1']",1,3,6,5,0,11,1.4857142857142858,10,4
"['011101', '100', '1100', '011']",1,4,7,9,2,16,3.4730158730158727,17,17
"['1011010', '11011', '101010', '1100101', '1011', '010011']",1,6,14,21,4,35,10.58063048063048,35,60
"['00', '1', '01010']",1,3,5,3,0,8,0.9047619047619047,9,4
"['110000', '10101', '1001', '10110', '010010', '1101']",1,6,15,15,6,30,10.051010101010101,34,41
"['010', '01011', '1011111']",1,3,5,10,0,15,1.8166666666666667,10,7
"['0', '01001', '01100', '1010011']",1,4,10,8,2,18,3.05,22,11
"['011', '1111', '000010', '0000', '01001']",1,5,13,9,2,22,4.667748917748917,29,27
"['01', '1', '0010011']",1,3,5,5,0,10,1.3611111111111112,12,6
"['0', '11110', '110']",1,3,3,6,0,9,1.5833333333333333,8,9
"['1', '1000010', '10010', '000', '001100']",1,5,15,7,0,22,4.726040626040626,36,27
"['11000', '01', '100', '00']",1,4,8,4,2,12,3.307142857142857,13,17
"['010', '110001', '01010']",1,3,8,6,0,14,1.7398989898989898,9,8
"['110', '001011', '0111110']",1,3,6,10,0,16,1.505982905982906,11,9
"['001', '10', '011110']",1,3,5,6,0,11,1.3444444444444446,10,7
"['0010', '011', '101', '00110', '10']",1,5,9,8,2,17,6.386507936507936,20,24
"['010', '1101110', '1010', '00', '1110']",1,5,9,11,2,20,6.227561327561327,25,32
"['011011', '00', '1010010']",1,3,8,7,0,15,1.5598290598290598,12,6
"['001', '1011101', '10110', '110100', '1110001', '011111', '01100']",1,7,16,23,6,39,13.05119325119325,65,57
"['001100', '11000', '1']",1,3,7,5,0,12,1.3463203463203464,12,6
"['0101', '100101', '0111110', '111011']",1,4,8,15,2,23,3.535198135198135,20,14
"['0011', '011010', '1', '0001100']",1,4,10,8,0,18,3.0322177822177823,23,12
"['010', '1', '0100010', '0110000', '011000']",1,5,16,8,2,24,5.701831501831502,35,39
"['1011010', '001', '0111011', '101', '100', '0110', '110111', '01010']",1,8,16,22,5,38,17.36862026862027,80,69
"['110000', '1110010', '001101', '10110', '111011', '000000', '0100']",1,7,22,18,4,40,11.657808857808858,67,61
"['0010', '011', '1111', '00', '110111', '110', '101001']",1,7,11,17,6,28,10.73015873015873,59,57
"['010001', '1100', '1111000', '1111', '10011', '011010', '110']",1,7,15,20,4,35,12.608835608835609,62,62
"['010001', '0110', '1111', '101111', '0110110']",1,5,10,17,4,27,6.085314685314685,30,30
"['010', '1', '00', '100011', '110111']",1,5,8,10,2,18,4.176984126984127,34,18
"['1010', '1101', '1111']",1,3,3,9,3,12,2.0,5,10
"['01', '00100', '1110001', '10', '110']",1,5,10,9,2,19,5.3317460317460315,32,21
"['11110', '100', '001110']",1,3,6,8,0,14,1.6717171717171717,9,10
"['11110', '0010', '000', '1011', '11100', '1110']",1,6,11,14,5,25,8.034126984126983,34,48
"['11001', '0', '10110', '10010', '111101']",1,5,9,13,3,22,5.303896103896104,30,22
"['110011', '1101', '1111']",1,3,3,11,2,14,2.35,5,21
"['0000101', '0101', '01000', '1011000']",1,4,15,8,2,23,3.7012987012987013,19,24
"['110', '1011100', '11111']",1,3,4,11,0,15,1.6,10,8
"['00101', '101', '1111', '011101', '100000', '10011']",1,6,13,16,4,29,8.56839826839827,44,49
"['110111', '11100', '10011', '0101001']",1,4,9,14,2,23,3.8214452214452215,18,20
"['01', '000011', '11']",1,3,5,5,2,10,1.5,9,8
"['0', '10111', '0001', '0011011']",1,4,8,9,0,17,2.63989898989899,22,12
"['1000001', '0010', '100', '01000']",1,4,14,5,0,19,3.80021645021645,17,15
"['111111', '100', '001101', '100010']",1,4,9,12,3,21,2.833333333333333,22,15
"['1000', '010', '11']",1,3,5,4,0,9,1.3047619047619048,7,4
"['01', '0101111', '0111010', '1111101', '00001', '0011']",1,6,13,19,3,32,7.874458874458874,56,40
"['00101', '0011', '10', '0000', '1100']",1,5,12,7,3,19,5.404761904761904,25,31
"['00111', '00', '01100']",1,3,7,5,2,12,1.7428571428571429,9,13
"['01', '101010', '101011', '100', '0011110', '0010100', '111011', '00', '111110', '010111']",1,10,22,29,9,51,24.28821733821734,149,128
"['010', '100101', '0011111', '10011', '0101']",1,5,11,14,0,25,6.627072927072927,30,27
"['11101', '111100', '101111']",1,3,4,13,2,17,2.121212121212121,7,15
"['101', '0111111', '001', '001111']",1,4,6,13,2,19,3.347008547008547,20,18
"['0100000', '10', '000', '1011', '110', '011000']",1,6,16,9,2,25,8.067787767787769,47,44
"['110011', '01', '00101', '0110001']",1,4,10,10,0,20,3.5123765123765125,20,16
"['0', '1011010', '010000']",1,3,9,5,0,14,0.9972527472527473,14,8
"['0011011', '1000', '11111']",1,3,6,10,0,16,1.4343434343434343,12,9
"['001101', '00001', '10001', '100', '10011', '11111']",1,6,14,15,4,29,8.258080808080807,39,52
"['0000100', '0011100', '001101', '00', '001010', '1100', '01100']",1,7,24,13,4,37,13.35020535020535,59,117
"['100', '1', '101001', '01110']",1,4,7,8,0,15,2.6493506493506493,21,11
"['11000', '01', '1001']",1,3,6,5,0,11,1.619047619047619,8,7
"['01', '11', '0011', '101', '001001']",1,5,8,9,2,17,6.4714285714285715,22,29
"['010000', '1110000', '110100', '1011', '0101', '01110']",1,6,17,15,4,32,8.973310023310024,46,41
"['00100', '0001', '1110011', '000', '11111', '0011100']",1,6,16,15,4,31,8.167893217893218,51,54
"['001', '111110', '0110', '000']",1,4,8,8,2,16,2.8539682539682536,18,18
"['0001', '1111101', '0010100', '1111']",1,4,9,13,4,22,2.6785714285714284,23,19
"['1000100', '0100011', '000', '11']",1,4,12,7,2,19,2.803174603174603,24,14
"['0001', '0010', '110', '1']",1,4,7,5,2,12,2.907142857142857,15,12
"['011111', '0011', '0010', '1']",1,4,6,9,2,15,2.835714285714286,19,13
"['00100', '11110', '0111111', '001011']",1,4,9,14,2,23,2.9524475524475524,20,21
"['1011110', '01', '0']",1,3,4,6,0,10,1.3611111111111112,12,6
"['01', '11', '100010', '10011', '1001011']",1,5,10,12,2,22,5.861582861582861,31,39
"['0011000', '10001', '010111', '10', '1110110', '0111101', '1111111']",1,7,15,26,4,41,11.051559551559551,79,54
"['0', '0001', '1110010', '11']",1,4,7,7,0,14,1.9732323232323232,23,12
"['1101001', '1100110', '110', '001011', '0100101']",1,5,14,16,3,30,6.1873015873015875,35,32
"['100', '1', '10']",1,3,3,3,0,6,1.9666666666666668,4,7
"['01', '1000000', '00']",1,3,9,2,2,11,1.1666666666666665,12,8
"['0101000', '10111', '101', '100', '1101']",1,5,10,12,2,22,6.257359307359307,27,28
"['0100010', '0001010', '1', '111010']",1,4,12,9,2,21,2.576923076923077,25,17
"['01', '0100', '11']",1,3,4,4,2,8,1.5,6,5
"['0110101', '1001111', '11']",1,3,5,11,2,16,1.6031746031746033,14,10
"['001101', '100', '1000011', '0000110', '101001']",1,5,17,12,4,29,6.083638583638583,33,26
"['01', '00110', '100101', '000']",1,4,10,6,0,16,3.615367965367965,17,13
"['0010001', '1110000', '1000010', '11']",1,4,14,9,3,23,3.1904761904761902,24,15
"['0100111', '01111', '010110']",1,3,7,11,0,18,1.9813519813519813,6,12
"['0', '10111', '00001', '1001101']",1,4,9,9,2,18,2.3166666666666664,22,12
"['11000', '000101', '00011']",1,3,10,6,2,16,2.0545454545454547,9,14
"['101100', '00111', '101', '1010', '0000', '0100']",1,6,15,11,3,26,8.50974025974026,36,44
"['01', '00110', '0']",1,3,5,3,0,8,1.5714285714285714,8,8
['001010'],1,1,4,2,0,6,0,0,0
"['00', '001', '0010']",1,3,7,2,0,9,2.3238095238095235,4,14
"['1000', '01101', '0011000', '00000']",1,4,15,6,2,21,3.405050505050505,16,28
"['100110', '100011', '1']",1,3,6,7,2,13,1.4047619047619047,12,10
"['0001001', '0110111', '111', '1100000', '1011', '011010', '1100', '01011']",1,8,20,23,5,43,16.49047619047619,92,90
"['0001101', '0110', '10110']",1,3,8,8,0,16,2.282828282828283,7,9
"['1111100', '101100', '11010', '101', '000001', '011111', '0000110', '01110']",1,8,21,24,7,45,15.447646797646797,97,80
"['10001', '010', '010111']",1,3,7,7,0,14,1.712121212121212,9,6
"['101011', '01', '1100', '1110']",1,4,6,10,2,16,2.9166666666666665,17,15
"['0110100', '00000', '00100', '10011', '1011', '1110']",1,6,17,13,5,30,7.724242424242424,43,41
"['010001', '11', '0001111', '0101010', '00', '1111010']",1,6,15,16,5,31,7.227106227106227,60,42
"['010', '1', '110111']",1,3,3,7,0,10,1.2301587301587302,11,4
"['00000', '101010', '1111010', '0111', '011111']",1,5,12,16,2,28,5.112898212898213,35,33
"['111', '011100', '110011', '0111', '1110110', '0101']",1,6,10,20,4,30,10.007942057942058,42,51
"['011101', '0011', '01101', '0']",1,4,7,9,0,16,3.1948051948051948,18,17
"['1000', '100011', '011']",1,3,7,6,0,13,1.7523809523809524,8,11
"['1110110', '1001', '1111001', '10', '00010']",1,5,11,14,2,25,5.613997113997113,36,27
"['00', '0101', '1', '0100101']",1,4,8,6,0,14,2.4883838383838386,21,15
"['00', '100', '10']",1,3,5,2,2,7,2.1,3,9
"['0011011', '01001', '001', '1']",1,4,8,8,0,16,2.933333333333333,21,16
"['0110111', '00000', '0001', '1001', '100', '010101', '100101', '01011']",1,8,22,18,6,40,16.806621156621155,73,83
"['010000', '10', '000']",1,3,9,2,0,11,1.5666666666666667,9,12
"['101', '100', '111011', '000', '0111', '111101']",1,6,9,16,5,25,7.5095238095238095,44,43
"['1110101', '11011', '1001', '0111']",1,4,6,14,2,20,3.9393939393939394,16,25
"['101', '01001', '01101', '00100']",1,4,10,8,3,18,4.2,12,15
"['101', '1100', '0100']",1,3,6,5,2,11,1.8928571428571428,5,6
"['00111', '0000110', '11101', '1']",1,4,8,10,2,18,2.683333333333333,25,13
"['10001', '1', '0100']",1,3,6,4,0,10,1.4,10,4
"['1', '10010', '1011000', '011010', '1100']",1,5,12,11,0,23,5.626157176157176,32,22
"['001100', '1010', '0010111']",1,3,9,8,0,17,1.760839160839161,10,9
"['11001', '1101', '1110000', '1110']",1,4,8,12,2,20,4.244949494949495,15,24
"['00010', '00', '110', '101001']",1,4,10,6,0,16,3.1431457431457432,18,13
"['01', '001', '000', '11100', '001011', '110101']",1,6,13,12,4,25,8.132178932178933,45,44
"['1010111', '00010', '00']",1,3,8,6,0,14,1.5158730158730158,12,6
"['0', '101', '0111']",1,3,3,5,0,8,1.4714285714285715,7,4
"['0011011', '1111010', '1']",1,3,5,10,2,15,1.0714285714285714,15,7
"['00101', '001101', '111101']",1,3,7,10,2,17,2.121212121212121,6,15
"['0', '10111', '0101111', '101']",1,4,5,11,0,16,3.2666666666666666,20,14
['0100010'],1,1,5,2,0,7,0,0,0
"['0010110', '010', '1', '0001', '10000', '00110', '001010']",1,7,20,11,2,31,11.946886446886447,61,71
"['0001', '1', '00001']",1,3,7,3,0,10,1.6222222222222222,8,11
"['1000', '111101', '0011100']",1,3,8,9,0,17,1.5608391608391607,11,6
"['110000', '101000', '1111', '10', '110111']",1,5,10,14,3,24,5.066666666666666,34,36
"['1100001', '1101', '1010101', '10101']",1,4,10,13,2,23,4.010822510822511,15,41
"['00000', '100', '1010', '0111', '011001', '1100011', '0101']",1,7,18,15,3,33,12.061294261294261,62,50
"['10100', '00', '1', '0000010']",1,4,11,4,0,15,2.0992063492063493,24,15
"['1', '00101', '00100', '000', '1100110']",1,5,13,8,2,21,5.15,33,28
"['0101', '100', '0110111', '1']",1,4,6,9,0,15,2.8487012987012985,21,13
"['0001000', '1001111', '000']",1,3,11,6,2,17,1.4285714285714286,13,12
"['00010', '110', '0011010']",1,3,9,6,0,15,1.7666666666666666,9,13
"['010', '011', '0111110']",1,3,5,8,2,13,1.8666666666666667,9,13
"['01', '0001', '01010', '1011', '0111101']",1,5,10,12,2,22,5.536075036075036,29,24
"['01011', '11110', '011', '111101']",1,4,5,14,2,19,3.548989898989899,16,23
"['01101', '0101', '10011', '1111']",1,4,6,12,4,18,3.7666666666666666,13,19
"['0100110', '111010', '01010']",1,3,9,9,0,18,2.0221445221445222,7,15
"['11001', '010000', '1', '0110100', '1100101', '0010010', '01100']",1,7,22,16,5,38,12.097452547452548,71,53
"['0110101', '11110', '11011', '111100', '100010', '00110', '010111', '010110', '000', '01000']",1,10,26,28,8,54,27.02921522921523,126,140
"['101', '1010110', '000100']",1,3,9,7,0,16,1.6598290598290597,11,6
"['111', '101011', '1000', '100000', '1101', '1110']",1,6,12,15,5,27,8.116666666666667,40,54
"['0011011', '1011', '0110', '1110']",1,4,7,12,3,19,4.0,15,17
"['11', '10001', '10', '000010', '000']",1,5,12,6,2,18,4.936796536796537,28,22
"['00', '1010', '100101', '1011000', '1011']",1,5,12,11,2,23,5.964374514374514,28,30
"['110000', '101100', '1101001', '0', '101']",1,5,12,11,2,23,5.237667887667888,37,24
"['1', '101', '1110011', '100000', '1110100']",1,5,11,13,2,24,4.567521367521367,41,32
"['010', '11', '0001', '100', '0000000', '0110011']",1,6,17,9,4,26,6.945743145743146,54,38
"['000110', '0001', '1', '110100']",1,4,10,7,2,17,2.6714285714285717,22,15
"['1111010', '100111', '111']",1,3,4,12,0,16,1.7282051282051283,11,18
"['11', '0110', '00', '001001', '0100']",1,5,11,7,4,18,5.483333333333333,25,26
"['11110', '010001', '0101101', '0001100', '001110']",1,5,16,15,4,31,6.394938394938395,30,30
"['010101', '0110', '111', '0111']",1,4,6,11,2,17,4.445238095238095,11,18
"['010', '0011', '10111', '110111', '110']",1,5,7,14,2,21,6.096392496392496,25,32
"['0', '1001001', '111']",1,3,5,6,0,11,0.85,13,4
"['11000', '000101', '100000']",1,3,12,5,2,17,1.9393939393939394,9,12
"['11', '01', '111011']",1,3,2,8,2,10,1.5,9,12
"['0', '111111', '01111', '01']",1,4,3,11,0,14,2.5487012987012987,21,17
"['0', '1010', '001111', '00011']",1,4,8,8,0,16,2.5907647907647906,21,14
"['110000', '01101', '10010', '1101', '101110', '0100']",1,6,15,15,6,30,9.616161616161616,40,37
"['0', '101000', '110100', '100101', '010011', '1110']",1,6,15,14,4,29,7.5095238095238095,51,33
"['01', '100', '111']",1,3,3,5,2,8,1.1333333333333333,6,6
"['110101', '1100', '11']",1,3,4,8,0,12,1.9666666666666668,8,14
"['0011', '101110', '01010']",1,3,7,8,0,15,1.993939393939394,7,7
"['01', '100', '1010011']",1,3,6,6,0,12,1.4444444444444444,11,7
"['1011110', '100', '11']",1,3,4,8,0,12,1.4444444444444444,11,7
"['01000', '11011', '1111101', '0110001']",1,4,10,14,4,24,3.4714285714285715,19,14
"['0100000', '1101000', '100', '000', '1110']",1,5,16,8,4,24,5.547186147186147,32,37
"['00', '1001', '001110', '1101']",1,4,8,8,2,16,3.4499999999999997,18,11
"['0010', '0100110', '1101111', '0011', '0110', '0000000', '1011']",1,7,20,17,7,37,11.938311688311689,69,58
"['01', '00110', '011110', '11111', '000', '0110110']",1,6,12,16,2,28,8.106987456987458,46,47
"['0100', '1110', '11']",1,3,4,6,2,10,1.5,7,6
"['010', '1', '011']",1,3,3,4,2,7,1.6666666666666665,5,5
"['1101101', '0010100', '1000010', '100111', '110']",1,5,15,15,3,30,5.5587301587301585,36,25
"['00000', '0110', '000001', '1001011', '1100', '111101']",1,6,18,14,4,32,7.730963480963481,50,41
"['011101', '110', '0000011', '111']",1,4,8,11,2,19,3.2615384615384615,22,17
"['101000', '01101', '000']",1,3,9,5,0,14,1.712121212121212,9,10
"['011101', '00110', '1000', '110']",1,4,9,9,0,18,3.782034632034632,16,15
"['101', '010', '0100101', '11']",1,4,7,8,2,15,3.511111111111111,18,14
"['0111', '01111', '1110', '101101']",1,4,5,14,2,19,4.6328282828282825,11,21
"['01', '1001', '100111', '111000']",1,4,8,10,2,18,3.3166666666666664,21,20
"['110001', '1000', '01010', '1101', '0011100']",1,5,14,12,2,26,6.351748251748251,28,21
"['0001', '11011', '1111110']",1,3,5,11,0,16,1.1262626262626263,12,8
"['10001', '0001', '1010101']",1,3,9,7,0,16,1.9191919191919191,6,14
"['100001', '00100', '1001000', '0111', '0001000']",1,5,20,9,2,29,5.871750471750472,30,33
"['11001', '01101', '000111', '11111']",1,4,7,14,3,21,3.8181818181818183,16,22
"['0', '1011', '100', '01111']",1,4,5,8,0,13,2.7214285714285715,17,12
"['0011', '10111', '01001', '10']",1,4,7,9,2,16,3.4095238095238094,16,14
"['0110000', '1001010', '0110011']",1,3,12,9,3,21,2.142857142857143,10,10
"['01101', '001', '100110', '10100', '001100', '0110110']",1,6,17,15,4,32,9.778554778554778,39,48
"['0111000', '0010', '001', '00101', '00000', '001110', '01010', '1011', '1101']",1,9,25,18,6,43,21.972261072261073,95,113
"['010', '001101', '1000110', '10101', '0111']",1,5,12,13,0,25,6.5815684315684315,27,23
"['111', '0011000', '11000', '1001', '1000010', '0000', '0001011']",1,7,23,14,5,37,11.78008658008658,69,69
"['1100', '01010', '1011111']",1,3,6,10,0,16,1.5303030303030303,11,5
"['1000100', '010', '11011']",1,3,8,7,0,15,1.6,11,4
"['011111', '111111', '010', '0110100']",1,4,7,15,2,22,3.176923076923077,21,22
"['1101101', '1100', '01111', '01110']",1,4,7,14,2,21,3.805050505050505,15,17
"['0', '0011011', '000111', '001']",1,4,9,8,0,17,3.0716117216117214,22,17
"['1111100', '010', '111100', '01110']",1,4,8,13,0,21,3.9114607614607615,17,24
"['110010', '1', '0111011', '00011', '1010']",1,5,10,13,0,23,4.71978576978577,36,26
"['011011', '1001', '1110100', '11']",1,4,7,12,0,19,3.171950271950272,21,19
"['1', '0100010', '1001', '1010', '001010']",1,5,13,9,2,22,5.373826173826174,32,24
"['0010', '111', '1101']",1,3,4,7,2,11,1.6428571428571428,7,6
"['00', '1010101', '10101']",1,3,7,7,0,14,1.8492063492063493,10,12
"['1100001', '001', '0110011']",1,3,9,8,2,17,1.9142857142857141,11,9
"['101000', '0110', '0100']",1,3,9,5,2,14,1.9500000000000002,6,10
"['0', '110', '1111']",1,3,2,6,0,8,1.0714285714285714,8,6
"['010', '001', '0010100', '1111', '111110', '100101']",1,6,13,16,4,29,7.611988011988012,52,37
"['1', '1010100', '0101011', '00', '1110']",1,5,10,11,2,21,3.5637806637806637,40,21
"['010001', '11100', '011', '11']",1,4,7,9,0,16,3.5835497835497834,17,18
"['0011101', '000010', '11']",1,3,8,7,0,15,1.3098290598290598,13,5
"['0', '0010110', '111110', '01010', '0111', '001001']",1,6,14,15,2,29,7.609074259074259,52,46
"['011', '11', '10110', '00110', '01011']",1,5,8,12,3,20,7.164285714285715,21,28
"['1100111', '1011011', '0010', '010']",1,4,9,12,2,21,3.2805194805194806,21,12
"['0', '110001', '100111', '100']",1,4,8,8,2,16,3.071428571428571,21,13
"['010', '111111', '00', '000010', '1011']",1,5,10,11,2,21,4.06031746031746,36,22
"['00001', '10011', '01010', '0000', '011010', '1100']",1,6,18,11,5,29,9.095959595959595,36,44
"['01', '011011', '1101100', '100000', '1101', '01100']",1,6,15,15,2,30,8.696642246642247,48,45
"['0010110', '010', '010001', '1011001', '11', '1001000', '000001']",1,7,23,15,5,38,11.766239316239316,73,53
"['1', '100', '000001', '0111', '01010']",1,5,11,8,0,19,4.42950937950938,32,20
"['00111', '100011', '1', '0000']",1,4,9,7,0,16,2.390764790764791,21,13
"['001000', '011101', '10', '1011', '00010']",1,5,13,10,2,23,5.455266955266955,31,23
"['0', '010110', '110100', '11']",1,4,7,8,2,15,2.238095238095238,22,12
"['0', '1011', '0100001', '1111']",1,4,7,9,2,16,2.059090909090909,23,12
"['0011', '0110', '1111', '00', '10']",1,5,7,9,5,16,4.916666666666666,23,23
"['0001', '110', '1111101', '101111']",1,4,6,14,0,20,2.7091797091797094,22,20
"['1011', '00', '0001']",1,3,6,4,2,10,1.5,7,6
"['1011', '0010000', '01110']",1,3,9,7,0,16,1.5303030303030303,12,4
"['010', '111110', '1', '0111100']",1,4,6,11,0,17,2.8493894993894995,23,12
"['0111001', '111101', '010101', '0111', '01010', '00010', '110', '01000', '1111011']",1,9,21,27,7,48,21.52324342324342,100,110
"['1001001', '01', '1', '000011']",1,4,9,7,0,16,2.762210012210012,24,15
"['01', '0010', '11', '101010', '10010']",1,5,10,9,2,19,5.859018759018759,24,26
"['111100', '0001', '1110011', '0001100', '10']",1,5,13,13,2,26,5.350993450993451,40,30
"['00110', '111000', '01100', '11']",1,4,9,9,2,18,3.7155844155844155,18,15
"['0101101', '11000', '10001', '0110']",1,4,11,10,2,21,3.4717171717171715,19,12
"['011', '1100001', '10101', '0001', '0111']",1,5,11,12,2,23,6.129076479076479,27,32
"['0', '0111010', '1010100', '10000', '1101']",1,5,13,11,2,24,4.521933621933622,37,20
"['100', '110', '111', '1010010']",1,4,7,9,3,16,3.2666666666666666,16,16
"['0101110', '11', '1101011', '10100', '1101010']",1,5,11,17,3,28,6.357142857142857,32,31
"['101100', '00101', '111', '0101101', '00', '0100']",1,6,14,13,0,27,8.187989787989787,44,42
"['00', '100', '0111011']",1,3,6,6,0,12,1.6444444444444444,11,8
"['1010011', '10', '11']",1,3,4,7,2,11,1.3888888888888888,11,11
"['0001011', '00010', '0000111', '0011000']",1,4,17,9,3,26,3.857142857142857,18,32
"['001', '1001010', '101', '0110', '1101', '111000']",1,6,13,14,4,27,8.983277833277834,42,36
"['01101', '1', '00101', '001000', '00']",1,5,12,7,2,19,4.667965367965368,31,30
"['000110', '1', '00100', '0001', '0101']",1,5,13,7,2,20,5.379653679653679,27,26
"['1010010', '0110', '0100110', '000']",1,4,13,8,2,21,3.7194805194805194,18,24
"['100011', '1', '1111110']",1,3,4,10,0,14,0.8434065934065934,15,9
"['01101', '01111', '0000111', '001100', '0101']",1,5,13,14,2,27,6.722455322455322,27,30
"['01', '10001', '11']",1,3,4,5,2,9,1.6428571428571428,7,9
"['00111', '111000', '0110']",1,3,7,8,0,15,1.812121212121212,10,9
"['01', '1110011', '01010', '1100011', '110', '1001111']",1,6,12,19,3,31,8.19047619047619,55,49
"['110011', '01', '111', '1110']",1,4,4,11,0,15,3.357142857142857,16,24
"['00', '1101', '00011']",1,3,6,5,0,11,1.349206349206349,9,7
"['010000', '00101', '101010', '110001', '100011']",1,5,17,12,4,29,6.712121212121212,26,22
"['11001', '01101', '010111', '01001', '011010', '1110']",1,6,13,18,5,31,10.05959595959596,32,48
"['00011', '001111', '011000', '11111']",1,4,9,13,4,22,3.2636363636363637,19,23
"['1000010', '111010', '001010', '10']",1,4,12,9,2,21,3.341880341880342,20,23
"['010', '1110000', '01010', '0000']",1,4,13,6,0,19,3.615367965367965,18,28
"['01', '101011', '100', '001110', '01010', '01000']",1,6,15,12,4,27,9.166089466089465,41,39
"['000110', '101', '0001010', '1101', '0100']",1,5,14,10,2,24,6.168820068820069,28,24
"['100110', '11110', '010', '1111']",1,4,6,12,0,18,3.2463203463203465,15,20
"['0', '100', '0110001']",1,3,7,4,0,11,1.35,12,6
"['0', '110000', '100', '100101']",1,4,10,6,2,16,3.071428571428571,21,13
"['0110010', '1001', '10']",1,3,7,6,0,13,1.8383838383838382,10,6
"['1110000', '100', '00', '10100', '011110', '1011011']",1,6,15,15,2,30,8.807775557775557,52,43
"['11110', '00010', '0100']",1,3,8,6,2,14,1.511111111111111,8,10
"['11110', '01', '00001', '0001', '1000', '1011']",1,6,13,11,5,24,7.584920634920635,40,43
"['10111', '0101', '1', '1100101']",1,4,6,11,0,17,2.8772727272727274,21,22
"['0', '1010', '1101', '0111']",1,4,5,8,3,13,3.2,16,11
"['0011001', '0101', '1100100', '11111']",1,4,10,13,2,23,3.4314574314574315,22,16
"['110110', '11', '0001', '10000', '1101110', '000', '01100']",1,7,17,15,2,32,10.923726273726274,67,64
"['11', '100', '0110', '100110', '0111']",1,5,8,11,2,19,5.907142857142857,24,27
"['1001', '110', '11']",1,3,3,6,0,9,2.038095238095238,5,10
"['1111010', '001', '01000']",1,3,8,7,0,15,1.4,12,7
"['110001', '0100110', '0110']",1,3,9,8,0,17,1.7888111888111888,10,8
"['0100010', '101', '1001', '0']",1,4,9,6,0,15,3.1344155844155845,19,10
"['1110010', '11', '110001', '00', '10']",1,5,9,10,3,19,4.602564102564102,33,24
"['000100', '110', '1', '001000']",1,4,11,5,2,16,2.7936507936507935,22,15
"['1110111', '010', '010000', '001101', '101']",1,5,12,13,4,25,5.534188034188034,37,21
"['00', '100000', '011', '11']",1,4,8,5,2,13,2.1722222222222225,19,14
"['10100', '01', '1']",1,3,4,4,0,8,1.5714285714285714,8,6
"['00', '1110000', '0011111']",1,3,8,8,2,16,1.3174603174603174,16,13
"['011', '10001', '10100', '00', '1100', '01000']",1,6,15,9,3,24,9.274603174603174,36,41
"['101000', '101', '10', '0000']",1,4,10,5,0,15,3.1857142857142855,16,18
"['0010110', '111100', '111']",1,3,6,10,0,16,1.682051282051282,11,9
"['01', '110001', '1101000', '11']",1,4,8,9,2,17,3.158119658119658,21,21
"['0', '000111', '100']",1,3,6,4,0,10,1.2301587301587302,11,7
"['0100000', '100', '00', '111010']",1,4,12,6,0,18,3.4726495726495727,21,19
"['1000000', '000100', '01000']",1,3,15,3,0,18,1.8554778554778555,7,16
"['0110000', '1', '1111110']",1,3,6,9,2,15,0.9285714285714286,16,4
"['101000', '01', '001101']",1,3,8,6,2,14,1.5,11,8
"['101011', '0010111', '0000']",1,3,9,8,0,17,1.7146853146853147,10,7
"['010001', '11', '010101', '10', '001100', '01001']",1,6,15,12,5,27,9.173160173160174,43,39
"['00', '0100110', '1111000', '1']",1,4,9,8,2,17,1.9603174603174602,29,12
"['11010', '0101011', '0001101', '1000011', '001100', '00010', '000111', '111001']",1,8,26,23,8,49,17.946153846153845,85,83
"['0001', '0101', '11100']",1,3,7,6,2,13,1.3888888888888888,8,8
"['0010', '1', '101000', '1100011', '1101']",1,5,11,11,2,22,5.077672327672328,36,24
"['11011', '1110000', '00011', '101', '1111000', '01010', '1100111', '110']",1,8,18,24,8,42,16.416666666666668,95,96
"['01', '0101110', '011', '110001', '0110001']",1,5,12,13,2,25,5.789377289377289,36,33
"['01', '00110', '1010', '001001', '110']",1,5,11,9,0,20,5.8979076479076475,25,27
"['0010', '111', '01110']",1,3,5,7,0,12,1.7023809523809523,7,5
"['111000', '100', '1']",1,3,5,5,0,10,1.4523809523809523,10,7
"['0011001', '01', '1110', '11']",1,4,6,9,2,15,2.9343434343434343,20,15
"['0000', '10100', '001', '11111']",1,4,9,8,2,17,2.1658730158730157,19,15
"['1010', '100', '000']",1,3,7,3,2,10,2.095238095238095,4,9
"['0011110', '0110', '1010100', '001010', '0001011', '0100']",1,6,20,15,5,35,9.865484515484516,42,60
"['100100', '011', '10', '000']",1,4,9,5,2,14,2.7444444444444445,17,15
"['00', '1001', '01111', '10']",1,4,6,7,2,13,2.849206349206349,16,11
"['101', '1100000', '1111', '100110', '00', '001010']",1,6,15,13,2,28,7.069252969252969,53,35
"['11010', '01101', '1', '00100', '010010']",1,5,12,10,3,22,5.285714285714286,31,21
"['1101011', '0110', '0110011']",1,3,7,11,2,18,2.1298701298701297,9,10
"['111111', '001010', '110111']",1,3,5,13,3,18,1.3333333333333333,9,10
"['0011', '001', '0111']",1,3,5,6,2,11,2.1785714285714284,4,9
"['0010', '1000', '1']",1,3,6,3,2,9,1.55,8,5
"['11', '1001', '110001', '0001111', '11101']",1,5,9,15,0,24,6.203984903984904,33,46
"['010', '101', '100111', '11111', '01110']",1,5,7,15,4,22,5.650505050505051,28,23
"['010100', '001101', '00101', '00011', '1111', '10', '110']",1,7,15,16,4,31,11.937662337662337,60,55
"['01', '001', '01011', '0100100']",1,4,10,7,0,17,3.5825396825396822,18,18
"['011', '00000', '1001', '000111', '1011011', '01011']",1,6,15,15,2,30,8.564590964590964,44,44
"['0', '010100', '10011']",1,3,7,5,0,12,1.1645021645021645,13,4
"['000001', '0100110', '101110', '1111']",1,4,11,12,2,23,2.8815850815850816,21,12
"['101', '100', '100111', '1111']",1,4,5,11,2,16,3.457142857142857,14,26
"['0110000', '0101111', '001', '101111']",1,4,10,13,2,23,3.057631257631258,24,17
"['1000', '1010101', '1']",1,3,6,6,0,12,1.3772727272727274,12,9
"['110010', '11010', '0110000', '1000000', '110', '0110001']",1,6,21,14,3,35,10.055794205794205,45,48
"['11100', '10011', '1111110']",1,3,5,12,2,17,1.5999999999999999,11,10
"['111000', '1', '10011']",1,3,5,7,0,12,1.1645021645021645,13,9
"['11', '101010', '00', '100000', '00010']",1,5,14,7,4,21,4.546536796536796,32,27
"['101011', '1011001', '1', '101101']",1,4,7,13,2,20,3.0265567765567765,21,33
"['1', '0100110', '101', '0110010', '0101']",1,5,11,11,2,22,5.387012987012987,34,23
"['0111101', '001', '10', '11']",1,4,5,9,2,14,2.588888888888889,19,13
"['0', '10100', '100', '1100011']",1,4,9,7,0,16,3.1,22,13
"['011', '1010100', '1001', '0001100', '111111', '1100011']",1,6,15,19,3,34,8.418670218670218,55,43
"['00', '111001', '11']",1,3,4,6,2,10,1.0,10,6
"['0', '001010', '0011111', '0111101', '0100']",1,5,12,13,2,25,4.9827172827172825,39,31
"['1111001', '01', '111000', '10']",1,4,7,10,2,17,2.908119658119658,23,15
"['0101111', '000110', '010000', '0100']",1,4,14,9,2,23,3.489044289044289,19,29
"['0001001', '01111', '01010', '11']",1,4,9,10,2,19,3.3539682539682536,20,13
"['011100', '101', '011101', '110', '01011']",1,5,9,14,4,23,6.2853535353535355,26,27
"['01', '0001', '1000', '001']",1,4,9,4,2,13,3.9785714285714286,11,20
"['0100110', '01011', '1101100']",1,3,9,10,2,19,2.2142857142857144,8,9
"['1111100', '0101', '10', '0111']",1,4,6,11,2,17,3.1035353535353534,20,15
"['110000', '001', '10111', '10101', '101', '010011']",1,6,13,15,6,28,9.052525252525253,40,50
"['01111', '1', '0011100']",1,3,5,8,0,13,1.25,13,4
"['0010110', '11', '011101', '10010', '01100']",1,5,12,13,2,25,5.908746808746809,33,22
"['01', '1101', '00', '10']",1,4,5,5,3,10,3.1666666666666665,11,11
"['00', '100100', '100011', '011']",1,4,10,7,2,17,3.1777777777777776,20,16
"['00', '1101101', '110111', '01010']",1,4,8,12,0,20,3.401071151071151,20,13
"['1101001', '0111001', '001', '00011', '101', '100', '010010', '1111']",1,8,18,20,5,38,16.88139083139083,84,76
"['0011', '1001', '0110', '1111110', '00']",1,5,9,12,3,21,5.494949494949495,33,23
"['00110', '100', '0001', '1110']",1,4,9,7,2,16,3.2261904761904763,15,17
"['1101', '01101', '000001', '101101']",1,4,10,11,2,21,3.694949494949495,14,27
"['0', '11011', '101101', '00001', '10001', '0011110', '000101', '110111']",1,8,19,22,6,41,14.722993672993674,91,75
"['001010', '000101', '1111101']",1,3,9,10,2,19,1.7564102564102564,10,7
"['0', '0111000', '0011000', '0101', '101001']",1,5,15,10,2,25,5.010689310689311,37,27
"['010001', '0110', '110']",1,3,7,6,0,13,1.9015873015873015,8,9
"['1001001', '1', '000', '1111011']",1,4,8,10,2,18,1.8714285714285714,28,12
"['11001', '001000', '101010', '10111', '110001', '0110', '111110', '1011011']",1,8,19,26,6,45,16.897902097902097,79,80
"['11011', '00001', '100011', '00010', '110', '0100']",1,6,16,12,3,28,8.453246753246754,40,38
"['11', '000000', '101101']",1,3,8,6,2,14,0.8333333333333333,14,4
"['0111000', '1100', '1', '0100']",1,4,9,7,2,16,3.254545454545455,19,15
"['101000', '010', '010000', '1001']",1,4,13,6,2,19,3.938095238095238,17,15
"['1001011', '00', '101111']",1,3,6,9,0,15,1.3098290598290598,12,6
"['11110', '01111', '110101']",1,3,4,12,2,16,1.8909090909090909,7,11
"['0011001', '00', '01011', '1110']",1,4,9,9,0,18,3.0057720057720054,21,15
"['1001100', '001010', '0011111']",1,3,10,10,2,20,1.9560439560439562,10,10
"['11010', '111100', '0110100', '011011', '1010101', '00', '10010', '0001011', '1100']",1,9,24,25,7,49,21.975835275835276,108,108
"['0000101', '00', '0100']",1,3,10,3,0,13,1.6565656565656566,11,13
"['011', '101', '00', '111111', '00010']",1,5,8,11,2,19,4.108802308802309,34,20
"['11', '1011100', '10011', '000100', '01000']",1,5,14,11,2,25,5.373032523032522,34,26
"['110011', '1010010', '1']",1,3,6,8,0,14,1.304945054945055,13,8
"['00', '011', '111']",1,3,3,5,2,8,1.0666666666666667,6,6
"['0', '01000', '1110', '00011']",1,4,9,6,2,15,2.5555555555555554,21,17
"['011', '00100', '1011101', '10001', '0101011', '10100', '10', '0101001']",1,8,21,20,6,41,17.057142857142857,85,77
"['0', '1110001', '0000110']",1,3,9,6,2,15,1.0714285714285714,17,4
"['1101001', '1000', '11']",1,3,6,7,0,13,1.323232323232323,11,10
"['0000110', '010010', '1', '011001']",1,4,12,8,2,20,3.0393772893772892,24,12
"['0', '1001', '00001', '111011']",1,4,8,8,0,16,2.6493506493506493,21,12
"['001', '0101', '100', '11']",1,4,6,6,2,12,3.276190476190476,11,14
"['011', '001000', '10111', '0001100', '1101']",1,5,13,12,0,25,5.610861360861361,32,24
"['1011', '10001', '10010', '1']",1,4,7,8,2,15,3.2,17,22
"['0010100', '0011111', '11']",1,3,7,9,2,16,1.4603174603174602,13,9
"['1000010', '000110', '0']",1,3,10,4,0,14,1.304945054945055,13,9
"['00', '1', '101110']",1,3,4,5,0,9,0.7857142857142857,11,4
"['0', '1010100', '1110', '100010']",1,4,10,8,0,18,2.3147352647352646,22,14
"['0001', '1010', '11111', '110', '1001011']",1,5,9,14,2,23,4.348051948051948,30,29
"['001', '0011', '0000101', '001110', '0011111', '0111']",1,6,15,16,4,31,10.328554778554778,40,55
"['1001', '1', '0011010']",1,3,6,6,0,12,1.1954545454545453,13,4
"['110110', '001', '111', '0010011', '10', '000000', '000001', '000100', '01011']",1,9,27,17,6,44,17.777411477411476,119,112
"['01', '111000', '1101011', '0100']",1,4,9,10,0,19,3.121950271950272,22,14
"['0010', '111', '0100010', '00110', '10010', '1100']",1,6,16,12,4,28,9.440981240981241,40,48
"['101111', '1101101', '1000111']",1,3,6,14,2,20,2.2527472527472527,7,17
"['0101110', '000101', '001010']",1,3,11,8,2,19,2.217948717948718,7,10
"['0', '11010', '0101', '100011']",1,4,8,8,0,16,2.6493506493506493,20,11
"['0001111', '000001', '1001101']",1,3,11,9,2,20,1.7912087912087913,8,9
"['10101', '1010100', '1111101', '0010011']",1,4,11,15,3,26,3.4285714285714284,20,22
"['010', '011', '101', '10100', '10010', '01100']",1,6,13,11,6,24,10.2,33,40
"['01111', '011', '00011']",1,3,5,8,2,13,2.1,6,12
"['111010', '101', '000101', '01010', '110']",1,5,11,12,4,23,6.315656565656566,27,26
"['001', '1', '01011', '011001']",1,4,7,8,0,15,2.831168831168831,18,15
"['0', '0111000', '100', '101']",1,4,8,6,2,14,2.9166666666666665,20,12
"['0110111', '1111111', '100010']",1,3,6,14,2,20,1.1978021978021978,11,10
"['0110101', '0', '00001', '011001', '01100']",1,5,14,10,2,24,5.328488178488178,31,37
"['0000', '01', '11']",1,3,5,3,2,8,0.8333333333333333,8,4
"['11110', '1101', '000011']",1,3,6,9,0,15,1.4303030303030302,11,9
"['1000010', '101', '11010', '001001']",1,4,12,9,0,21,3.844172494172494,19,16
"['0100001', '101', '00', '1001111']",1,4,10,9,2,19,2.8603174603174604,24,12
"['0001001', '01', '10111', '11000', '0000', '1011']",1,6,15,12,4,27,7.446536796536797,49,45
"['01101', '101001', '0110', '1000011', '110', '111101']",1,6,13,18,2,31,8.902247752247753,42,44
"['1111100', '01', '101', '0011', '100', '0001101', '00010']",1,7,16,15,4,31,11.267099567099567,70,59
"['11011', '0000100', '111010', '01111', '011110', '0110001']",1,6,16,20,6,36,9.043889443889444,47,43
"['0', '00101', '111', '10101', '1110001', '011000']",1,6,13,14,2,27,7.323631923631924,52,36
"['0', '1010', '100', '011']",1,4,6,5,2,11,3.1619047619047618,13,13
"['110', '111', '0111011']",1,3,3,10,2,13,1.8666666666666667,9,11
"['011111', '0101', '1']",1,3,3,8,0,11,1.2857142857142856,11,7
"['011101', '0111111', '001', '11']",1,4,5,13,0,18,2.9581196581196583,21,18
"['10', '101110', '0100']",1,3,6,6,0,12,1.7666666666666666,9,8
"['0', '1000', '01111']",1,3,5,5,0,10,0.9555555555555555,11,6
"['0010101', '010', '01010']",1,3,9,6,0,15,2.1833333333333336,8,12
"['0', '10101', '100', '11']",1,4,5,6,0,11,2.5547619047619046,15,11
"['1', '011', '10000', '0010101', '0001100']",1,5,14,9,2,23,4.497619047619048,40,24
"['10100', '100', '111101', '101101']",1,4,8,12,2,20,3.967171717171717,15,23
"['01', '0111', '1111011']",1,3,3,10,0,13,1.6565656565656566,11,10
"['1', '01011', '01100', '0110']",1,4,7,8,2,15,3.2222222222222223,17,15
"['1', '00101', '101101', '110001', '0011011']",1,5,11,14,2,25,5.13028638028638,36,33
"['0', '010001', '11101']",1,3,6,6,0,12,0.9826839826839826,12,5
"['10100', '11010', '11100', '000010']",1,4,12,9,3,21,3.8545454545454545,15,19
"['111', '10001', '10011', '0101', '11100', '1110']",1,6,10,16,5,26,9.234126984126984,36,54
"['0011101', '0001', '001110', '1011', '1110', '0100']",1,6,14,15,4,29,8.254895104895105,41,43
"['1000001', '0101', '1', '01000']",1,4,11,6,0,17,2.862121212121212,22,13
"['110000', '110', '1']",1,3,5,5,0,10,1.4523809523809523,10,8
"['11010', '0101110', '100', '00', '0101']",1,5,11,10,0,21,6.297907647907648,27,28
"['01', '110010', '0111100']",1,3,7,8,0,15,1.5598290598290598,13,7
"['00', '1', '0100']",1,3,5,2,0,7,1.0666666666666667,7,6
"['110000', '10010', '0111', '1']",1,4,8,8,0,16,2.5907647907647906,22,13
"['1011010', '00000', '1011101', '1111', '11101', '01010', '0111', '0000111']",1,8,19,25,8,44,16.705555555555556,87,88
"['10111', '0000110', '0110']",1,3,8,8,0,16,1.893939393939394,9,7
"['00', '000111', '1100', '11111']",1,4,7,10,0,17,2.5565656565656565,22,22
"['0', '0101', '11100', '11101']",1,4,6,9,2,15,2.977777777777778,17,15
"['0101', '0010000', '1011110', '10', '1101', '0100011', '1111011']",1,7,17,21,6,38,11.51046176046176,78,52
"['01', '11', '101', '000010', '0011011', '00010']",1,6,14,11,2,25,8.331618381618382,47,37
"['110000', '010011', '00', '111010']",1,4,11,9,3,20,3.1666666666666665,20,17
"['1110111', '0101011', '1']",1,3,4,11,2,15,1.2142857142857144,15,10
"['1', '011011', '1001', '0111', '0101']",1,5,7,12,3,19,5.485714285714286,27,28
"['01001', '101110', '11']",1,3,5,8,0,13,1.6168831168831168,11,6
"['0001', '1', '0110011']",1,3,6,6,0,12,1.3772727272727274,12,6
"['0', '11000', '100']",1,3,6,3,0,9,1.5833333333333333,8,7
"['10100', '1010110', '0111']",1,3,7,9,0,16,1.823232323232323,8,9
"['01', '10100', '1001', '0001']",1,4,9,6,2,15,3.765873015873016,13,18
"['01011', '1111101', '011']",1,3,4,11,0,15,1.65,11,11
"['00', '111', '111001']",1,3,4,7,0,11,1.1666666666666665,10,8
"['00101', '10011', '000', '111011']",1,4,9,10,2,19,3.544949494949495,17,15
"['0', '001', '110111']",1,3,4,6,0,10,1.2301587301587302,11,4
"['0001', '110', '000101']",1,3,8,5,0,13,1.53015873015873,9,10
"['1011010', '000101', '1010', '110', '0100']",1,5,13,11,2,24,5.871567321567321,28,28
"['01', '10', '0100', '00000']",1,4,10,3,2,13,2.849206349206349,16,17
"['010', '0101101', '110011', '0001100', '0101']",1,5,14,13,2,27,6.319369519369519,32,27
"['101001', '000', '1110', '1001101']",1,4,10,10,0,20,3.0728160728160727,18,12
"['001', '100', '011']",1,3,5,4,3,9,1.6666666666666665,6,7
"['00101', '101101', '10111', '111000', '0111110']",1,5,11,18,4,29,6.209557109557109,30,26
"['11110', '11100', '101101']",1,3,5,11,2,16,2.254545454545455,5,8
"['0001001', '10101', '10000', '1111', '10010', '0011111', '000']",1,7,19,17,5,36,11.529004329004328,69,65
"['001', '0110100', '0010000', '10100', '1011100', '0001010', '00010', '0100']",1,8,30,15,6,45,18.52893217893218,81,132
"['1100011', '01010', '0100']",1,3,9,7,0,16,1.9343434343434343,9,6
"['1110101', '1', '000']",1,3,5,6,0,11,0.65,14,4
"['1', '100000', '0000111', '1101', '01011']",1,5,12,11,0,23,4.345038295038295,40,28
"['011111', '101', '1010', '11110']",1,4,5,13,0,18,3.373304473304473,16,18
"['0110100', '10001', '00', '11101', '010110', '0001011', '1100']",1,7,19,17,4,36,11.956188256188256,70,53
"['11000', '01', '110', '1110000']",1,4,9,8,0,17,3.0912698412698414,20,18
"['1110101', '0010', '0001111']",1,3,8,10,2,18,1.6623376623376622,13,7
"['0', '1100001', '10', '111']",1,4,6,7,0,13,2.361111111111111,21,12
"['1000001', '110110', '01', '101', '10100', '111110']",1,6,13,16,2,29,7.887123987123987,49,42
"['0100001', '010', '101110', '010110']",1,4,12,10,2,22,3.8435897435897437,20,24
"['1100001', '01', '110', '111101']",1,4,7,11,0,18,3.2264957264957266,21,21
"['1001110', '001100', '10']",1,3,8,7,0,15,1.7136752136752138,11,8
['1010100'],1,1,4,3,0,7,0,0,0
"['0', '0001', '1110']",1,3,5,4,2,9,1.05,10,6
"['1100', '10', '1']",1,3,3,4,0,7,1.7333333333333334,6,6
"['11110', '0110', '1110']",1,3,4,9,2,13,2.3055555555555554,4,15
"['1101', '0101', '10']",1,3,4,6,2,10,2.083333333333333,5,8
"['1001111', '0011', '111', '0101001']",1,4,8,13,2,21,3.6155844155844155,20,21
"['11', '1101', '0100', '00000']",1,4,9,6,2,15,2.1666666666666665,18,12
"['01', '1010', '00']",1,3,5,3,2,8,1.8333333333333333,5,6
"['11011', '100000', '10', '111000', '0110001']",1,5,14,12,2,26,5.642912642912643,33,25
"['101', '00', '001001', '10']",1,4,8,5,2,13,3.3666666666666667,15,14
"['1000011', '1000', '0']",1,3,8,4,0,12,1.3772727272727274,12,7
"['110110', '010', '1', '001000', '00011', '0001000']",1,6,18,10,2,28,7.508064158064158,53,49
"['01', '1010', '000', '1101']",1,4,7,6,2,13,3.34047619047619,13,11
"['0', '1010', '0010', '11']",1,4,6,5,2,11,2.55,14,12
"['1111100', '0110000', '10000']",1,3,11,8,2,19,1.9047619047619047,9,12
"['011100', '00011', '111111', '00', '010111', '010110']",1,6,13,18,4,31,7.935064935064935,47,48
"['0001111', '100101', '10011', '000', '1101']",1,5,12,13,0,25,6.073826173826173,28,32
"['0011', '111', '0100']",1,3,5,6,2,11,1.3571428571428572,8,7
"['001', '00011', '0000', '111110', '0101100', '0100100', '000100']",1,7,24,14,4,38,12.044150294150294,62,94
"['00111', '1010000', '01']",1,3,8,6,0,14,1.349206349206349,13,7
"['00011', '101', '1101000', '1101', '111001']",1,5,11,14,0,25,6.256365856365856,30,40
"['000110', '1', '101010', '0110', '0001011']",1,5,13,11,2,24,5.018165168165169,35,26
"['010', '01111', '000', '00001']",1,4,10,6,4,16,3.0666666666666664,16,19
"['01', '0010', '011011', '1111', '0001100', '100110']",1,6,14,15,4,29,8.436635586635587,48,34
"['01101', '0011101', '111', '0111001', '0011', '10111', '100010', '000111']",1,8,18,25,6,43,18.873248973248973,81,86
"['01111', '1010101', '0110111', '10']",1,4,7,14,2,21,3.2222222222222223,22,17
"['1', '10111', '100', '0000', '0101']",1,5,9,8,2,17,4.265079365079365,28,21
"['1100111', '1011', '110']",1,3,4,10,0,14,1.8987012987012988,9,14
"['0011110', '1', '0110001', '00001']",1,4,11,9,2,20,2.5952380952380953,26,14
"['0', '1100010', '001100']",1,3,9,5,0,14,1.151098901098901,15,8
"['011111', '1101', '011', '01011']",1,4,5,13,0,18,3.60021645021645,14,23
"['010100', '101', '1010111', '001001']",1,4,11,11,2,22,3.9974358974358974,18,14
"['101101', '100', '1011', '000111', '11100']",1,5,10,14,2,24,6.216378066378066,29,35
"['11', '110011', '01010', '0100100', '01011']",1,5,12,13,2,25,6.275413475413475,29,32
"['010000', '1', '00001']",1,3,9,3,0,12,1.3463203463203464,11,7
"['0100101', '001111', '1110']",1,3,7,10,0,17,1.579020979020979,10,8
"['110000', '1010001', '10']",1,3,9,6,0,15,1.7136752136752138,11,7
"['0', '0101', '0110001']",1,3,7,5,0,12,1.3772727272727274,12,8
"['110000', '001', '1']",1,3,6,4,0,10,1.2301587301587302,11,7
"['101000', '00', '010']",1,3,8,3,0,11,1.9666666666666668,8,10
"['01', '0010101', '011000']",1,3,9,6,0,15,1.4059829059829059,12,9
"['101100', '01', '01100', '1101010']",1,4,10,10,0,20,3.8608613608613607,19,17
"['11001', '1', '10100', '1101', '00010']",1,5,10,10,3,20,5.3999999999999995,29,24
"['0011', '100000', '0000', '110101', '011010', '011000']",1,6,20,12,6,32,9.1,43,50
"['01', '110010', '1101101', '001010', '1100']",1,5,12,13,2,25,5.7563325563325565,33,29
"['0010', '111000', '00', '1111001']",1,4,10,9,0,19,3.525796425796426,22,17
"['00011', '01', '110', '1101010']",1,4,8,9,0,17,3.015873015873016,22,17
"['01', '0010', '001111', '0001', '1000', '110']",1,6,13,10,3,23,8.28968253968254,41,41
"['00101', '1000', '111111', '011111', '1101', '11100']",1,6,10,20,6,30,7.8,44,55
"['1011010', '101', '0100101', '110101']",1,4,10,13,2,23,3.833699633699634,19,23
"['110110', '011100', '1111', '1010111', '10', '1011011', '1100', '01011']",1,8,14,27,6,41,17.135753135753134,83,90
"['0', '110', '01010']",1,3,5,4,0,9,1.3333333333333333,8,9
"['1000101', '101', '100', '1010', '00', '111000']",1,6,14,11,2,25,9.445831945831946,42,43
"['00111', '11101', '111000', '00101']",1,4,9,12,3,21,3.6363636363636362,17,25
"['0101101', '010001', '011', '11']",1,4,8,10,0,18,3.7803418803418802,19,19
"['101000', '1011101', '0010']",1,3,9,8,0,17,1.579020979020979,10,7
"['101', '1100', '111']",1,3,3,7,2,10,1.8095238095238093,5,10
"['011011', '10001', '000']",1,3,8,6,0,14,1.558080808080808,9,4
"['0', '1110111', '100', '100111', '0001010', '110']",1,6,12,15,4,27,7.376678876678876,56,38
"['0111011', '0001', '010010', '11101', '0000']",1,5,14,12,2,26,5.356293706293706,29,25
"['1011001', '100', '1', '1101111']",1,4,6,12,2,18,2.7142857142857144,26,19
"['0', '01', '11011', '11101', '100011', '10011', '11100']",1,7,11,18,4,29,11.331168831168831,63,69
"['00111', '0011', '10001', '0101010', '1011', '0100']",1,6,15,14,5,29,9.683333333333334,38,38
"['01', '1', '01000', '1010011']",1,4,8,7,0,15,2.9325396825396823,22,11
"['1001110', '11', '0010010', '10', '1101']",1,5,10,12,4,22,5.234487734487734,36,24
"['0110101', '010000', '1', '11000', '010010', '0100']",1,6,18,11,2,29,8.398351648351648,45,46
"['001', '00000', '00111', '00110', '110', '101111']",1,6,14,13,5,27,7.976767676767677,43,47
"['010', '010001', '11', '1001', '1000', '1110100']",1,6,14,12,2,26,8.81026196026196,44,37
"['110110', '11110', '000', '1011', '0101']",1,5,9,13,2,22,5.135930735930736,26,23
"['110110', '00110', '00', '001']",1,4,9,7,0,16,3.793145743145743,16,23
"['0010001', '0010', '111', '0011001', '1011', '000100']",1,6,18,13,4,31,8.720424020424021,46,43
"['1110111', '111', '0000']",1,3,5,9,0,14,0.7818181818181817,14,12
"['1000', '111000', '01111', '100111']",1,4,9,12,2,21,3.394949494949495,20,23
"['110010', '1', '110001', '10100', '0000']",1,5,13,9,2,22,4.837085137085137,34,23
"['0011101', '1', '00101', '000001', '0101', '0110011']",1,6,16,14,2,30,7.956288156288156,50,45
"['0', '0111010', '001']",1,3,6,5,0,11,1.15,12,8
"['101', '0111111', '001011', '011']",1,4,6,13,2,19,3.4615384615384617,20,18
"['01', '1001', '100']",1,3,5,4,0,9,1.9238095238095236,5,9
"['111000', '001', '01111', '01000']",1,4,10,9,2,19,3.117171717171717,19,20
"['10001', '110', '10', '1110']",1,4,6,8,0,14,3.8396825396825394,13,18
"['000010', '11100', '011', '000']",1,4,11,6,2,17,2.808080808080808,19,22
"['100', '110', '111', '0100110']",1,4,7,9,3,16,3.2666666666666666,16,14
"['101001', '000', '1000111', '11']",1,4,9,9,0,18,2.6042735042735043,22,15
"['01001', '100001', '1111111', '00011']",1,4,10,13,2,23,3.228904428904429,21,18
"['10001', '1', '10']",1,3,4,4,0,8,1.5714285714285714,8,9
"['110000', '011', '11', '0101011', '1100100', '1110']",1,6,13,16,2,29,8.182717282717283,52,55
"['0110000', '101000', '00', '0110100']",1,4,15,7,2,22,3.7844932844932844,21,31
"['101', '0001', '110']",1,3,5,5,2,10,1.5238095238095237,7,7
"['001', '0110111', '011100', '11', '0001111']",1,5,10,15,2,25,5.178388278388279,38,29
"['100001', '11', '1011101', '000101', '0010101', '10100', '00']",1,7,19,16,6,35,11.033522033522033,69,65
"['0101110', '10', '1110', '00011']",1,4,8,10,0,18,3.235209235209235,21,18
"['0', '10111', '0110', '10']",1,4,5,7,0,12,3.3047619047619046,15,12
"['11110', '001111', '11', '100', '1010111', '100110', '1011', '111000']",1,8,14,25,3,39,16.518614718614717,88,102
"['101', '0100000', '1', '0010000']",1,4,13,5,2,18,2.657142857142857,26,12
"['1011', '11110', '000']",1,3,5,7,0,12,0.9801587301587301,9,5
"['001111', '1110000', '001101', '1101101', '0010011', '10100', '0000', '00010', '1011000', '110']",1,10,31,26,8,57,26.23861693861694,146,157
"['1011001', '110', '01010']",1,3,7,8,0,15,1.7666666666666666,10,5
"['101', '100111', '1']",1,3,3,7,0,10,1.4523809523809523,10,13
"['0', '10010', '1110100', '1001101']",1,4,10,10,2,20,2.880952380952381,25,13
"['11010', '100', '010']",1,3,6,5,2,11,2.1666666666666665,6,8
"['1100011', '101', '001101', '111']",1,4,7,12,2,19,3.815384615384615,19,24
"['1100', '010000', '100101', '0000']",1,4,14,6,4,20,3.6,16,19
"['00', '0110', '11']",1,3,4,4,2,8,1.3333333333333333,6,4
"['10100', '01', '001011', '0111100']",1,4,10,10,0,20,3.1895326895326894,22,17
"['010', '1', '011100', '001000', '101000']",1,5,14,8,3,22,5.523809523809524,32,29
"['111', '00100', '00', '0111', '01010']",1,5,10,9,2,19,4.9944444444444445,27,29
"['0111101', '10101', '100']",1,3,6,9,0,15,1.65,10,9
"['01', '110', '10', '000']",1,4,6,4,4,10,2.8333333333333335,11,13
"['01', '0110', '01000']",1,3,7,4,0,11,1.9047619047619047,7,11
"['1001', '1111', '1000', '10', '110']",1,5,7,10,3,17,5.680952380952381,20,29
"['11', '00000', '0011110', '10110', '0111', '0011011', '1110']",1,7,15,19,6,34,11.861399711399711,67,64
"['1010110', '00101', '1001', '00', '1101']",1,5,11,11,2,22,6.038600288600288,27,25
"['110000', '101', '110']",1,3,6,6,2,12,1.7777777777777777,9,8
"['1001010', '110110', '00', '101001']",1,4,11,10,2,21,3.4957264957264957,21,12
"['01', '010', '1000110', '0001100', '1101']",1,5,13,10,2,23,6.075036075036075,33,21
"['00111', '101', '0100001', '1010001', '110']",1,5,13,12,4,25,5.523809523809524,35,30
"['110011', '0010', '000']",1,3,8,5,0,13,1.9015873015873015,8,6
"['0', '0011', '1010', '1000', '100011']",1,5,11,8,3,19,5.435714285714286,27,27
"['0011001', '11010', '11101', '0']",1,4,8,10,2,18,3.05,23,12
"['01', '1', '011000']",1,3,5,4,0,9,1.4523809523809523,10,5
"['101', '0110', '1011111']",1,3,4,10,0,14,1.7168831168831167,11,6
"['01100', '0110', '111011', '0001100', '00010', '01110']",1,6,17,15,3,32,10.202952602952603,38,61
"['10100', '101000', '1110001', '0010011']",1,4,14,11,2,25,4.198468198468198,15,20
"['1010', '011', '0001111']",1,3,6,8,0,14,1.535064935064935,11,7
"['01', '10111', '11000', '100010', '110011', '10', '000']",1,7,15,14,6,29,11.205050505050504,63,55
"['1101', '10', '0101100']",1,3,6,7,0,13,1.6565656565656566,11,4
"['1011', '00', '00110', '01110']",1,4,8,8,2,16,3.6095238095238096,15,16
"['101100', '000110', '1011010', '001000', '1100110', '1100']",1,6,20,16,5,36,10.30985680985681,42,57
"['0', '010001', '1111101', '11', '10101', '0111101']",1,6,10,18,2,28,6.586857586857587,56,45
"['1110111', '010100', '0010', '01', '111', '100100', '011000', '111001']",1,8,19,21,4,40,15.847641247641247,92,79
"['01', '001', '1100010', '1000', '0111']",1,5,11,9,2,20,5.51002886002886,31,24
"['101000', '001', '011000']",1,3,10,5,2,15,1.7222222222222223,10,11
"['0010110', '0010', '10010', '0000', '0101']",1,5,16,8,3,24,7.070707070707071,23,38
"['0110', '000', '1011111']",1,3,6,8,0,14,1.3168831168831168,12,4
"['11110', '001', '1000111']",1,3,6,9,0,15,1.35,12,8
"['010', '11111', '100', '011001', '1011']",1,5,8,13,2,21,5.2327561327561325,28,22
"['0', '0010010', '110100']",1,3,9,5,0,14,1.151098901098901,15,9
"['0', '0101111', '0111011', '0000101', '101001', '011000']",1,6,17,17,5,34,7.22985347985348,60,36
"['010', '0101111', '100', '000']",1,4,9,7,3,16,3.4,18,18
"['101100', '00000', '100', '000101', '0011100', '0100']",1,6,21,10,2,31,9.282162282162282,41,72
"['0000011', '110010', '100', '011']",1,4,11,8,2,19,2.905982905982906,23,17
"['1110111', '11110', '0010', '0101000', '011101', '00']",1,6,14,17,2,31,7.613042513042513,55,41
"['0010001', '010100', '001', '011100', '1111', '00', '01010', '1101']",1,8,20,17,4,37,15.304600954600954,83,82
"['1000100', '01', '001010']",1,3,10,5,0,15,1.7136752136752138,12,7
"['001', '00101', '11000', '1111', '10', '0100011', '0011100']",1,7,17,16,4,33,11.136868686868686,72,58
"['01', '0011101', '111']",1,3,4,8,0,12,1.4444444444444444,11,7
"['0011110', '0111110', '1000111']",1,3,8,13,3,21,2.142857142857143,8,8
"['0011100', '001111', '0111']",1,3,7,10,0,17,2.2965034965034965,7,13
"['11', '1011110', '100', '0010011', '10100', '0101', '101110', '011000']",1,8,19,21,4,40,17.316344766344766,87,78
"['010100', '11', '101010', '10001', '1111001', '1101110']",1,6,14,19,4,33,9.062715062715062,50,39
"['011', '111', '0110', '010010', '10', '00010']",1,6,12,11,2,23,8.87020202020202,36,44
"['0001', '1000101', '10', '111101']",1,4,9,10,0,19,3.0204351204351205,22,19
"['0010110', '01', '0001110', '100000', '10', '0111']",1,6,16,12,4,28,7.588417138417138,57,42
"['0010000', '10111', '110001', '0010011', '0000', '10', '10011', '010110', '1101', '1100']",1,10,27,23,9,50,26.27252747252747,136,131
"['1011', '110', '10010']",1,3,5,7,0,12,1.7380952380952381,6,9
"['0000111', '100100', '1']",1,3,8,6,0,14,0.9972527472527473,15,7
"['01', '0110111', '11', '0011110', '011010']",1,5,9,15,4,24,5.53052503052503,36,27
"['0101', '100001', '0100']",1,3,9,5,2,14,1.75,7,7
"['0101101', '00010', '111010']",1,3,9,9,0,18,1.8146853146853146,9,8
"['010', '11', '1100010', '101', '101011']",1,5,9,12,2,21,5.95982905982906,31,29
"['0010110', '010', '111', '00100', '11101', '000111']",1,6,14,15,4,29,8.287917637917637,46,44
"['01', '000101', '11']",1,3,5,5,2,10,1.5,9,7
"['001', '0110', '0001000']",1,3,10,4,0,14,1.7168831168831167,10,10
"['1011001', '011', '0010101', '100010', '010110', '11111', '01110']",1,7,17,22,6,39,12.296142746142745,64,50
"['1', '1100100', '01000']",1,3,8,5,0,13,1.25,13,5
"['000110', '001', '010010', '100010']",1,4,14,7,3,21,4.5,15,20
"['100100', '11110', '110001']",1,3,8,9,2,17,1.5757575757575757,9,7
"['0010', '010101', '111110']",1,3,7,9,2,16,1.3333333333333333,10,7
"['11010', '11101', '0010111']",1,3,6,11,2,17,1.8,10,10
"['0010', '011001', '000', '1101100']",1,4,12,8,0,20,3.4344544344544343,18,19
"['1000100', '0011110', '0010011', '00', '011111']",1,5,15,14,3,29,4.978937728937729,41,33
"['1110000', '0110001', '00001', '00111', '00100', '0011000', '01000', '1011', '1100', '01100']",1,10,33,21,10,54,28.8998556998557,125,169
"['010001', '11000', '1111', '000', '0101']",1,5,12,10,2,22,5.304256854256854,27,27
"['1101001', '11000', '100000', '10']",1,4,12,8,0,20,3.538017538017538,19,17
"['1010', '00', '01100', '11']",1,4,7,6,2,13,3.142857142857143,15,12
"['01', '0001', '0110111', '0010100']",1,4,11,9,2,20,3.0360750360750357,22,16
"['1', '00', '100011', '1011', '101001']",1,5,9,10,2,19,4.571428571428571,32,30
"['1000101', '10111', '110100', '11111', '1101', '0100011']",1,6,13,21,4,34,8.849217449217448,43,63
"['1111', '0111', '0100']",1,3,4,8,3,12,1.5,6,9
"['1110111', '1101001', '1011', '01001', '01011']",1,5,10,18,4,28,7.191053391053391,25,43
"['0000111', '11000', '0010010', '11011']",1,4,13,11,4,24,3.338095238095238,21,20
"['0010', '1001', '0000110', '1110']",1,4,11,8,3,19,3.5681818181818183,18,15
"['10110', '10010', '10', '010111']",1,4,8,10,2,18,3.7155844155844155,16,18
"['01', '111010', '1111000', '10100', '0110011']",1,5,12,15,2,27,5.754745254745255,36,26
"['0101', '010111', '111']",1,3,4,9,0,13,2.038095238095238,7,13
"['01101', '11', '100000', '100011', '110']",1,5,11,11,2,22,5.3360750360750355,33,30
"['0110010', '1000', '1']",1,3,7,5,0,12,1.3772727272727274,12,4
"['0011', '111000', '10', '0111110']",1,4,8,11,0,19,2.8386169386169384,24,15
"['11', '10001', '010010', '100110', '00', '010101']",1,6,15,12,5,27,8.658008658008658,47,32
"['1001110', '1111110', '10100', '10', '0000', '0100101']",1,6,16,16,3,32,7.16955266955267,56,40
"['0100010', '0010', '100']",1,3,10,4,0,14,1.8987012987012988,9,12
"['0100001', '101', '01111', '0']",1,4,8,8,0,16,2.4833333333333334,23,12
"['01', '001000', '110011', '10', '1101', '001001']",1,6,14,12,5,26,8.633333333333333,47,39
"['0', '1011', '1110110']",1,3,4,8,0,12,1.3772727272727274,12,5
"['001', '111', '011001']",1,3,5,7,2,12,1.6666666666666665,8,8
"['0', '1010110', '1111110']",1,3,5,10,2,15,1.2142857142857144,14,8
"['110010', '01101', '0101000', '010', '00001', '0011', '0001', '01100']",1,8,24,15,5,39,17.597441447441447,72,92
"['0011', '01', '001110']",1,3,6,6,0,12,1.9666666666666668,8,9
"['010011', '1011011', '000001', '011001']",1,4,13,12,3,25,3.858974358974359,14,17
"['0111001', '11100', '1000', '0111', '000', '1101', '1100', '0100']",1,8,18,17,5,35,17.064862914862914,65,88
"['1101001', '0', '0111010', '1011001', '1111101', '0011110', '0010100', '101110']",1,8,21,28,6,49,15.796703296703297,102,67
"['001', '001111', '011011', '10000', '0111', '01010', '01011']",1,7,16,18,5,34,12.607792207792208,53,64
"['010000', '10', '0111', '11']",1,4,7,7,2,14,2.65,19,13
"['001', '1100000', '1001001', '110', '110101']",1,5,14,12,4,26,5.543345543345543,34,33
"['1001100', '1', '0100']",1,3,7,5,0,12,1.1954545454545453,12,6
"['0', '0111000', '0010110', '0111001', '100', '011110', '0011011']",1,7,19,19,4,38,11.153235653235653,77,74
"['0', '1011', '11001']",1,3,4,6,0,10,1.4,9,5
"['0011', '0001', '010011']",1,3,8,6,2,14,2.35,5,10
"['11001', '110000', '1', '1000111']",1,4,9,10,0,19,2.8783716283716285,24,23
"['1111100', '100101', '010010', '11001']",1,4,11,13,2,24,3.8776223776223775,18,12
"['101', '0001', '001', '1011100']",1,4,9,8,2,17,3.4588744588744587,18,21
"['0', '101', '100011', '1111']",1,4,5,9,0,14,2.4238095238095236,19,15
"['11110', '001', '0010', '1010', '100101', '01110']",1,6,13,14,4,27,8.522510822510823,35,41
"['1', '1111110', '1101010']",1,3,4,11,2,15,0.9285714285714286,14,8
"['11101', '00101', '01011', '1001']",1,4,8,11,3,19,3.7777777777777777,13,19
"['010001', '001111', '011', '0001101', '11111', '0110110']",1,6,14,20,4,34,9.274425574425575,48,43
"['10111', '000111', '111', '0100101']",1,4,8,13,0,21,4.013170163170163,16,25
"['0010110', '0100000', '01101', '001111', '00111', '00100', '10001', '10']",1,8,24,18,6,42,16.114513264513263,90,85
"['11001', '0', '11000', '1101110', '1010000']",1,5,13,12,4,25,5.371428571428571,36,27
"['00111', '11011', '1001']",1,3,5,9,2,14,1.9333333333333331,8,10
"['0010111', '111', '10000', '10', '01010', '01001']",1,6,14,13,3,27,8.075396825396826,49,37
"['01', '0010101', '00001']",1,3,9,5,0,14,1.5158730158730158,10,10
"['100', '0111', '000', '011110', '0101']",1,5,10,10,4,20,5.419841269841269,25,29
"['11001', '1111100', '010', '11']",1,4,6,11,0,17,2.9825396825396826,22,15
"['1000001', '0011', '110001', '10110', '10010', '1101', '101110']",1,7,18,19,6,37,13.464102564102564,59,70
"['01', '00011', '10001', '0110000', '111110', '001100']",1,6,17,14,4,31,8.034737484737486,54,37
"['011111', '001', '110111']",1,3,4,11,2,15,1.5555555555555554,10,9
"['01', '0100000', '0000100', '010010', '1100']",1,5,19,7,2,26,5.523021423021423,34,39
"['0', '1000110', '11101']",1,3,6,7,0,13,1.25,14,4
"['0010', '0100111', '0001']",1,3,9,6,2,15,2.0227272727272725,9,7
"['111010', '11', '00', '1001001', '0101']",1,5,10,11,2,21,5.1648795648795645,34,21
"['0010010', '001', '100', '11']",1,4,9,6,2,15,3.111111111111111,19,14
"['0100111', '011', '0011', '1100111', '1101']",1,5,9,16,4,25,6.531168831168831,28,43
"['001', '0110111', '00111', '101011', '000', '110']",1,6,12,15,3,27,8.146503496503497,44,42
"['00001', '100', '1111', '1000', '10']",1,5,10,8,2,18,4.867460317460317,26,28
"['11', '011011', '10000', '0000010', '0000']",1,5,16,8,0,24,4.515939615939616,37,35
"['1001', '100010', '011', '00001']",1,4,11,7,0,18,3.7098124098124097,15,16
"['0', '011110', '000100', '110', '0011100']",1,5,13,10,2,23,5.071001221001221,36,39
"['0', '010000', '1001110']",1,3,9,5,0,14,1.151098901098901,15,8
"['1000100', '01', '000110', '0100']",1,4,13,6,0,19,3.5076146076146077,19,20
"['1000001', '00', '10', '01110']",1,4,10,6,2,16,2.865079365079365,22,12
"['1111010', '0111010', '0100011']",1,3,9,12,3,21,1.7142857142857142,8,13
"['001', '10001', '1010', '00', '0000111']",1,5,13,8,0,21,6.100937950937951,29,26
"['11000', '010', '010001', '000']",1,4,12,5,2,17,3.977272727272727,14,20
"['100000', '1000101', '1110']",1,3,10,7,0,17,1.5328671328671328,10,9
"['011100', '1100010', '100100', '1110011', '0111', '011001', '0001011', '011010']",1,8,24,25,7,49,18.615850815850816,85,85
"['1', '100101', '010111', '1101', '1100']",1,5,8,13,4,21,5.188095238095238,32,32
"['100100', '1000', '001', '01100']",1,4,12,6,0,18,3.75021645021645,14,21
"['1110111', '101', '01', '1101010']",1,4,6,13,2,19,3.6031746031746033,22,17
"['1110110', '010011', '111']",1,3,5,11,0,16,1.6598290598290597,10,13
"['0111010', '0101011', '0000']",1,3,10,8,2,18,1.8051948051948052,10,9
"['00', '0010100', '11010', '11111']",1,4,9,10,2,19,2.615873015873016,23,16
"['01000', '10100', '10', '1110']",1,4,9,7,2,16,3.4984126984126984,15,15
"['10111', '1101', '0100100', '0110001']",1,4,11,12,2,23,3.8203463203463204,20,13
"['01', '1000', '01011', '1011111']",1,4,7,11,0,18,2.8239538239538238,22,15
"['0101', '111', '0111', '100010']",1,4,7,10,2,17,3.623015873015873,15,17
"['00111', '0001', '0']",1,3,6,4,0,10,1.4,9,7
"['100001', '1000111', '00110', '1100110', '000', '1011', '0101', '0111110', '0100']",1,9,24,23,6,47,21.414457764457765,113,92
"['10111', '1000110', '01000']",1,3,9,8,2,17,1.7333333333333334,11,5
"['0', '0000011', '111']",1,3,6,5,0,11,0.65,14,6
"['01', '0110100', '11']",1,3,5,6,2,11,1.3888888888888888,11,5
"['1110111', '001', '1111']",1,3,3,11,0,14,1.412987012987013,11,16
"['0000', '1010', '011', '11']",1,4,7,6,2,13,2.8238095238095235,14,12
"['01', '1100010', '1100100', '00', '01001']",1,5,14,9,4,23,5.611111111111111,35,27
"['1001110', '101111', '1000110', '01']",1,4,9,13,2,22,3.6306471306471306,20,18
"['11001', '01101', '0000100']",1,3,10,7,2,17,1.8,10,5
"['1111010', '001', '1']",1,3,4,7,0,11,1.15,13,6
"['000100', '001', '01000']",1,3,11,3,0,14,1.893939393939394,8,14
"['111010', '1001', '000101', '10000', '1000111', '0000010', '1011111']",1,7,22,20,5,42,12.234132534132534,69,68
"['01', '10101', '110001', '0111101', '01000']",1,5,12,13,2,25,5.7572316572316575,32,28
"['0010', '00000', '0011', '0011110', '100100', '1000010', '1101']",1,7,23,14,5,37,12.918165168165167,63,68
"['101010', '110', '1']",1,3,4,6,0,10,1.2301587301587302,10,7
"['0001', '100', '01111', '100010', '1011', '0110011']",1,6,14,15,2,29,8.755716505716507,42,41
"['0000', '1010', '000001', '11']",1,4,11,5,2,16,2.6166666666666667,19,16
"['0', '0110000', '11110', '0101001']",1,4,11,9,2,20,2.380952380952381,27,15
"['01', '0011000', '0100010', '00100', '1110']",1,5,16,9,2,25,5.361471861471862,35,33
"['110000', '10101', '11011']",1,3,7,9,2,16,1.8909090909090909,8,11
['1011000'],1,1,4,3,0,7,0,0,0
"['010100', '00100', '00', '1110']",1,4,11,6,0,17,3.1582972582972584,17,28
"['101', '111001', '10', '000', '0100']",1,5,10,8,2,18,5.553968253968254,24,20
"['00', '111', '01100', '0100']",1,4,8,6,0,14,2.9126984126984126,15,19
"['01', '11101', '00', '01000']",1,4,8,6,4,14,2.9,17,14
"['1', '011111', '10001', '0100001', '0101']",1,5,11,12,0,23,4.921495171495171,36,31
"['1101', '0010', '110', '0000010']",1,4,11,7,2,18,3.4194805194805196,19,18
"['1111100', '10001', '111000']",1,3,8,10,0,18,1.9965034965034967,10,9
"['1111100', '001', '0001', '100', '1010', '110']",1,6,12,12,5,24,8.39004329004329,43,42
"['1100', '11101', '10', '000', '11100']",1,5,9,10,2,19,5.886507936507936,23,30
"['0001010', '0101', '0000']",1,3,11,4,2,15,1.9545454545454546,8,12
"['0101', '1', '1111001', '1000111']",1,4,7,12,2,19,2.2376623376623375,28,21
"['001', '10', '1111']",1,3,3,6,0,9,1.019047619047619,8,6
"['01', '100011', '1']",1,3,4,5,0,9,1.4523809523809523,10,8
"['0', '0001', '110']",1,3,5,3,0,8,1.1857142857142857,8,6
"['110000', '101', '0100101', '00011']",1,4,12,9,0,21,3.5386169386169386,20,17
"['111', '0001000', '00', '0001011', '01010', '011111', '01100']",1,7,19,16,4,35,10.422838272838273,74,74
"['101100', '1100001', '01111', '000010', '1101', '110']",1,6,15,16,2,31,8.367010767010767,50,40
"['1001110', '01101', '10000', '1111', '001011', '01100']",1,6,15,17,3,32,8.135897435897435,45,38
"['0', '1011', '10', '0111']",1,4,4,7,2,11,3.216666666666667,14,12
"['0010', '01001', '1101']",1,3,7,6,2,13,1.6111111111111112,8,5
"['001', '0000110', '000', '11']",1,4,10,5,2,15,2.7111111111111112,19,17
"['00', '00101', '11']",1,3,5,4,2,9,1.1428571428571428,8,6
"['10100', '00', '1001011', '111011']",1,4,9,11,0,20,3.0805583305583304,21,17
"['101100', '111100', '00110', '000', '101111']",1,5,12,14,3,26,5.845959595959596,28,35
"['0010001', '1110010', '1010100', '110011', '011111', '110', '0100']",1,7,19,21,5,40,12.12100122100122,73,58
"['0010001', '11', '1111110', '11101', '000']",1,5,10,14,2,24,3.796031746031746,43,27
"['0', '100', '1111']",1,3,3,5,0,8,0.7857142857142857,9,4
"['00111', '1101', '00010', '10000']",1,4,11,8,3,19,3.1333333333333333,17,15
"['0', '0010', '0111']",1,3,5,4,2,9,1.3,8,8
"['0', '0001', '0111101', '11111']",1,4,6,11,0,17,2.069191919191919,24,11
"['101010', '1011101', '011001']",1,3,8,11,2,19,2.2051282051282053,8,9
"['11001', '10101', '11111']",1,3,4,11,3,15,2.0,6,15
"['00011', '10000', '110100', '101101']",1,4,12,10,4,22,3.2666666666666666,18,18
"['01', '11010', '0010000']",1,3,9,5,0,14,1.5158730158730158,12,6
"['001', '101', '01111', '011110', '0100']",1,5,9,12,2,21,5.651948051948052,26,26
"['1010110', '010000', '1', '1110000', '111100', '1010111', '100101', '0101001']",1,8,23,24,7,47,15.06043956043956,101,78
"['1001111', '0001100', '100111', '10']",1,4,10,12,2,22,3.498778998778999,21,19
"['010000', '1', '0100']",1,3,8,3,0,11,1.4857142857142858,10,8
"['000111', '0001000', '101101']",1,3,11,8,2,19,1.7435897435897436,10,9
"['10001', '010', '110', '01000']",1,4,10,6,4,16,3.716666666666667,14,13
"['100100', '0011101', '1110000', '000']",1,4,14,9,2,23,3.8227106227106225,23,23
"['0', '110001', '111']",1,3,4,6,0,10,0.9523809523809523,11,6
"['1', '00001', '10111', '0101011', '001110', '0100']",1,6,14,14,2,28,6.906654456654457,49,32
"['01', '1110011', '1010', '0100001', '1011']",1,5,11,13,4,24,5.907287157287157,33,29
"['101000', '01111', '00', '1000', '001011']",1,5,13,10,2,23,4.783694083694083,33,33
"['0110101', '00', '011', '1110']",1,4,7,9,0,16,2.8946608946608947,19,15
"['1110111', '10101', '001010', '0100100', '11100']",1,5,14,16,4,30,5.85024975024975,30,25
"['01', '001', '10000']",1,3,7,3,0,10,1.5857142857142859,8,8
"['0111010', '001111', '10001', '10101', '10000', '0010101']",1,6,18,17,5,35,9.24062604062604,44,43
"['110', '100000', '1']",1,3,6,4,0,10,1.2301587301587302,11,6
"['1110101', '10111', '1010110', '100010']",1,4,10,15,2,25,3.657176157176157,16,21
"['10111', '0001', '0011', '100']",1,4,8,8,2,16,3.503968253968254,14,17
"['1', '100010', '000', '0101', '110']",1,5,10,7,2,17,4.373015873015873,28,19
"['11110', '010', '100011']",1,3,6,8,0,14,1.308080808080808,11,6
"['01', '0001', '11']",1,3,4,4,2,8,1.5,6,7
"['01', '0011101', '10110', '10100', '00', '1011100']",1,6,14,14,6,28,8.911111111111111,47,48
"['01001', '0110', '000', '1001010']",1,4,12,7,0,19,3.732034632034632,17,16
"['1001', '0100110', '01000']",1,3,10,6,0,16,2.2272727272727275,7,7
"['100', '10110', '1110', '11']",1,4,5,9,0,14,3.848412698412698,12,17
"['0011011', '101', '000101', '1']",1,4,8,9,0,17,3.0716117216117214,22,17
"['110010', '10001', '110']",1,3,7,7,0,14,1.893939393939394,8,9
"['1011', '1', '000']",1,3,4,4,0,8,0.6857142857142857,9,4
"['110000', '010', '001111', '011111', '1010001']",1,5,13,15,3,28,5.125641025641025,38,25
"['1101001', '01', '111010', '0000101', '000100']",1,5,16,12,4,28,5.432844932844933,38,25
"['00100', '11', '0110', '101101']",1,4,8,9,0,17,3.4645021645021643,17,8
"['00101', '1000111', '011001']",1,3,9,9,0,18,1.8275058275058274,9,7
"['0110010', '1001', '000']",1,3,9,5,0,14,1.8987012987012988,9,4
"['1000101', '1010', '1', '000001']",1,4,11,7,0,18,2.6783716283716283,23,16
"['0011111', '1100', '000101', '0111011']",1,4,10,14,2,24,3.397002997002997,21,18
"['11001', '111110', '1001111', '11']",1,4,5,15,0,20,3.343378843378843,22,29
"['001', '0001', '110', '0110001', '0100']",1,5,13,8,4,21,5.773593073593074,27,31
"['01101', '0111010', '101', '010011', '01011']",1,5,11,15,2,26,6.616083916083916,24,30
"['10111', '000', '1011111']",1,3,5,10,0,15,1.2833333333333334,12,10
"['1100001', '1010', '1111']",1,3,6,9,2,15,1.5909090909090908,10,10
"['0', '1101', '0101', '1111']",1,4,4,9,3,13,2.8,14,14
"['100110', '010000', '011']",1,3,9,6,2,15,1.7777777777777777,10,7
"['1011', '10100', '110', '100001']",1,4,9,9,0,18,3.327994227994228,15,19
"['0', '1100', '00001']",1,3,7,3,0,10,1.1777777777777778,10,7
"['11', '0110', '1001000', '0010011', '100011', '000']",1,6,17,12,2,29,8.283460983460984,52,42
"['00', '01111', '10']",1,3,4,5,2,9,1.0714285714285714,9,6
"['0010', '001111', '100', '011101', '1000']",1,5,12,11,4,23,5.90079365079365,31,29
"['1011001', '101', '10001', '000101', '11100']",1,5,13,13,2,26,6.169114219114219,28,39
"['011011', '01', '101001']",1,3,6,8,2,14,1.6666666666666665,11,8
"['1100', '10', '000']",1,3,6,3,0,9,1.638095238095238,6,8
"['1001000', '10', '0100']",1,3,9,4,0,13,1.8383838383838382,10,8
"['100', '001', '011000']",1,3,8,4,2,12,1.7777777777777777,9,9
"['1000001', '110000', '111', '00001', '00100', '1000111', '1110']",1,7,21,16,4,37,11.44897324897325,69,70
"['010', '00011', '101', '1111', '110', '0011100', '0111100']",1,7,14,18,5,32,11.86955266955267,66,53
"['01', '101011', '1010', '10010', '110111', '10011', '1010010']",1,7,15,20,4,35,14.363836163836163,53,80
"['1001110', '1', '1000110', '1100100', '1011', '0100011']",1,6,16,17,4,33,8.374025974025974,55,42
"['0101010', '1000', '00', '1111011']",1,4,10,10,2,20,2.9956709956709955,24,12
"['1000100', '11110', '001', '1010111', '0110000', '00', '1000']",1,7,20,15,3,35,10.799206349206349,76,62
"['0010001', '0', '1010101', '1111001', '111111', '100101']",1,6,14,20,5,34,7.096153846153847,57,50
"['0', '1100010', '1100101', '100110']",1,4,11,10,2,21,2.8736263736263736,24,14
"['0001', '0110110', '111011']",1,3,7,10,0,17,1.5328671328671328,10,4
"['00', '1111110', '101111', '1111']",1,4,4,15,0,19,2.614879564879565,22,25
"['101', '010', '01011', '0111']",1,4,6,9,2,15,3.9761904761904763,11,15
"['0110100', '0010101', '0001101', '110111', '1100']",1,5,15,16,3,31,6.368231768231769,31,30
"['0', '110000', '1000111', '0100']",1,4,11,7,0,18,2.6965534465534464,26,12
"['0', '0001001', '1110001', '1101110']",1,4,11,11,3,22,2.321428571428571,31,13
"['10100', '01011', '0000']",1,3,9,5,2,14,1.488888888888889,8,8
"['01', '0011110', '1010100', '0110', '10010']",1,5,13,12,2,25,5.503607503607503,32,29
"['1011', '111100', '0001000']",1,3,9,8,0,17,1.2251748251748253,12,7
"['00111', '011', '111', '100010']",1,4,7,10,2,17,3.6010101010101008,16,19
"['0', '0111010', '110', '001011']",1,4,8,9,0,17,2.5416971916971915,24,16
"['0010110', '1', '0110011', '0001111']",1,4,10,12,3,22,2.75,28,12
"['001', '00101', '10111', '100', '1011']",1,5,9,11,4,20,6.215079365079365,22,33
"['10110', '1100', '0011010', '11']",1,4,8,10,0,18,3.743145743145743,18,14
"['11010', '010', '0001', '100', '10110']",1,5,11,9,4,20,6.298412698412698,22,26
"['11010', '01', '111', '0101101', '000', '0101100', '1011011']",1,7,15,19,5,34,11.383333333333333,70,53
"['11001', '0111010', '00', '100011', '11111']",1,5,10,15,2,25,5.001653901653902,34,21
"['0', '11', '011101', '1111010', '0101']",1,5,7,13,0,20,4.6615107115107115,35,23
['110011'],1,1,2,4,0,6,0,0,0
"['01', '1101', '0011110', '0110']",1,4,7,10,2,17,3.80050505050505,18,14
"['0100110', '010110', '111101', '00000']",1,4,13,11,2,24,3.265734265734266,19,17
"['0', '1010', '11']",1,3,3,4,0,7,1.0666666666666667,7,4
"['0', '010', '1110']",1,3,4,4,0,8,1.4714285714285715,7,9
"['111', '100000', '10', '1001011', '0110010', '1010010', '01110']",1,7,19,18,3,37,11.539155289155289,73,58
"['0001', '1101011', '101111']",1,3,6,11,0,17,1.379020979020979,10,10
"['1011101', '10', '11']",1,3,3,8,2,11,1.3888888888888888,11,9
"['11', '0001', '1101000', '00', '010111']",1,5,11,10,2,21,4.295881895881895,36,29
"['0100001', '00', '1110111', '11']",1,4,8,10,4,18,1.984126984126984,27,14
"['110010', '101110', '0111011', '11']",1,4,7,14,2,21,3.3290598290598292,22,18
"['0001001', '11', '101', '0000', '01110']",1,5,12,9,0,21,4.673304473304473,33,21
"['110000', '01', '10', '001000']",1,4,11,5,4,16,2.9166666666666665,22,15
"['101000', '1110110', '010010']",1,3,10,9,2,19,2.0641025641025643,8,7
"['1000001', '1110111', '00101', '0110100', '00']",1,5,15,13,3,28,4.777777777777778,40,22
"['00110', '1101', '011', '101011']",1,4,7,11,0,18,3.982034632034632,15,14
"['0010', '1', '00011']",1,3,6,4,0,10,1.4,9,5
"['1100010', '1010', '0101000', '011001']",1,4,14,10,2,24,4.307292707292707,18,15
"['0111001', '001010', '10', '0101100', '00010']",1,5,16,11,2,27,5.9421689421689425,34,34
"['0', '01010', '0010101', '001000']",1,4,13,6,0,19,3.198884448884449,21,22
"['11000', '010', '01000', '11']",1,4,9,6,2,15,3.307142857142857,15,17
"['10111', '100', '110']",1,3,4,7,2,11,1.6666666666666665,7,8
"['1', '00101', '00001', '101011', '10001', '01010']",1,6,15,12,4,27,7.964502164502164,42,37
"['0', '1101', '1100000', '01']",1,4,8,6,0,14,2.7510101010101007,22,13
"['1010', '1', '0010', '0111']",1,4,6,7,3,13,2.95,15,12
"['0010110', '0', '010', '00101', '111', '00011']",1,6,13,11,4,24,7.3,46,39
"['10100', '001', '10', '01000']",1,4,10,5,2,15,3.342857142857143,16,16
"['010', '0110001', '1001', '100', '0000', '01000']",1,6,18,8,4,26,9.877489177489178,35,45
"['10100', '110', '1110']",1,3,5,7,0,12,1.8015873015873014,5,9
"['0101011', '10', '10011', '0101', '01011']",1,5,10,13,2,23,7.003463203463204,26,38
"['1011010', '01', '000101', '10']",1,4,9,8,2,17,2.8504273504273505,23,15
"['010', '111', '000011']",1,3,6,6,2,12,1.222222222222222,10,6
"['1100010', '1', '00011']",1,3,7,6,0,13,1.25,13,7
"['11110', '1110010', '111100', '010111', '10011', '1101', '011010']",1,7,14,25,5,39,13.27878787878788,56,68
"['0010000', '1001', '10011', '0001010', '0101', '001100']",1,6,21,12,4,33,10.015878565878566,45,40
"['00111', '1000', '0111', '11']",1,4,6,9,2,15,3.1547619047619047,17,20
"['011', '000011', '00101', '011100', '101101', '0001', '0000101', '010110', '011001']",1,9,27,22,5,49,23.101381951381953,98,112
"['1001', '1', '000']",1,3,5,3,0,8,0.9714285714285714,8,4
"['0100001', '1010', '1', '0000']",1,4,11,5,2,16,2.422727272727273,22,10
"['1100101', '00101', '00000']",1,3,11,6,2,17,1.9333333333333333,8,10
"['001111', '011', '0110111', '00011', '0100010', '101011']",1,6,15,19,4,34,9.758025308025308,43,47
"['1101001', '0111101', '00000']",1,3,10,9,2,19,1.2380952380952381,12,5
"['0', '101', '0110', '001111']",1,4,6,8,0,14,2.8015873015873014,20,10
"['11000', '100000', '11']",1,3,8,5,0,13,1.5487012987012987,10,10
"['0000111', '00', '001', '0011000']",1,4,13,6,2,19,3.4603174603174605,24,29
"['00100', '001011', '0111100']",1,3,10,8,0,18,1.8554778554778555,9,16
"['0', '011', '0001', '11101', '011110', '01110']",1,6,10,14,2,24,8.065728715728715,44,42
"['000011', '10101', '0001111', '0001100', '000001', '1101']",1,6,20,15,4,35,8.601698301698303,45,53
"['1101', '100101', '11']",1,3,4,8,0,12,1.9666666666666668,8,16
"['1100111', '1101', '0111101', '1001']",1,4,7,15,4,22,3.866883116883117,18,26
"['10', '01110', '1011111', '00001']",1,4,8,11,2,19,2.7015873015873013,24,12
"['01', '100', '001010']",1,3,7,4,0,11,1.5666666666666667,9,7
"['00100', '00101', '011']",1,3,8,5,2,13,2.05,6,10
"['010000', '1111101', '1', '00100', '0001']",1,5,13,10,0,23,4.267649017649018,40,23
"['0', '100110', '0001']",1,3,7,4,0,11,1.2857142857142856,11,6
"['0', '010010', '0000111']",1,3,9,5,0,14,1.151098901098901,14,8
"['0111001', '0110111', '1001010', '11', '100100', '000111', '110']",1,7,17,21,5,38,11.836507936507937,76,61
"['0', '101100', '00001']",1,3,8,4,0,12,0.9826839826839826,13,7
"['1101001', '1', '1100000', '001010', '1100', '01110']",1,6,16,14,2,30,7.558741258741259,56,37
"['10000', '110', '1011100']",1,3,8,7,0,15,1.6,10,8
"['11000', '1010110', '1100000', '1']",1,4,11,9,2,20,2.5952380952380953,25,18
"['01', '010001', '1000111', '111011', '0110010', '01011']",1,6,15,18,4,33,8.614496614496614,49,44
"['010', '100', '1011001', '01010']",1,4,10,8,2,18,4.033333333333333,18,15
"['1011101', '11011', '011110', '111001']",1,4,7,17,2,24,4.144522144522145,16,15
"['1000', '011110', '1111']",1,3,5,9,2,14,1.4500000000000002,9,4
"['0100011', '100', '1']",1,3,6,5,0,11,1.35,12,6
"['01', '0001', '0110']",1,3,6,4,2,10,1.8333333333333333,7,8
"['100101', '10', '111', '0110011']",1,4,7,11,0,18,3.3803418803418803,21,17
"['01', '001111', '1011101', '1111', '110', '01011']",1,6,8,19,0,27,8.4999666999667,44,47
"['00', '1001000', '10', '01110']",1,4,10,6,2,16,2.865079365079365,21,18
"['0011', '110001', '001011']",1,3,8,8,2,16,1.9,9,12
"['0', '1100001', '1001000', '111']",1,4,10,8,2,18,2.2142857142857144,27,12
"['011', '111', '0010101', '011101', '00110', '10']",1,6,11,15,2,26,8.941863691863691,42,37
"['0111000', '110010', '11011', '101000', '00', '0111']",1,6,15,15,2,30,8.601953601953602,49,44
"['0111000', '01', '0110100', '000', '1110110']",1,5,14,12,3,26,5.276190476190476,37,37
"['1011', '0001', '0100111', '11']",1,4,7,10,2,17,3.398989898989899,18,19
"['11010', '01100', '1010000', '011010', '0110001']",1,5,17,13,4,30,7.550416250416251,23,37
"['1', '110', '000010']",1,3,6,4,0,10,1.2301587301587302,11,5
"['1011', '01001', '0111111']",1,3,5,11,0,16,1.712121212121212,10,8
"['1', '100100', '1101101', '1010', '10011']",1,5,10,13,0,23,5.472311022311023,33,32
"['00101', '101', '10111', '0000000', '1111', '110']",1,6,13,14,4,27,7.087301587301587,51,43
"['001', '0010000', '1001']",1,3,10,4,0,14,2.0025974025974023,9,9
"['1101101', '000101', '0000101', '00', '1000']",1,5,16,10,2,26,5.55965145965146,34,39
"['0010001', '11', '1011101', '0001', '01000']",1,5,14,11,2,25,5.17027417027417,35,27
"['1', '1001', '0110', '100000', '000']",1,5,12,6,2,18,4.395238095238096,31,22
"['000110', '1101', '1']",1,3,5,6,0,11,1.2857142857142856,12,4
"['001100', '0100000', '100100', '0111110']",1,4,16,10,4,26,3.415750915750916,18,25
"['100110', '1100', '10000']",1,3,9,6,0,15,1.993939393939394,7,9
"['1100010', '1001', '1']",1,3,6,6,0,12,1.3772727272727274,12,8
"['11', '101011', '110100', '1101', '110101']",1,5,8,16,3,24,6.7,26,55
"['001', '1', '110']",1,3,3,4,2,7,1.3333333333333333,7,6
"['001', '11011', '1']",1,3,3,6,0,9,1.3333333333333333,9,8
"['01111', '01010', '1', '000011']",1,4,8,9,2,17,2.643290043290043,21,12
"['01111', '001', '1']",1,3,3,6,0,9,1.3333333333333333,9,6
"['001001', '010110', '000000']",1,3,13,5,3,18,1.8333333333333333,8,10
"['0', '111', '11000', '10000', '1010', '10010']",1,6,13,10,3,23,7.843650793650793,39,38
"['0', '11010', '0011101']",1,3,6,7,0,13,1.25,14,6
"['00000', '1111', '1000010', '1100101', '000010', '1011', '0100']",1,7,22,15,5,37,10.884565434565435,67,56
"['11100', '1', '10', '0010011']",1,4,7,8,0,15,2.765873015873016,23,14
"['101', '00110', '0000']",1,3,8,4,0,12,1.4523809523809523,8,6
"['1110010', '00110', '0100111']",1,3,9,10,2,19,1.7380952380952381,11,9
"['1101', '0001110', '0100']",1,3,8,7,2,15,1.4090909090909092,11,5
"['10101', '011101', '000010', '1010011', '101001']",1,5,15,15,3,30,6.5,26,35
"['0', '010000', '0011', '111111', '001001']",1,5,12,11,3,23,3.738095238095238,41,24
"['001100', '00', '000100']",1,3,11,3,2,14,1.8333333333333335,9,25
"['0001101', '11011', '111']",1,3,5,10,0,15,2.0166666666666666,10,12
"['0010011', '1000010', '10', '011001', '011010', '01011']",1,6,18,15,4,33,8.904706404706404,48,42
"['1000001', '11', '101', '0110000', '111101']",1,5,12,13,2,25,5.492918192918193,38,31
"['11001', '0010001', '0000']",1,3,11,5,0,16,1.6565656565656566,9,8
"['11001', '01101', '1', '0111111', '011001', '0001010', '01011', '01000', '0111100']",1,9,22,26,7,48,19.32186147186147,118,106
"['1011011', '1100', '1111']",1,3,4,11,2,15,1.7727272727272727,9,13
"['1011010', '00', '000101']",1,3,9,6,0,15,1.4059829059829059,12,8
"['1111010', '01001', '00101']",1,3,8,9,2,17,1.8,10,7
"['0', '000101', '011000']",1,3,9,4,2,13,1.0714285714285714,14,10
"['10000', '00010', '100', '01011']",1,4,12,6,3,18,3.55,16,18
"['101', '011', '0101001']",1,3,6,7,2,13,1.8666666666666667,10,8
"['0', '1010011', '1011', '110', '111001']",1,5,8,13,0,21,5.170313020313021,33,29
"['010100', '111100', '111', '101', '1000', '0001011', '0100']",1,7,17,16,6,33,11.633827283827284,63,63
"['01', '1000', '001', '0110']",1,4,8,5,2,13,3.4428571428571426,13,15
"['00011', '1001', '001010', '10', '0111', '0111110']",1,6,13,15,2,28,8.197058497058498,48,37
"['01101', '0001', '10', '1011', '11100', '01100']",1,6,12,13,5,25,8.525396825396825,38,39
"['1111100', '1010000', '01111', '1011']",1,4,9,14,2,23,3.147186147186147,21,20
"['11110', '111000', '0010111', '11']",1,4,7,13,0,20,3.2046842046842046,23,25
"['0010110', '0010', '010']",1,3,9,5,0,14,2.1844155844155844,8,19
"['0001', '001010', '001000']",1,3,12,4,2,16,2.033333333333333,6,16
"['1011', '0010', '1001', '1110100']",1,4,9,10,3,19,3.6363636363636362,17,13
"['11011', '010', '1110000', '11', '10011']",1,5,9,13,2,22,5.1873015873015875,33,34
"['01', '0111', '0000', '0110010', '01000']",1,5,14,8,2,22,5.483044733044733,28,37
"['111111', '00101', '000']",1,3,6,8,0,14,1.1136363636363638,12,6
"['00111', '110010', '010', '1']",1,4,7,8,0,15,2.831168831168831,21,13
"['0', '01101', '1100', '001010']",1,4,9,7,0,16,3.012987012987013,19,15
"['1011101', '010011', '100', '010001']",1,4,11,11,2,22,3.9974358974358974,18,17
"['101011', '00', '1101']",1,3,5,7,0,12,1.4333333333333333,9,5
"['0', '001110', '1000101']",1,3,8,6,0,14,1.151098901098901,15,4
"['0100011', '110', '00000']",1,3,10,5,0,15,1.15,12,7
"['0', '1011', '000111']",1,3,5,6,0,11,1.2857142857142856,11,5
"['0010010', '0101', '1001010', '11']",1,4,11,9,2,20,3.7243867243867244,20,12
"['1100010', '0110000', '00', '001']",1,4,13,6,2,19,3.546031746031746,22,19
"['00111', '010010', '100000', '011001', '1010001']",1,5,18,12,3,30,6.108391608391608,30,23
"['00110', '100', '01010', '1101']",1,4,9,8,2,17,3.954761904761905,14,12
"['01', '001111', '01111', '110011', '00', '0110110']",1,6,11,17,4,28,8.739038739038739,50,42
"['001111', '0111011', '00001']",1,3,8,10,0,18,1.648018648018648,9,8
"['01000', '01', '00101', '1001011']",1,4,11,8,2,19,3.5206349206349206,20,13
"['0', '01', '1111001', '011001']",1,4,7,9,0,16,2.916056166056166,23,17
"['0101', '010111', '110100', '1100000']",1,4,12,11,2,23,3.3405594405594408,20,20
"['001100', '00', '001', '001111']",1,4,10,7,2,17,3.8,17,31
"['0010010', '100', '1']",1,3,7,4,0,11,1.35,12,5
"['00110', '0111001', '1']",1,3,6,7,0,13,1.0833333333333333,13,4
"['011', '0110000', '111111', '1011', '1100']",1,5,9,15,2,24,5.353435453435454,35,31
"['11011', '1101111', '100100', '1100', '0101010', '1010', '111110', '000100', '110']",1,9,21,27,7,48,20.73014763014763,102,117
"['0', '0111010', '00011', '100101', '011111']",1,5,11,14,2,25,4.812104562104562,39,22
"['0010', '0001', '11111', '1110', '0100']",1,5,10,11,4,21,4.583333333333333,28,26
"['0', '10010', '001011']",1,3,7,5,0,12,1.3463203463203464,12,6
"['0', '001', '11', '101010', '011101']",1,5,8,10,2,18,3.8603174603174604,33,19
"['01', '0100111', '1', '1100001', '1100000', '1011000']",1,6,17,14,4,31,7.079365079365079,65,43
"['0101011', '1111', '01000', '10010', '10', '111101']",1,6,12,17,2,29,7.3882339882339885,48,41
"['0010', '11', '10001', '111110', '1111011']",1,5,8,16,0,24,4.912376512376512,37,31
"['0000101', '0111010', '1001', '00011']",1,4,13,10,2,23,3.4805194805194803,20,13
"['0', '0100111', '11']",1,3,4,6,0,10,0.6944444444444444,13,6
"['1101', '0011110', '111']",1,3,4,10,0,14,2.0025974025974023,9,6
"['11', '10111', '1010101', '10100', '10011', '011010']",1,6,12,18,3,30,9.592296592296591,42,49
"['101', '00010', '001111', '1101110']",1,4,9,12,0,21,3.205283605283605,21,13
"['11001', '0111010', '1101011', '0000', '11111', '01000']",1,6,15,18,5,33,7.967821067821068,46,38
"['01', '010001', '01111', '1101110']",1,4,8,12,0,20,3.1895326895326894,22,17
"['110000', '100011', '011111', '111011']",1,4,9,15,4,24,3.1666666666666665,19,25
"['1010111', '11100', '1111001']",1,3,6,13,2,19,1.7619047619047619,10,14
"['0010', '10', '011000']",1,3,8,4,0,12,1.7666666666666666,9,10
"['01', '100000', '1111000', '10']",1,4,10,7,2,17,2.532051282051282,25,15
"['0', '10111', '0001', '1111001']",1,4,7,10,0,17,2.473232323232323,23,14
"['0001010', '0001', '11010']",1,3,10,6,0,16,1.8383838383838382,9,12
"['001011', '101101', '1010', '1011', '1001111']",1,5,10,17,4,27,7.227855477855478,24,41
"['01', '1100010', '1000000', '10', '001100', '1011']",1,6,17,11,4,28,7.5073704073704075,56,35
"['1', '10110', '0001100', '001010', '0111', '01011']",1,6,14,14,2,28,8.438278388278388,47,33
"['11110', '1', '0001101', '000100', '01100']",1,5,13,11,2,24,4.829187479187479,36,26
"['11110', '011100', '00111', '10', '011010']",1,5,10,14,4,24,6.017748917748918,30,30
"['010', '010000', '10110', '00', '0101']",1,5,13,7,0,20,6.624025974025974,25,35
"['0101110', '100001', '01111', '010101', '10', '1110']",1,6,13,17,2,30,8.091930291930291,49,42
"['11', '00100', '00110', '110111', '0111101']",1,5,10,15,2,25,5.292729492729492,34,23
"['0101000', '1111101', '0011010', '1110001', '0111', '1011', '0101']",1,7,17,23,7,40,12.73051948051948,70,57
"['00110', '11011', '100011']",1,3,7,9,2,16,2.0545454545454547,8,7
"['00100', '000111', '10', '0101', '1111111', '1111011']",1,6,11,20,2,31,7.156193806193806,58,45
"['00010', '100011', '111']",1,3,7,7,0,14,1.4217171717171717,9,6
"['0111', '00', '000011']",1,3,7,5,0,12,1.4333333333333333,10,9
"['01100', '100', '001010', '1']",1,4,9,6,0,15,3.262987012987013,18,14
"['0101101', '0011', '1000']",1,3,8,7,2,15,1.7727272727272727,10,7
"['0110101', '0111010', '10']",1,3,7,9,2,16,1.746031746031746,12,9
"['010', '111000', '1', '000001']",1,4,10,6,2,16,2.4603174603174605,24,12
"['01', '111000', '010011', '10']",1,4,8,8,4,16,2.75,23,14
"['0', '11100', '101101', '11']",1,4,5,9,0,14,2.4177489177489178,20,12
"['010100', '11', '1011100', '0100']",1,4,10,9,0,19,3.574281274281274,19,19
"['0010', '000111', '001100', '0101', '111001']",1,5,14,12,5,26,6.183333333333334,31,27
"['1', '1001', '100010', '10100', '010111']",1,5,11,11,2,22,4.962337662337662,33,26
"['0010001', '00101', '10111', '1010', '1011', '0100']",1,6,15,14,5,29,9.751515151515152,37,42
"['0', '0111', '1111']",1,3,2,7,2,9,1.15,8,8
"['110011', '0010010', '1100', '1101110']",1,4,11,13,2,24,4.0287712287712285,18,21
"['01', '01101', '11', '1100000', '000100', '1100']",1,6,15,11,2,26,7.56045621045621,51,44
"['1111100', '110111', '011001']",1,3,6,13,2,19,1.7435897435897436,10,9
"['111', '101101', '0001', '00', '1110110']",1,5,9,13,0,22,4.696359196359197,35,25
"['0110010', '0010', '0110']",1,3,9,6,2,15,2.2045454545454546,7,20
"['1', '0011010', '1111001', '00010', '111101']",1,5,11,15,2,26,4.616383616383616,40,24
"['0010110', '101011', '1000010', '1010001', '0000110', '0011100']",1,6,24,17,5,41,10.098901098901099,43,42
"['010', '011', '01011']",1,3,5,6,2,11,2.1666666666666665,5,12
"['11', '00', '1010100', '011001']",1,4,9,8,2,17,2.658119658119658,23,12
"['011', '00000', '10001', '1010100', '1111', '010101']",1,6,16,14,2,30,7.653285603285603,46,35
"['00101', '011100', '00111', '10', '1010011']",1,5,12,13,2,25,5.487368187368188,33,24
"['10000', '100100', '1100100']",1,3,12,6,0,18,2.6655011655011656,4,15
"['111', '101101', '00011', '11101', '1011', '1110']",1,6,8,19,4,27,9.966450216450216,33,69
"['101001', '0011', '01', '000']",1,4,9,6,0,15,3.1825396825396823,16,13
"['011', '10', '11']",1,3,2,5,2,7,1.7000000000000002,4,8
"['0', '1101', '1111']",1,3,2,7,2,9,1.15,8,6
"['01', '0011101', '001101', '11', '01100', '111011', '001010', '011010', '0110110']",1,9,21,26,8,47,23.33888333888334,105,107
"['00001', '11011', '110001', '11']",1,4,8,10,2,18,3.2116883116883117,18,30
"['001', '100000', '10', '0110']",1,4,10,5,0,15,2.9825396825396826,18,15
"['010011', '1101', '00011']",1,3,7,8,0,15,1.7535353535353535,7,11
"['0', '01101', '01100']",1,3,6,5,2,11,1.4666666666666668,9,11
"['1111', '10010', '111100', '00001']",1,4,9,11,2,20,2.9757575757575756,20,19
"['00100', '1010100', '01111', '100', '1010000']",1,5,16,11,4,27,5.647619047619048,32,38
"['0', '1100', '10']",1,3,4,3,0,7,1.7333333333333334,6,6
"['0', '00110', '1001']",1,3,6,4,0,10,1.4,10,4
"['1010000', '0101', '1100100']",1,3,11,7,2,18,1.8051948051948052,10,7
"['1', '00000', '1101101', '0010101', '0001111', '1111011']",1,6,15,19,4,34,6.523809523809524,66,46
"['1001', '100', '11']",1,3,4,5,0,9,1.9238095238095236,5,10
"['01', '0110111', '111', '0000100', '10000', '0100001', '1011011', '110', '0011100']",1,9,25,23,7,48,18.70079365079365,139,95
"['1000', '010', '0010111']",1,3,8,6,0,14,1.535064935064935,11,7
"['11110', '00110', '1011011', '000010']",1,4,11,12,2,23,3.331934731934732,18,16
"['1011101', '11101', '111110', '000', '110']",1,5,8,16,2,24,5.552059052059052,31,28
"['0110', '00101', '111101', '1111']",1,4,6,13,2,19,3.5565656565656565,15,18
"['0010', '11011', '110100', '10', '1010000']",1,5,13,11,0,24,5.768942168942169,32,27
"['01', '1011001', '1000101', '101000', '1111', '0000', '01110']",1,7,18,17,4,35,10.096736596736596,70,50
"['11001', '010', '1100', '11']",1,4,6,8,0,14,3.598412698412698,13,17
"['0110101', '01', '101001']",1,3,7,8,0,15,1.7136752136752138,12,10
"['001', '1101111', '00000', '101011', '0011', '0001011', '0101001', '011000']",1,8,24,21,5,45,15.941558441558442,90,89
"['1000101', '1', '1100001', '1000010', '1010', '01001']",1,6,18,13,3,31,8.721428571428572,53,47
"['00', '010010', '101111', '11111']",1,4,7,12,2,19,2.340909090909091,23,14
"['11110', '11', '00001', '101', '00010', '001001', '0000110', '0110001']",1,8,23,17,5,40,15.492651792651793,92,79
"['01', '0101110', '0110100', '111', '101011', '100110', '0000010']",1,7,19,19,5,38,11.273137973137974,76,49
"['010001', '011', '0100']",1,3,8,5,0,13,2.038095238095238,7,11
"['11110', '001', '00100', '010111', '100011', '1011']",1,6,13,16,4,29,8.238095238095237,43,40
"['101', '001001', '10011']",1,3,7,7,0,14,2.143939393939394,8,10
"['00100', '10111', '0110001']",1,3,9,8,2,17,1.5666666666666667,10,4
"['0111000', '110000', '01', '00', '01011']",1,5,13,9,2,22,4.914613164613165,36,32
"['0011101', '00101', '00001']",1,3,10,7,2,17,1.9333333333333333,6,14
"['00100', '00010', '0011101']",1,3,11,6,2,17,2.1333333333333333,8,14
"['0010111', '00001', '00', '0111111', '101001']",1,5,13,14,2,27,4.793206793206793,37,27
"['011011', '101', '10010', '100011', '000', '110']",1,6,13,13,5,26,8.66161616161616,40,37
"['11001', '01', '1010100', '01010', '000']",1,5,13,9,2,22,5.737301587301587,30,22
"['010', '100100', '1', '00001']",1,4,10,5,0,15,2.831168831168831,20,11
"['1100111', '110', '000', '1']",1,4,6,8,2,14,2.0833333333333335,22,13
"['010', '110', '00011']",1,3,6,5,2,11,1.6666666666666665,8,8
"['00110', '1', '001110']",1,3,6,6,0,12,1.528138528138528,10,9
"['1101000', '010000', '10010', '0000000']",1,4,19,6,2,25,3.5253080253080253,16,26
"['0', '010101', '001011']",1,3,7,6,2,13,1.4047619047619047,12,6
"['110000', '00001', '1000111', '1111010', '00', '1110100']",1,6,18,16,3,34,8.17965367965368,58,48
"['101110', '01', '111']",1,3,3,8,0,11,1.5666666666666667,9,6
"['0', '00110', '0111']",1,3,5,5,0,10,1.4,9,8
"['001', '001110', '0101011']",1,3,8,8,0,16,1.682051282051282,10,8
"['0010001', '00100', '10']",1,3,10,4,0,14,1.8492063492063493,10,11
"['0001100', '010', '11']",1,3,7,5,0,12,1.4444444444444444,11,4
"['101', '11100', '0100']",1,3,6,6,0,12,1.7380952380952381,7,6
"['01', '011', '10', '1111']",1,4,3,8,2,11,2.9380952380952383,13,15
"['01', '010', '011', '0110000', '010111']",1,5,11,10,2,21,6.205982905982906,30,35
"['001', '010', '000101']",1,3,8,4,2,12,2.0,8,8
"['101111', '0101', '0110110']",1,3,6,11,0,17,1.9426573426573426,9,5
"['101', '100', '010010', '010011', '0110011']",1,5,13,12,4,25,7.058974358974359,25,29
"['0011001', '0010', '10']",1,3,8,5,0,13,1.8383838383838382,10,9
"['0', '01', '111011']",1,3,3,6,0,9,1.4523809523809523,10,4
"['0011', '10', '1111']",1,3,3,7,2,10,1.1666666666666665,8,8
"['0110010', '001', '1101111']",1,3,7,10,2,17,1.5714285714285714,13,4
"['1110010', '11', '101010', '101011', '0110', '00', '10011']",1,7,14,18,4,32,11.944333444333445,62,58
"['101011', '0011', '000', '0011011', '1011']",1,5,11,13,2,24,6.475363525363526,26,42
"['11011', '0000010', '0100']",1,3,10,6,0,16,1.323232323232323,12,5
"['101', '1101110', '00110', '110', '0011100']",1,5,11,14,4,25,6.164285714285715,32,30
"['101101', '00', '11101', '10010', '1011100', '110', '0100']",1,7,15,17,2,32,12.566994116994117,59,54
"['0011101', '011', '101', '1001', '0011111', '000100', '0100']",1,7,17,17,6,34,12.229231879231879,67,59
"['01', '1100001', '1110']",1,3,6,7,0,13,1.323232323232323,12,8
"['0001101', '1111010', '1110110', '0']",1,4,9,13,3,22,2.75,28,15
"['0000', '1', '01110', '1011000']",1,4,10,7,0,17,2.2398989898989896,23,14
"['01101', '00', '001', '10']",1,4,7,5,2,12,3.342857142857143,12,15
"['110110', '010', '0100110', '00011', '00000', '0100001', '1001001']",1,7,25,15,5,40,12.742546342546342,63,61
"['110000', '1', '111101']",1,3,5,8,2,13,1.0714285714285714,13,9
"['00', '100', '0010']",1,3,7,2,0,9,2.038095238095238,5,13
"['0000100', '010010', '1011', '011010', '0100']",1,5,17,10,4,27,6.0755244755244755,27,35
"['0', '11110', '10101']",1,3,4,7,2,11,1.0666666666666667,11,4
"['00100', '00010', '11', '00011']",1,4,11,6,3,17,3.342857142857143,17,19
"['0', '1000', '00011']",1,3,7,3,0,10,1.4,10,8
"['1001110', '010011', '10', '11']",1,4,7,10,2,17,3.158119658119658,22,16
"['11011', '1001', '0110', '000101', '111000']",1,5,12,13,4,25,5.824242424242424,31,23
"['0001', '110', '1']",1,3,4,4,0,8,1.1857142857142857,8,6
"['1010010', '00', '10011', '0101', '01100']",1,5,13,10,2,23,6.0660894660894655,31,22
"['01000', '0100', '0001111']",1,3,10,6,0,16,1.7525252525252526,11,15
"['110', '1100100', '01000']",1,3,9,6,0,15,1.7666666666666666,10,9
"['11', '11011', '111001']",1,3,3,10,0,13,1.7987012987012987,9,20
"['0010110', '000011', '1000010', '1010', '10010', '000', '110']",1,7,22,13,4,35,12.60041625041625,59,71
"['00', '1100101', '11']",1,3,5,6,2,11,0.8888888888888888,12,6
"['1000011', '001', '011', '0110001']",1,4,11,9,4,20,3.780952380952381,20,18
"['101', '01001', '11011', '11']",1,4,5,10,2,15,4.042857142857143,13,23
"['1100010', '100', '11']",1,3,6,6,0,12,1.4444444444444444,11,8
"['101011', '01111', '111', '1100110']",1,4,6,15,0,21,3.6091297591297593,18,25
"['0', '10001', '010110', '1111']",1,4,7,9,0,16,2.008946608946609,23,8
"['010', '11', '0111', '0101', '0111110']",1,5,7,13,2,20,6.229076479076479,26,30
"['11001', '01', '001011']",1,3,6,7,0,13,1.6168831168831168,10,8
"['11100', '110', '011', '1110']",1,4,5,10,2,15,4.234126984126984,11,22
"['10111', '0110', '0010100', '1']",1,4,8,9,0,17,2.8772727272727274,22,8
"['0011', '1010', '1', '00000']",1,4,9,5,2,14,2.188888888888889,19,12
"['0010', '011', '101011', '100', '011110', '0111']",1,6,11,15,6,26,8.663492063492063,39,42
"['1010001', '01001', '10110']",1,3,9,8,2,17,2.1,8,10
"['110000', '1000', '10011', '00010', '0100101']",1,5,17,10,2,27,7.015384615384615,24,27
"['1010', '10010', '1', '011']",1,4,6,7,0,13,3.1936507936507934,15,15
"['11110', '101', '1010', '0011111', '110']",1,5,7,15,2,22,5.61998556998557,29,31
"['0', '100100', '010101', '10011', '0111', '1011']",1,6,12,14,4,26,8.5497113997114,44,38
"['010', '1100', '0110110']",1,3,7,7,0,14,1.8987012987012988,9,10
"['00111', '10110', '0110100', '0000']",1,4,12,9,2,21,3.1858585858585857,18,19
"['1001001', '111110', '1100110']",1,3,8,12,2,20,1.4835164835164836,9,9
"['1', '1010', '0000', '0001011', '0111100']",1,5,13,10,4,23,4.01038961038961,41,25
"['0110', '11111', '00010', '110', '01000']",1,5,11,11,3,22,5.134920634920634,27,29
"['0', '10111', '000011', '0100']",1,4,9,7,0,16,2.408946608946609,21,12
"['010', '110', '100101']",1,3,6,6,2,12,1.7777777777777777,7,5
"['0', '101000', '10101', '1100']",1,4,9,7,0,16,3.212987012987013,18,14
"['0', '110110', '1110101', '1010', '11101']",1,5,8,15,0,23,5.792823842823843,33,27
"['1010110', '010001', '1', '0001', '01111']",1,5,11,12,0,23,4.537967587967588,37,24
"['010', '0001111', '111110', '11101', '011010']",1,5,10,17,2,27,5.863092463092463,33,30
"['11', '011110', '0110010', '000111', '1101010']",1,5,12,16,4,28,5.7203907203907205,36,29
"['0111010', '001000', '0111111', '10', '0110001']",1,5,14,15,3,29,5.303418803418803,38,30
"['1011010', '11010', '111011', '10010', '0111', '0001011', '101110', '011000']",1,8,20,26,7,46,18.421933621933622,74,86
"['00', '0010100', '1111110', '10']",1,4,9,9,4,18,2.341269841269841,26,19
"['0010111', '111', '011011', '00', '100111', '1101']",1,6,10,18,2,28,8.71883671883672,46,52
"['0', '001110', '1100100']",1,3,8,6,0,14,1.151098901098901,15,9
"['011', '00001', '00000', '11000', '0100', '10100', '1101010']",1,7,22,12,4,34,12.193145743145744,55,72
"['11', '00', '00011']",1,3,5,4,2,9,1.1428571428571428,8,8
"['1', '0111101', '100011', '1111101']",1,4,6,15,2,21,2.5659340659340657,27,24
"['011', '111', '00111', '101', '0000']",1,5,8,10,3,18,5.015873015873016,24,27
"['1010', '01111', '10011', '000']",1,4,8,9,2,17,3.0325396825396824,17,12
"['010', '110', '01100']",1,3,6,5,2,11,2.1666666666666665,5,10
"['0', '1011001', '011000', '1010', '1101', '0100']",1,6,14,12,3,26,8.504945054945056,45,31
"['0000', '1000', '01001', '11']",1,4,10,5,2,15,2.765873015873016,15,14
"['11110', '0001', '1', '111010']",1,4,6,10,0,16,2.3685425685425687,21,15
"['11110', '010', '011', '00011', '100']",1,5,9,10,5,19,5.316666666666666,27,27
"['1010101', '010010', '100011', '000', '0111']",1,5,14,12,2,26,6.351448551448551,30,19
"['0', '1010101', '101001', '11']",1,4,7,9,0,16,2.403235653235653,23,16
"['1001101', '0011011', '111', '011000']",1,4,10,13,2,23,3.7323565323565324,21,13
"['010100', '11011', '1010111', '000001', '110']",1,5,13,14,2,27,4.815501165501166,33,25
"['110000', '110010', '1001', '0100']",1,4,12,8,4,20,4.183333333333334,14,14
"['110111', '1010', '00', '010110']",1,4,8,10,2,18,3.4833333333333334,18,11
"['01', '0001110', '0110100', '1000', '10']",1,5,13,9,4,22,5.082972582972583,38,29
"['11011', '010111', '10']",1,3,4,9,0,13,1.7987012987012987,9,8
"['0100010', '11000', '0001', '0100110']",1,4,15,8,2,23,4.145021645021645,16,20
"['0', '1011101', '0110', '1110000']",1,4,9,10,2,19,2.744155844155844,26,10
"['0010', '001101', '1111', '010111', '0111', '01001', '0101', '11100']",1,8,16,22,8,38,17.985858585858587,65,91
"['111', '01100', '00001']",1,3,7,6,2,13,1.15,10,5
"['1111', '10010', '011', '0000']",1,4,8,8,2,16,2.4682539682539684,17,12
"['110010', '010000', '100110', '11101', '011001']",1,5,15,14,4,29,6.878787878787879,26,22
"['0111001', '1', '1110']",1,3,4,8,0,12,1.3772727272727274,12,6
"['0', '1010', '1110']",1,3,4,5,2,9,1.3,7,7
"['0110101', '100', '010010']",1,3,9,7,0,16,1.882051282051282,9,7
"['0000101', '1111010', '1101011']",1,3,9,12,3,21,1.7142857142857142,11,8
"['111', '0001', '0010011', '00010', '01000']",1,5,15,9,2,24,5.22005772005772,29,30
"['0', '0110010', '1101011']",1,3,7,8,2,15,0.9285714285714286,15,4
"['0', '1110010', '01011', '1111']",1,4,6,11,0,17,2.255050505050505,23,17
"['0', '100', '10110', '011000']",1,4,9,6,0,15,3.262987012987013,19,16
"['1000100', '111100', '0111']",1,3,8,9,0,17,1.425174825174825,11,10
"['0010110', '01', '010010', '1110']",1,4,10,9,0,19,3.0204351204351205,20,19
"['010001', '0010111', '000011', '101', '1010', '001110', '1100110']",1,7,20,19,5,39,12.634632034632034,66,54
"['0', '11101', '0110', '0101000']",1,4,9,8,0,17,2.8772727272727274,22,13
"['1001110', '010', '1001010', '0110', '111110', '11111']",1,6,12,20,2,32,8.530097680097679,43,55
"['011101', '0011', '0100111', '00011']",1,4,10,12,0,22,4.21033411033411,15,19
"['101', '11101', '110', '010110']",1,4,6,11,2,17,4.2272727272727275,15,15
"['001', '1', '000011', '110100', '000']",1,5,12,7,4,19,4.2936507936507935,34,30
"['010100', '110111', '10', '001100', '0101']",1,5,12,12,3,24,6.0,31,24
"['01', '110', '100111', '0000']",1,4,8,7,0,15,2.3634920634920635,20,11
"['010100', '11010', '00011', '1101101', '01111', '11101', '1100101', '1100011']",1,8,19,28,7,47,18.23836163836164,77,108
"['011001', '0011', '000010', '000', '110', '011000']",1,6,18,10,5,28,8.83174603174603,43,56
"['11110', '11101', '001110', '1100100']",1,4,9,14,2,23,4.036596736596737,17,18
"['0101000', '00001', '01111', '000010', '011110', '001011']",1,6,20,15,5,35,8.395337995337995,41,55
"['001', '0110100', '0110', '0000101', '0100']",1,5,16,9,4,25,6.009740259740259,30,40
"['01111', '101011', '0101011']",1,3,6,12,0,18,1.9685314685314685,5,14
"['0000000', '011', '1001011', '11']",1,4,11,8,2,19,2.473015873015873,27,16
"['11001', '01', '100']",1,3,5,5,0,10,1.7214285714285715,7,7
"['1010110', '10001', '110001', '1101110', '110']",1,5,12,16,2,28,6.376490176490177,31,39
"['0101000', '1', '100100', '001110', '10011', '01011']",1,6,16,14,4,30,8.233316683316684,54,37
"['1', '0001', '0011010', '1111001', '0010101', '1000011']",1,6,17,16,4,33,7.192207792207792,61,39
"['101', '011010', '100', '111011']",1,4,7,11,4,18,3.7777777777777777,16,11
"['0', '011', '10', '11111']",1,4,3,8,0,11,2.3523809523809525,17,12
"['1111', '10', '0100011', '101001', '0110011']",1,5,11,15,2,26,5.808735708735709,34,31
"['00110', '00', '0101010', '10']",1,4,10,6,2,16,3.198412698412698,19,23
"['00', '1101110', '0001111']",1,3,7,9,2,16,1.4603174603174602,13,9
"['11001', '01', '1101111', '11', '01011']",1,5,6,15,4,21,5.407936507936507,31,42
"['0101101', '000110', '01110']",1,3,9,9,0,18,2.163170163170163,6,11
"['0', '01001', '11']",1,3,4,4,0,8,0.9047619047619047,9,4
"['100', '001', '010', '0110111']",1,4,8,8,3,16,3.4,19,14
"['0010', '11011', '1', '000011', '1100110']",1,5,11,12,0,23,5.034937284937285,35,27
"['10001', '011', '111011']",1,3,5,9,0,14,1.712121212121212,9,11
"['11000', '10101', '01011']",1,3,7,8,3,15,1.8,8,7
"['000', '00101', '110100']",1,3,9,5,0,14,1.7398989898989898,8,11
"['100', '1010', '000', '011111', '1101']",1,5,9,11,4,20,4.946825396825397,28,22
"['101111', '001001', '1011001', '0011100']",1,4,12,14,4,26,4.137362637362638,16,19
"['0', '10100', '1011100', '111001']",1,4,9,10,0,19,3.198884448884449,22,14
"['01', '0010', '11', '1100010', '0100011']",1,5,12,10,4,22,5.264790764790765,35,27
"['1101', '100', '01100']",1,3,6,6,0,12,1.9880952380952381,6,6
"['1101', '1', '1111000']",1,3,4,8,0,12,1.1954545454545453,13,9
"['0001', '1001', '00', '00110', '001100']",1,5,14,7,2,21,6.597186147186147,25,38
"['0001100', '11010', '11', '111011']",1,4,8,12,0,20,3.371350871350871,23,18
"['1101', '001', '10', '111']",1,4,4,8,2,12,3.2285714285714286,11,17
"['0', '11110', '010', '100011', '10011']",1,5,9,11,2,20,4.569552669552669,33,24
"['0100000', '11010', '0110111', '001111', '00001', '100', '10010', '000000']",1,8,27,17,7,44,15.044033744033744,95,93
"['01', '000011', '0101001', '0000010', '010110', '01110', '01000']",1,7,24,14,6,38,12.375002775002775,64,80
"['1111100', '010', '110']",1,3,5,8,2,13,1.6666666666666665,10,8
"['11000', '10001', '01011']",1,3,8,7,3,15,1.8,8,7
"['1011110', '0011', '11010', '011']",1,4,7,12,0,19,3.6137085137085134,18,17
"['0', '11', '100101', '000001', '011001']",1,5,12,9,3,21,3.9404761904761902,37,22
"['0', '0001110', '0101101', '101000', '1111', '10010', '110111']",1,7,16,20,4,36,10.055333555333556,76,48
"['0110111', '00001', '11000', '1001', '1100100', '10']",1,6,16,14,4,30,8.175036075036076,51,42
"['00111', '100', '001', '00101']",1,4,9,7,4,16,3.966666666666667,14,22
"['0011011', '1010010', '10']",1,3,8,8,2,16,1.4603174603174602,13,8
"['1', '0110', '110100', '0101010', '001110', '0000']",1,6,16,12,4,28,7.460589410589411,50,44
"['111010', '1', '101110']",1,3,4,9,2,13,1.2380952380952381,12,7
"['0100001', '00101', '111']",1,3,8,7,0,15,1.5666666666666667,11,7
"['0000101', '110', '0100110']",1,3,10,7,2,17,1.7142857142857144,12,8
"['101011', '01', '10']",1,3,4,6,2,10,1.5,10,7
"['0010', '1000', '010110', '011100']",1,4,12,8,4,20,3.6166666666666667,15,23
"['0001101', '00010', '100', '000']",1,4,13,5,2,18,3.75,17,29
"['11001', '00110', '111', '0']",1,4,6,8,2,14,2.5166666666666666,20,10
"['01', '00010', '000001']",1,3,10,3,0,13,1.7987012987012987,9,9
"['0001', '001001', '1101100']",1,3,10,7,0,17,1.579020979020979,11,11
"['1101001', '10', '01000', '000001']",1,4,13,7,0,20,3.093378843378843,21,14
"['0', '10100', '100011']",1,3,7,5,0,12,1.1645021645021645,12,5
"['0010', '010', '011', '10111', '10', '000', '001011']",1,7,14,12,3,26,12.762193362193361,47,59
"['01101', '0011000', '10111', '100', '001100']",1,5,14,12,2,26,6.429137529137529,28,32
"['0', '010', '111010', '1111', '010110']",1,5,8,12,2,20,4.557142857142857,33,30
"['11011', '0011000', '10011', '0101', '1110']",1,5,11,14,4,25,6.002020202020201,30,24
"['010', '1', '000011', '11000', '110']",1,5,10,8,2,18,4.97005772005772,32,25
"['0', '11010', '00001']",1,3,7,4,2,11,1.0666666666666667,12,6
"['0', '0010', '1111010', '01010', '11100']",1,5,11,11,2,22,5.0732323232323235,33,36
"['1110101', '0011110', '00101']",1,3,8,11,2,19,1.9047619047619047,10,9
"['0110111', '101101', '11000', '10001', '00100']",1,5,14,14,3,28,5.9207459207459205,31,23
"['111100', '101010', '00110', '00', '000001', '1110']",1,6,16,13,3,29,7.092640692640693,49,47
"['01', '1111', '011101', '0011011', '01110']",1,5,8,16,0,24,6.3881340881340885,28,27
"['11001', '11010', '110011', '011111', '101111']",1,5,8,20,5,28,6.618181818181818,25,47
"['10101', '0001', '00', '001111']",1,4,9,8,0,17,3.327994227994228,17,16
"['101', '0001', '001', '1111011']",1,4,7,10,2,17,3.4588744588744587,18,19
"['0111000', '00111', '0011', '10001', '1100000', '110011', '10010', '010110', '000010', '100011']",1,10,32,25,9,57,29.311799311799312,127,136
"['11001', '111', '00000']",1,3,7,6,2,13,1.15,10,6
"['011001', '00101', '11']",1,3,6,7,0,13,1.6168831168831168,9,7
"['110000', '0001', '100', '1']",1,4,9,5,0,14,3.0238095238095237,18,16
"['1110011', '10010', '10', '1']",1,4,6,9,0,15,2.9325396825396823,22,16
"['0', '1010010', '1000', '1100011', '111000']",1,5,14,11,2,25,5.6930069930069935,36,24
"['0', '110000', '1000001', '01010', '011111', '1101']",1,6,15,14,2,29,6.768048618048618,57,32
"['00000', '100110', '10', '1101', '101111', '0100']",1,6,14,13,4,27,7.379653679653679,47,33
"['1111100', '1011', '1010', '110']",1,4,6,12,2,18,3.401948051948052,16,18
"['10100', '0101111', '000']",1,3,8,7,0,15,1.4,11,8
"['0111', '010', '1111111', '01100']",1,4,6,13,0,19,3.0668831168831168,21,18
"['1001001', '01101', '10011', '11']",1,4,8,11,2,19,3.5206349206349206,19,24
"['111010', '11000', '10001', '1001000', '10110', '1111000', '11100']",1,7,20,20,6,40,14.874658674658674,51,70
"['1000', '001', '0111']",1,3,6,5,2,11,1.3928571428571428,8,7
"['01', '1110010', '1101111', '00110', '1000', '10011', '1101']",1,7,14,20,6,34,12.448629148629148,67,59
"['01', '01101', '00', '10']",1,4,6,5,3,11,3.2142857142857144,13,14
"['00', '11011', '111101']",1,3,4,9,0,13,1.262987012987013,11,6
['0001010'],1,1,5,2,0,7,0,0,0
"['00111', '0100010', '1001', '0110', '1111010', '000000', '11111', '0101001']",1,8,23,22,7,45,14.597580197580198,95,77
"['01001', '0110', '0000']",1,3,9,4,2,13,1.6111111111111112,6,9
"['1010110', '001', '1', '1100110']",1,4,8,10,2,18,2.857142857142857,24,15
"['11001', '1011011', '01', '11101']",1,4,6,13,2,19,3.8873015873015873,17,24
"['1011', '11110', '111100', '111']",1,4,4,14,0,18,3.7416305916305914,12,30
"['1000', '100100', '000001']",1,3,12,4,2,16,1.9,8,12
"['0', '1010', '0110']",1,3,5,4,2,9,1.3,8,9
"['0', '1110011', '010010']",1,3,7,7,0,14,1.151098901098901,14,4
"['1010110', '0101110', '011', '10', '1000011']",1,5,12,14,3,26,5.676190476190476,38,28
"['001101', '11', '101', '0011010', '01110', '0100']",1,6,13,14,0,27,9.083105783105783,41,37
"['000001', '001010', '01011', '0']",1,4,12,6,2,18,2.4956709956709955,22,15
"['1110101', '101', '10111', '0110100']",1,4,8,14,2,22,3.664285714285714,19,18
"['01', '001', '100001', '00010', '111000']",1,5,14,8,2,22,5.921933621933622,32,26
"['0011', '10', '11']",1,3,3,5,2,8,1.5,6,8
"['0101110', '01', '001', '0110']",1,4,8,8,0,16,3.6098124098124096,17,20
"['101111', '010', '110', '01000']",1,4,8,9,2,17,3.169191919191919,18,14
"['000100', '110110', '101100', '01101', '00', '11111', '0101', '1100']",1,8,18,20,7,38,16.221933621933623,78,80
"['0', '011000', '1111']",1,3,5,6,0,11,0.6857142857142857,13,4
"['0', '1001', '0111', '110', '01000']",1,5,9,8,2,17,4.887301587301587,27,20
"['110011', '11000', '1101000']",1,3,9,9,0,18,2.175990675990676,7,18
"['11001', '1', '111010', '00101', '0000010', '011110']",1,6,15,15,4,30,7.2081418581418575,56,33
"['100110', '001', '01110']",1,3,7,7,0,14,1.893939393939394,8,8
"['110011', '1010', '1111111']",1,3,4,13,0,17,1.579020979020979,11,12
"['0', '0010', '111', '0110', '0011010', '11101']",1,6,11,13,2,24,7.572799422799423,45,38
"['100110', '0001', '11']",1,3,6,6,0,12,1.4333333333333333,10,6
"['1010010', '001', '1001010', '11']",1,4,10,9,2,19,3.2031746031746033,22,15
"['00100', '0010', '001']",1,3,9,3,0,12,2.496031746031746,4,17
"['100', '110', '0011000']",1,3,8,5,2,13,1.8666666666666667,9,8
"['01', '0110100', '111']",1,3,5,7,0,12,1.4444444444444444,11,5
"['11010', '1', '100101', '000', '110']",1,5,9,9,2,18,4.540764790764791,29,21
"['1100000', '1111', '1010111', '1011', '00010']",1,5,12,15,4,27,4.619047619047619,36,35
"['010001', '0101101', '10111', '00100', '111111', '0100']",1,6,15,18,4,33,8.524708624708625,44,42
"['011010', '0011101', '1100100', '0010000']",1,4,16,11,3,27,4.010989010989011,20,20
"['0110101', '111', '10000', '10', '101001']",1,5,11,12,0,23,5.247224997224997,34,26
"['101', '100', '010111']",1,3,5,7,2,12,1.7777777777777777,8,7
"['1001', '1010', '1000', '00', '01011']",1,5,11,8,3,19,6.599206349206349,20,24
"['010001', '0110', '0111', '01110']",1,4,9,10,2,19,4.273232323232323,12,26
"['01101', '1', '010000', '10111', '01010']",1,5,11,11,3,22,5.1220779220779225,33,20
"['001101', '1100101', '111']",1,3,6,10,0,16,2.0358974358974358,10,12
"['0111001', '10', '111', '000010']",1,4,9,9,0,18,2.782051282051282,24,11
"['11011', '001', '000011', '01100', '10000', '110011', '01000', '0100011', '01110']",1,9,26,21,7,47,22.14079254079254,101,116
"['010', '10110', '101110']",1,3,6,8,0,14,2.3257575757575757,6,13
"['1101001', '101100', '11110', '111', '0001', '000010']",1,6,15,16,2,31,7.453041403041403,50,42
"['0', '111', '1101110']",1,3,3,8,0,11,0.85,13,6
"['0011', '0101111', '001']",1,3,6,8,0,14,1.9844155844155844,8,9
"['110000', '0', '111100', '101', '010011', '111001']",1,6,13,15,4,28,7.698412698412698,53,37
"['11001', '1001', '001111']",1,3,6,9,0,15,2.0343434343434343,9,12
"['101011', '00', '01101']",1,3,6,7,0,13,1.6168831168831168,10,4
"['001', '00001', '001000', '10110', '011101', '01100']",1,6,18,12,5,30,8.415656565656565,41,49
"['101', '1000', '000010']",1,3,9,4,0,13,1.615873015873016,9,7
"['0', '1011', '1111110', '1001011']",1,4,6,13,2,19,2.2766233766233768,26,16
"['0', '0010001', '11111']",1,3,6,7,0,13,0.5833333333333333,16,4
"['000100', '100', '1']",1,3,7,3,0,10,1.4523809523809523,10,7
"['101010', '1011', '10000', '1101110']",1,4,10,12,0,22,3.968220668220668,16,18
"['11', '10001', '1110011', '100111', '000010', '0000', '01110']",1,7,18,17,4,35,11.203424353424353,71,54
"['11011', '1', '0000', '011010', '011000']",1,5,12,10,2,22,4.433044733044733,33,23
"['1010', '001', '1']",1,3,4,4,0,8,1.4714285714285715,7,6
"['0101010', '001', '11']",1,3,6,6,0,12,1.2444444444444445,11,4
"['100', '000001', '11']",1,3,7,4,0,11,1.0944444444444446,11,7
"['11', '101', '10000', '000', '01001']",1,5,11,7,4,18,5.09047619047619,25,24
"['0', '0001101', '10', '111000', '1111111']",1,5,9,14,2,23,3.720695970695971,47,24
"['110011', '10', '011110', '11001']",1,4,7,12,2,19,3.5259740259740258,20,16
"['011', '11', '1111001', '10100', '1100']",1,5,8,13,0,21,6.236796536796537,29,33
"['0101111', '0101110', '11', '101', '1001100', '111101']",1,6,11,21,3,32,9.242857142857142,52,45
"['1111110', '1111010', '10', '011110', '1101']",1,5,7,19,2,26,6.181030081030081,31,32
"['10001', '110001', '100', '10010', '000', '00010']",1,6,18,9,5,27,11.013636363636364,32,46
"['011101', '0110', '10']",1,3,5,7,0,12,1.9666666666666668,8,9
"['101100', '0010111', '11', '101', '0110', '100010', '000000', '0111']",1,8,20,18,5,38,15.091225441225442,93,71
"['1011110', '0100000', '010', '11']",1,4,10,9,2,19,2.4952380952380953,26,13
"['010100', '001101', '011100', '101011', '10001', '0110', '00']",1,7,19,16,4,35,13.046176046176045,62,56
"['010', '001', '1', '011']",1,4,5,5,3,10,3.5,10,11
"['101', '00', '10']",1,3,4,3,2,7,1.7000000000000002,4,5
"['11010', '011', '0011001', '0011010', '110', '01000']",1,6,16,14,6,30,9.44047619047619,45,49
"['00', '1100', '11100', '011']",1,4,7,7,0,14,3.598412698412698,14,22
"['000110', '11100', '110100']",1,3,9,8,2,17,1.7727272727272727,8,11
"['01', '010', '100', '1011000', '1001111', '01110']",1,6,13,14,4,27,8.681746031746032,50,37
"['101100', '111100', '0011000', '001000', '0001', '1111001']",1,6,20,16,5,36,9.523876123876125,42,61
"['11010', '1101000', '01000', '1101110']",1,4,12,12,4,24,4.314285714285714,14,27
"['11110', '1', '0010101', '1000000', '001011']",1,5,14,12,2,26,3.9515484515484514,43,27
"['101', '100', '0101011', '1']",1,4,6,8,2,14,3.1166666666666667,19,15
"['0000', '110', '11']",1,3,5,4,0,9,1.0857142857142859,8,6
"['0011101', '1', '00001', '10100', '100111', '0101']",1,6,14,14,2,28,7.300904650904651,51,40
"['10100', '001', '1000101', '0000100']",1,4,15,7,2,22,3.5809523809523807,19,19
"['1001110', '1011', '0001', '0101']",1,4,9,10,3,19,3.5681818181818183,16,14
"['11000', '1110001', '110101']",1,3,8,10,0,18,2.3298368298368297,6,13
"['101', '00', '1111111']",1,3,3,9,0,12,0.8,14,4
"['011', '0110100', '10001', '110100', '110']",1,5,12,12,2,24,5.946309246309246,31,29
"['110110', '0001', '00', '010111', '00010']",1,5,13,10,2,23,5.5027417027417025,29,31
"['000100', '111', '0111110']",1,3,7,9,0,16,1.2837606837606836,13,4
"['01', '0110', '001111']",1,3,5,7,0,12,1.7666666666666666,9,7
"['1011', '01001', '1001']",1,3,6,7,2,13,2.3055555555555554,4,12
"['0011', '00', '1111']",1,3,4,6,2,10,1.1666666666666665,8,8
"['0101110', '111', '000001', '10', '0101001', '01000']",1,6,17,13,2,30,7.452536352536352,53,40
"['0', '1000000', '00111', '100111']",1,4,11,8,0,19,2.573010323010323,25,17
"['11010', '1110010', '0011000']",1,3,10,9,2,19,2.2142857142857144,8,9
"['0', '111001', '001000']",1,3,8,5,2,13,1.0714285714285714,13,4
"['00', '0110111', '1111']",1,3,4,9,0,13,0.9898989898989898,12,8
"['110110', '001', '100001', '1']",1,4,8,8,2,16,2.6825396825396823,23,16
"['1111100', '0011', '1011101', '0110', '000', '000010', '000100', '1100']",1,8,23,18,7,41,15.788245088245088,93,99
"['0101000', '000011', '001000', '11101', '1001100', '01001', '110']",1,7,23,16,6,39,12.261366411366412,67,60
"['1', '1110000', '10001', '100', '1111110', '100101']",1,6,13,16,2,29,7.439310689310689,57,46
"['1', '10001', '0100110', '0111']",1,4,8,9,0,17,2.63989898989899,22,11
"['0011011', '0101', '1', '1110']",1,4,6,10,2,16,2.8227272727272728,22,13
"['11001', '010', '0111001']",1,3,7,8,0,15,1.9333333333333333,9,9
"['001100', '1101', '1']",1,3,5,6,0,11,1.2857142857142856,11,4
"['0', '0011', '1010', '001']",1,4,7,5,2,12,3.2285714285714286,13,14
"['1001100', '000100', '000101', '100']",1,4,15,7,2,22,3.6213675213675214,17,29
"['1010', '000', '11111']",1,3,5,7,0,12,1.0158730158730158,10,4
"['100101', '100011', '01100']",1,3,9,8,2,17,1.9242424242424243,9,6
"['01011', '0011', '1101011', '10']",1,4,7,11,0,18,3.7987012987012987,17,22
"['11', '00101', '00011']",1,3,6,6,2,12,1.9428571428571428,8,9
"['1010111', '0110', '0110001', '11']",1,4,8,12,2,20,3.3997113997113995,23,15
"['1101001', '01', '0100110', '0001', '0110', '11100', '01011', '01110']",1,8,19,20,7,39,16.78124098124098,83,83
"['010', '001', '1010101', '110001', '0011010']",1,5,14,12,4,26,5.77997557997558,34,24
"['000111', '10', '010000']",1,3,9,5,2,14,1.25,13,8
"['0', '001111', '0111']",1,3,4,7,0,11,1.4857142857142858,10,8
"['1', '10101', '1010101', '0000001', '10010', '111001']",1,6,16,15,4,31,7.402897102897103,53,58
"['10010', '111', '0000000']",1,3,10,5,0,15,1.0,14,4
"['011011', '00100', '010010', '01000']",1,4,14,8,4,22,4.193939393939393,14,25
"['0001010', '11011', '01010']",1,3,9,8,2,17,1.9333333333333333,8,8
"['00111', '00110', '10010', '11111', '01001']",1,5,11,14,5,25,6.0,25,26
"['10010', '00101', '00001']",1,3,10,5,3,15,2.0,6,8
"['0', '01111', '111']",1,3,2,7,0,9,1.0833333333333333,9,8
"['011011', '1110011', '0000110', '1']",1,4,9,12,2,21,2.4340659340659343,26,13
"['101', '010', '00101']",1,3,6,5,2,11,2.1666666666666665,6,6
"['1110111', '111100', '1', '1010001', '001001', '0110011']",1,6,14,20,5,34,7.667582417582418,58,46
"['0100000', '1', '001101']",1,3,9,5,0,14,0.9972527472527473,15,5
"['0', '110010', '11']",1,3,4,5,0,9,0.7857142857142857,11,6
"['1011010', '00100', '100', '10100', '11111', '1100']",1,6,14,15,3,29,9.167748917748918,38,50
"['00', '10010', '1110100']",1,3,8,6,0,14,1.5158730158730158,11,8
"['00', '010', '10', '11']",1,4,5,4,3,9,3.0,8,11
"['0011101', '0110001', '00000', '101101', '1001000', '00010', '01011', '101111']",1,8,26,22,8,48,16.241558441558443,85,78
"['0010001', '000110', '001', '100', '01111', '1011', '111000']",1,7,18,16,4,34,11.515545565545565,71,59
"['001101', '1100101', '10', '11100', '101001']",1,5,12,14,2,26,5.993728493728494,32,29
"['0100010', '00', '11101', '110', '011000']",1,5,13,10,0,23,5.094844044844045,33,25
"['11110', '010', '1001', '1']",1,4,5,8,0,13,2.749206349206349,18,11
"['100', '1', '1111110', '001010']",1,4,7,10,0,17,2.41007326007326,25,12
"['10111', '0010010', '00']",1,3,8,6,0,14,1.2301587301587302,13,6
"['11100', '0101', '110', '1']",1,4,5,8,0,13,2.999206349206349,16,13
"['101', '11100', '111']",1,3,3,8,2,11,1.9166666666666665,6,12
"['000011', '100', '1101100', '0001101', '110']",1,5,14,12,4,26,5.5577533577533575,37,32
"['0100111', '000101', '00', '111000', '110101']",1,5,14,13,3,27,5.47008547008547,37,31
"['0111', '1101', '1110', '001000']",1,4,8,10,3,18,3.2,18,14
"['101', '11010', '01101']",1,3,5,8,2,13,2.3,6,8
"['101', '100001', '000000']",1,3,11,4,2,15,1.5555555555555554,10,6
"['0100010', '1100000', '0110', '00000']",1,4,17,6,2,23,3.9314574314574315,17,28
"['01', '0011101', '00']",1,3,6,5,2,11,1.3888888888888888,11,9
"['1110001', '1001', '1']",1,3,5,7,0,12,1.3772727272727274,12,14
"['0', '101', '001111', '011001']",1,4,7,9,2,16,2.6825396825396823,22,11
"['0101', '001111', '1010100', '100', '011110', '1010010', '0110110']",1,7,19,21,5,40,13.002941502941503,66,61
"['101011', '0111010', '1']",1,3,5,9,0,14,1.151098901098901,14,4
"['0', '0110010', '0011100', '01']",1,4,10,7,2,17,2.7698412698412698,26,19
"['1', '000001', '01110']",1,3,7,5,0,12,0.9826839826839826,13,4
"['010', '011', '0011', '01111', '10', '0001010']",1,6,12,12,2,24,8.702669552669553,41,45
"['00111', '1011', '10']",1,3,4,7,0,11,1.619047619047619,8,8
"['0011000', '0110', '100111', '0000', '1001001', '0111101']",1,6,19,16,5,35,8.85064935064935,50,38
"['0010', '111100', '10111', '0001', '10', '1100']",1,6,12,13,3,25,7.966883116883117,45,42
"['101010', '00010', '001010']",1,3,11,6,2,17,2.106060606060606,4,17
"['01', '00', '010011']",1,3,6,4,2,10,1.5,9,7
"['00', '110', '1110000']",1,3,7,5,0,12,1.4444444444444444,11,9
"['0010', '00', '0100']",1,3,8,2,2,10,2.083333333333333,6,17
"['0001', '0110', '00', '1001111', '110101']",1,5,11,12,2,23,5.4840714840714835,33,20
"['1011010', '111010', '111', '101', '1011000']",1,5,10,16,4,26,6.7494505494505495,27,38
"['0101', '001', '10']",1,3,5,4,0,9,1.638095238095238,5,7
"['1110011', '0110', '10000', '11']",1,4,8,10,0,18,2.886724386724387,22,14
"['011011', '10100', '1', '101110']",1,4,7,11,2,18,2.844155844155844,23,14
"['1110010', '1', '001101', '0010101', '10100', '0011100']",1,6,17,16,3,33,8.222194472194472,56,44
"['101', '0100000', '110001', '001']",1,4,12,7,2,19,3.4153846153846152,20,15
"['00111', '1000', '0010101']",1,3,9,7,0,16,1.823232323232323,10,10
"['000110', '00101', '0011', '10101', '10', '000111']",1,6,15,13,4,28,9.56053391053391,39,44
"['1001', '1101111', '000', '11']",1,4,6,10,0,16,2.427994227994228,22,16
"['0001001', '10', '1101010']",1,3,9,7,2,16,1.4603174603174602,14,7
"['1010', '100', '00000']",1,3,9,3,0,12,1.8015873015873014,7,9
"['0010110', '011', '0001', '1111001', '0010100', '0101100']",1,6,19,16,4,35,9.057142857142857,50,47
"['0100010', '110101', '000', '111001']",1,4,12,10,2,22,3.552991452991453,20,10
"['1110111', '00', '111']",1,3,3,9,0,12,0.8222222222222222,13,12
"['0', '101', '000100', '1100']",1,4,9,5,0,14,2.8015873015873014,19,13
"['01', '010', '0010111']",1,3,6,6,0,12,1.8444444444444446,10,7
"['0', '100', '0101000']",1,3,8,3,0,11,1.35,12,9
"['0', '0100000', '110']",1,3,8,3,0,11,1.15,13,8
"['11110', '0101', '1', '011100']",1,4,6,10,0,16,2.790764790764791,20,11
"['01', '0111010', '1000101', '0000000', '1000']",1,5,18,9,3,27,4.834054834054834,41,27
"['0', '1010110', '1011001', '01010']",1,4,10,10,2,20,2.880952380952381,25,13
"['0', '1011', '001']",1,3,4,4,0,8,1.4714285714285715,7,4
"['0', '101100', '110010', '1111', '111011']",1,5,8,15,3,23,4.657142857142857,35,28
"['010000', '1111110', '10', '11100', '101001']",1,5,12,14,2,26,5.237318237318237,36,23
"['10110', '00101', '1110']",1,3,6,8,2,14,1.9333333333333331,7,8
"['11010', '00001', '1001', '00', '011111', '001100', '0001000']",1,7,21,14,4,35,11.208164058164058,72,65
"['0', '110001', '1111001', '1010001', '1100']",1,5,12,13,2,25,5.846853146853147,33,33
"['0100010', '01', '10000', '11']",1,4,10,6,2,16,2.7936507936507935,21,11
"['001', '111', '0010000', '0101101', '1000', '100111', '10010', '00010', '0101']",1,9,25,19,8,44,21.05926850926851,106,102
"['0010', '001', '101010', '0101', '110']",1,5,11,9,4,20,5.943650793650794,21,27
"['1000110', '1110000', '111101', '1111']",1,4,9,15,2,24,3.6541458541458542,21,26
"['1100001', '100100', '100011', '11']",1,4,11,10,2,21,3.6495726495726495,21,25
"['101', '011', '11']",1,3,2,6,2,8,2.2666666666666666,4,10
"['110010', '001', '10010', '10', '110']",1,5,10,9,2,19,6.0971861471861475,24,32
"['1111100', '010000', '001010', '0']",1,4,12,8,2,20,2.411172161172161,27,21
"['101100', '0101111', '011', '100', '111110']",1,5,9,16,4,25,5.452991452991453,34,29
"['0000101', '1000', '00011']",1,3,11,5,0,16,2.0454545454545454,9,12
"['0110010', '100', '1111111', '101101']",1,4,8,15,2,23,3.126007326007326,23,11
"['011101', '1000110', '010110']",1,3,9,10,2,19,2.051282051282051,8,10
"['01101', '0011111', '101101']",1,3,6,12,0,18,2.191142191142191,7,10
"['010100', '0010000', '00011', '100', '0010100', '000', '11111']",1,7,23,13,6,36,11.202985902985903,69,94
"['01', '010110', '000']",1,3,7,4,0,11,1.5666666666666667,9,9
"['0000101', '01', '0110111', '0100000']",1,4,14,9,3,23,3.0476190476190474,25,19
"['00010', '010', '10']",1,3,7,3,0,10,2.1214285714285714,6,12
"['1111100', '010', '11']",1,3,4,8,0,12,1.2444444444444445,12,6
"['0010', '001', '101', '100', '1111110', '000']",1,6,12,11,4,23,8.087445887445886,41,41
"['10101', '010', '100011', '000']",1,4,10,7,2,17,3.755050505050505,15,9
"['00000', '00001', '100', '01001', '111000']",1,5,17,7,3,24,6.053030303030303,25,38
"['101', '1110010', '1', '110100']",1,4,7,10,0,17,3.0716117216117214,23,15
"['011010', '01111', '11']",1,3,4,9,0,13,1.7987012987012987,9,8
"['11010', '100', '001']",1,3,6,5,2,11,1.9166666666666665,7,7
"['10111', '010', '1100101', '11']",1,4,6,11,0,17,3.015873015873016,20,17
"['0', '0110', '10010', '0101', '1001111']",1,5,10,11,2,21,5.224242424242424,34,23
"['00001', '101', '1001', '10110', '110001', '1010', '01011']",1,7,16,16,5,32,13.767316017316016,48,69
"['11001', '11', '100101', '0000', '01001', '110', '111001']",1,7,15,16,4,31,12.036147186147186,57,69
"['0001011', '100', '01111']",1,3,7,8,0,15,1.15,12,8
"['0010', '111110', '111']",1,3,4,9,0,13,1.3523809523809525,10,9
"['101', '10111', '0001110']",1,3,6,9,0,15,1.8166666666666667,10,6
"['1000', '00', '10110']",1,3,7,4,0,11,1.9047619047619047,7,9
"['01', '001', '110010', '100', '1111000', '1011']",1,6,12,13,2,25,8.264613164613165,46,38
"['1001', '001111', '00011']",1,3,7,8,0,15,1.993939393939394,8,8
"['00000', '0011110', '0110', '00010', '110']",1,5,15,9,2,24,6.012193362193362,28,48
"['00100', '010110', '0001000', '111']",1,4,13,8,0,21,3.0704351204351203,20,16
"['00', '1001', '000101', '0110']",1,4,10,6,2,16,3.533333333333333,17,13
"['0101', '100', '0110111', '000']",1,4,9,8,2,17,3.3367965367965366,18,15
"['0', '0000011', '0111']",1,3,7,5,0,12,1.1954545454545453,13,7
"['00', '10110', '11111']",1,3,4,8,2,12,0.9714285714285714,10,4
"['010100', '101', '10']",1,3,6,5,0,11,1.9666666666666668,8,5
"['0010001', '011', '101', '0101010', '1011100', '110', '111101']",1,7,16,20,6,36,12.116239316239316,72,52
"['0011101', '111100', '111001']",1,3,7,12,2,19,2.217948717948718,8,10
"['1000100', '1000', '010101', '0111', '0100101', '0001000']",1,6,22,13,5,35,9.418231768231768,46,48
"['01', '1010010', '001111', '11101']",1,4,8,12,0,20,3.2046842046842046,22,15
"['00111', '1101100', '000001', '0001010', '011010']",1,5,18,13,4,31,5.805694305694305,33,33
"['011', '100', '10000', '000', '11111', '110']",1,6,11,11,6,22,6.7,41,42
"['0111001', '10', '01000']",1,3,8,6,0,14,1.6825396825396823,11,7
"['110011', '101000', '00101']",1,3,9,8,2,17,1.9393939393939394,9,7
"['1010001', '0010', '001', '000']",1,4,12,5,2,17,4.1264069264069265,15,18
"['1011', '0010011', '110', '11111']",1,4,6,13,0,19,2.9764790764790763,19,24
"['001101', '101101', '1001', '110011', '10010', '10', '1110']",1,7,14,19,5,33,13.786580086580086,55,67
"['011111', '00', '1101100']",1,3,6,9,0,15,1.1559829059829059,14,9
"['01', '01111', '0000010', '0100']",1,4,11,7,0,18,3.0057720057720054,22,18
"['110000', '010', '10000', '00110', '00']",1,5,15,6,2,21,5.991847041847041,28,39
"['110010', '001110', '1110100', '000010', '01001', '0101']",1,6,19,15,3,34,9.58049728049728,44,44
"['0011110', '1100', '1011111']",1,3,6,12,2,18,1.6233766233766234,11,6
"['110', '0010011', '0010010', '01001', '1100']",1,5,15,11,2,26,6.438528138528138,28,32
"['101', '01001', '01101', '0011000']",1,4,11,9,2,20,4.033333333333333,16,15
"['0010', '0101000', '10001', '010010', '1011', '1110']",1,6,17,13,3,30,8.695493395493395,41,36
"['1000', '0011000', '11']",1,3,8,5,0,13,1.505050505050505,11,8
"['11001', '111', '0111']",1,3,3,9,0,12,2.2738095238095237,6,15
"['1000001', '111010', '010110', '0100001', '0001010']",1,5,20,13,5,33,6.051282051282051,32,29
"['0001001', '010', '001', '0111001', '011100', '0110', '110']",1,7,18,15,5,33,13.455633255633256,60,74
"['0101000', '1', '1101000', '100', '010101', '110101']",1,6,16,14,4,30,8.564468864468864,50,47
"['1010', '110', '0110011']",1,3,6,8,0,14,1.7168831168831167,9,8
"['00111', '00', '10010', '10', '1010011', '110']",1,6,12,12,4,24,7.9222222222222225,45,39
"['0011', '11100', '010010']",1,3,8,7,0,15,1.5898989898989897,10,8
"['1', '1010100', '1001101', '110', '0100101']",1,5,12,13,3,25,4.65,40,25
"['1101000', '10011', '000']",1,3,9,6,0,15,1.6,11,9
"['00100', '00', '110111', '101101']",1,4,9,10,2,19,2.8971861471861473,21,12
"['001', '00001', '10111', '10000', '110']",1,5,12,9,5,21,4.933333333333334,29,29
"['010', '10', '000', '1010011', '001001']",1,5,13,8,2,21,5.913675213675214,29,22
"['11', '100', '0100']",1,3,5,4,0,9,1.5904761904761904,6,6
"['110', '1111001', '11']",1,3,3,9,0,12,1.8444444444444446,10,13
"['11110', '0111011', '10', '1001010']",1,4,8,13,2,21,3.0317460317460316,23,17
"['0', '10100', '0011100']",1,3,8,5,0,13,1.25,13,11
"['11001', '010', '100111', '0111', '01100']",1,5,10,13,2,23,6.471933621933622,27,25
"['101100', '011', '100', '1000', '000']",1,5,12,7,3,19,5.71111111111111,22,36
"['0', '1100', '10', '1111']",1,4,4,7,2,11,2.5666666666666664,15,12
"['0000', '100', '0110', '1011000']",1,4,12,6,2,18,3.5155844155844154,16,22
"['10', '0111', '11111', '00010', '0101', '101110']",1,6,10,16,4,26,8.02027417027417,41,37
"['100', '10', '010110', '11']",1,4,6,7,2,13,3.3666666666666667,15,12
['1011111'],1,1,1,6,0,7,0,0,0
"['0', '01111', '01', '110']",1,4,4,7,0,11,2.9714285714285715,15,14
"['1100001', '00', '10']",1,3,7,4,2,11,1.3888888888888888,11,4
"['010', '1000111', '0001101', '1000010', '000000']",1,5,20,10,3,30,6.176312576312577,33,27
"['1000001', '001', '00000', '0011001', '000111', '011000']",1,6,23,11,4,34,9.242679542679543,48,54
"['1111011', '0110', '0011111', '11']",1,4,5,15,2,20,3.3607503607503606,23,20
"['0', '1011011', '11']",1,3,3,7,0,10,0.6944444444444444,13,6
"['01', '11011', '010000', '1011001', '11', '100000']",1,6,15,13,4,28,7.085941835941836,55,40
"['01', '0010', '1', '00001', '0011']",1,5,10,6,2,16,5.788095238095238,23,23
"['1010', '100011', '110', '1111110']",1,4,7,13,0,20,2.8872016872016872,20,20
"['01', '0010', '100001', '111', '10']",1,5,9,8,2,17,4.963492063492064,28,21
"['1001', '0101011', '1101', '0110010', '110']",1,5,11,14,4,25,6.334415584415584,27,25
"['010001', '110', '10', '1001']",1,4,8,7,0,15,3.7825396825396824,15,16
"['0011', '01111', '011']",1,3,4,8,0,12,2.2738095238095237,5,12
"['00010', '1101', '000', '1110']",1,4,9,7,2,16,2.9603174603174605,16,16
"['11001', '110110', '010', '1', '1110']",1,5,7,12,0,19,5.028860028860029,28,26
"['1010', '0110010', '111101']",1,3,7,10,0,17,1.9426573426573426,9,6
"['1110011', '1', '1111101']",1,3,3,12,2,15,1.2142857142857144,15,15
"['1101001', '0011', '101', '01111', '000101', '1011']",1,6,12,17,2,29,9.624958374958375,40,50
"['01', '110011', '001010', '110111', '1110']",1,5,9,15,3,24,5.433333333333334,33,29
"['010100', '110110', '00101', '101', '1100000', '010011', '1110']",1,7,19,18,3,37,12.303635253635253,65,56
"['1100111', '101', '11110', '110']",1,4,5,13,2,18,3.6166666666666667,18,23
"['001111', '1011101', '1000', '00', '0101', '101111', '0100']",1,7,15,18,5,33,12.156449106449106,64,61
"['1', '10000', '0100', '0010011']",1,4,11,6,0,17,2.8772727272727274,22,13
"['010100', '110010', '000011', '00110', '1001001', '1101']",1,6,19,15,3,34,9.332634032634033,45,35
"['0001001', '1010', '1100000', '1011001']",1,4,15,10,3,25,3.8181818181818183,21,19
"['01', '11', '10110', '00110', '101001']",1,5,9,11,4,20,5.858441558441559,27,24
"['001', '010', '1', '1110']",1,4,5,6,2,11,2.9238095238095236,14,11
"['0011', '0100000', '1101']",1,3,9,6,2,15,1.2272727272727273,13,6
"['10001', '110001', '001010', '10', '0110001']",1,5,15,11,2,26,6.188367188367188,30,33
"['00', '010', '0000011']",1,3,9,3,0,12,1.6444444444444444,11,10
"['11', '11110', '0111100']",1,3,4,10,0,14,1.8492063492063493,10,6
"['0', '0001010', '1111000']",1,3,9,6,2,15,0.9285714285714286,16,10
"['001100', '110001', '0111']",1,3,8,8,2,16,1.8666666666666667,11,5
"['00', '100', '111000']",1,3,7,4,0,11,1.9666666666666668,8,11
"['010000', '0001', '1110101', '1000', '10010', '0100100']",1,6,21,12,4,33,10.07069042069042,39,43
"['011101', '1', '1000111']",1,3,5,9,0,14,1.151098901098901,15,8
"['10111', '010001', '0000110']",1,3,10,8,0,18,1.8146853146853146,10,4
"['101011', '101', '1010', '1101', '0100']",1,5,9,12,3,21,6.9523809523809526,20,30
"['1101', '1', '001110', '0000']",1,4,8,7,2,15,2.1357142857142857,22,10
"['0', '0001110', '01111', '0000101', '111111', '1101', '001011']",1,7,15,21,4,36,10.04910644910645,78,57
"['1101', '1', '01010']",1,3,4,6,0,10,1.4,9,4
"['010', '1010100', '10110', '11101', '0010010']",1,5,14,13,4,27,6.264285714285714,30,25
"['10111', '1001', '11']",1,3,3,8,0,11,1.9047619047619047,7,15
"['0001001', '110101', '11']",1,3,7,8,0,15,1.5598290598290598,12,11
"['11001', '011', '101', '100', '1111010', '10100', '00010', '1110']",1,8,16,19,6,35,16.597113997113997,76,74
"['00', '0001', '111']",1,3,5,4,0,9,0.9523809523809523,8,6
"['01111', '1111000', '11']",1,3,4,10,0,14,1.6825396825396823,12,13
"['001', '11011', '0001100', '00', '10']",1,5,11,8,2,19,5.046031746031746,32,26
"['0101000', '0100110', '001101', '100', '0101']",1,5,16,11,2,27,6.569319569319569,31,34
"['0111', '1100', '000']",1,3,6,5,2,11,1.3571428571428572,8,9
"['0111101', '010010', '011010']",1,3,9,10,2,19,1.8846153846153846,6,14
"['0001', '01111', '10001', '1100']",1,4,9,9,4,18,3.344444444444444,16,17
"['01', '010011', '01111', '00011']",1,4,8,10,2,18,3.697402597402597,15,20
"['1000011', '1100010', '011']",1,3,9,8,2,17,1.7142857142857144,11,10
"['11001', '001', '1100']",1,3,6,6,0,12,2.2103174603174605,6,12
"['0110101', '011', '10110', '10000', '10']",1,5,11,11,2,22,5.353968253968254,33,26
"['100100', '10010', '0101000', '0110011']",1,4,15,10,2,25,4.341325341325342,17,18
"['10001', '011101', '000001', '10', '011111', '110']",1,6,13,15,3,28,7.341125541125541,50,41
"['0010110', '1111101', '10', '0101', '0001000']",1,5,14,13,3,27,5.246753246753246,40,23
"['011', '100010', '100011', '1011100', '0000']",1,5,15,11,2,26,5.516872016872017,31,28
"['1000001', '011011', '1110011', '0000001', '1100']",1,5,17,14,3,31,5.324275724275724,33,34
"['000100', '001', '0100']",1,3,10,3,0,13,2.038095238095238,7,15
"['00000', '01100', '010010', '1000', '0011011', '010011', '0110110']",1,7,24,16,6,40,12.876257076257076,55,79
"['00110', '00', '1011101', '1101100']",1,4,10,11,2,21,3.507936507936508,22,15
"['11110', '0111010', '101011', '1000', '000', '0100']",1,6,15,14,2,29,8.298501498501498,43,41
"['1111100', '01101', '110011', '10', '101111']",1,5,8,18,2,26,5.686036186036186,35,30
"['101101', '11', '10000', '11101', '0001010']",1,5,12,13,2,25,5.438184038184038,33,28
"['11000', '0100101', '0100011', '01010']",1,4,14,10,4,24,4.123809523809523,15,20
"['110000', '01111', '0110', '111110', '1011', '1101', '1110']",1,7,11,22,6,33,12.885353535353536,54,69
"['1010', '111111', '01011']",1,3,4,11,0,15,1.4303030303030302,9,8
"['0', '1110001', '0011100', '0101001']",1,4,12,10,3,22,2.607142857142857,28,12
"['01', '001', '00011', '1000110', '11111', '1011']",1,6,11,15,2,26,8.344733044733045,43,41
"['11110', '0100101', '1110', '011000']",1,4,10,12,0,22,3.5005439005439003,18,18
"['1010', '1000', '0101110', '111']",1,4,8,10,2,18,3.47987012987013,17,12
"['001', '011', '1111010', '000', '0100101']",1,5,12,11,5,23,5.238095238095238,35,25
"['01', '101101', '11000', '1111', '1101100']",1,5,9,15,0,24,5.316561216561216,31,30
"['110010', '110', '011', '0000011']",1,4,10,9,2,19,3.2393162393162394,23,21
"['0', '10111', '110001', '0100']",1,4,8,8,0,16,2.6089466089466087,21,9
"['1110111', '00100', '100', '110011', '1010', '0000', '01001', '0101', '110']",1,9,21,20,7,41,21.4488122988123,97,91
"['11', '0100101', '00000']",1,3,9,5,0,14,0.9444444444444444,13,4
"['0010110', '1', '0010000', '0011', '0110']",1,5,14,9,4,23,5.30974025974026,36,32
"['0', '0011101', '11100']",1,3,6,7,0,13,1.25,13,7
"['0101', '110', '11']",1,3,3,6,0,9,2.038095238095238,5,8
"['011010', '10', '111']",1,3,4,7,0,11,1.5666666666666667,9,5
"['1', '1000110', '1001', '0101011', '01011']",1,5,11,13,2,24,5.568831168831169,35,31
"['0000111', '1010', '00', '0111']",1,4,9,8,2,17,3.0353535353535355,21,17
"['11010', '0001', '111011']",1,3,6,9,0,15,1.5717171717171716,9,8
"['1000001', '1011010', '1', '01011', '01110']",1,5,12,13,4,25,4.671428571428572,40,21
"['101', '01', '0010', '11']",1,4,5,6,2,11,3.6714285714285713,10,11
"['101', '00100', '10110', '11101', '100011']",1,5,11,13,3,24,5.903030303030303,27,27
"['110010', '111', '00011', '10001', '10', '110']",1,6,11,13,4,24,8.62987012987013,41,46
"['11', '100', '1110101', '0001100', '100110', '000', '101111', '0111100']",1,8,19,22,7,41,14.95897435897436,101,79
"['1110101', '101', '010', '0110']",1,4,7,10,2,17,3.8406926406926405,18,12
"['0010', '0001', '0000100', '0100']",1,4,15,4,3,19,4.181818181818182,15,30
"['11010', '11', '001000', '100100', '1110']",1,5,12,11,2,23,5.5608225108225104,29,26
"['011', '110100', '111001']",1,3,6,9,2,15,1.5555555555555554,10,9
"['110110', '11110', '1011', '1011111']",1,4,5,17,0,22,3.7992229992229993,14,27
"['00101', '111', '0001100', '0011011', '101110']",1,5,13,15,2,28,6.157176157176157,32,26
"['0001100', '00010', '1100']",1,3,11,5,0,16,2.005050505050505,8,17
['1100110'],1,1,3,4,0,7,0,0,0
"['001', '111', '0011', '00', '000111']",1,5,9,9,2,18,5.8619047619047615,23,35
"['110010', '00111', '101', '10', '0011011']",1,5,10,13,0,23,5.790997890997891,34,28
"['11010', '001', '0000']",1,3,8,4,0,12,1.5158730158730158,8,8
"['0001011', '1101010', '101110', '11']",1,4,9,13,2,22,3.037240537240537,23,18
"['001', '011', '100', '1010111', '110111', '0101']",1,6,10,16,3,26,9.072571872571872,40,44
"['01', '00', '00011']",1,3,6,3,2,9,1.6428571428571428,7,8
"['010001', '1100001', '1101011', '0000000', '100111', '10', '001110']",1,7,23,18,6,41,11.105616605616605,78,51
"['0', '101000', '11101', '011001', '0111110']",1,5,11,14,2,25,4.683899433899434,38,21
"['00110', '001', '110111', '11111']",1,4,6,13,2,19,2.9353535353535354,17,18
"['101011', '00', '010']",1,3,6,5,0,11,1.9666666666666668,8,4
"['00', '100', '001011', '11']",1,4,7,6,2,13,2.6444444444444444,17,17
"['11', '101', '0001', '100110', '000']",1,5,10,8,2,18,5.328571428571428,25,24
"['1111', '1100010', '1011000']",1,3,8,10,2,18,1.6233766233766234,11,8
"['001', '111101', '11']",1,3,3,8,0,11,1.3444444444444446,10,11
"['11000', '1101100', '110011', '100101', '10']",1,5,12,14,2,26,6.201187701187701,31,33
"['0011', '1', '01110']",1,3,4,6,0,10,1.4,9,4
"['1', '00000', '1100010', '100', '01110']",1,5,13,8,2,21,4.25,37,21
"['1101', '001', '011']",1,3,4,6,2,10,1.8095238095238093,5,8
"['01', '0100011', '00', '111001']",1,4,9,8,2,17,3.0042735042735043,22,13
"['011', '00000', '10111', '1011101', '010111']",1,5,11,15,2,26,5.675291375291375,32,29
"['0', '111', '010010', '011110', '1011011']",1,5,9,14,2,23,4.5838217338217335,38,20
"['00111', '1010000', '110100']",1,3,10,8,0,18,1.4662004662004662,11,10
"['001100', '100000', '00011']",1,3,12,5,2,17,1.7727272727272727,9,12
"['0', '010', '011011', '1111', '0110010']",1,5,9,12,0,21,4.702780552780553,35,29
"['11', '101', '110001', '1010', '00', '10011']",1,6,10,12,2,22,8.943939393939393,36,44
"['11001', '01', '1100']",1,3,5,6,0,11,1.7936507936507935,7,10
"['0010', '111', '000001', '1011100', '000000', '00010']",1,6,21,10,2,31,7.047058497058497,51,56
"['01101', '100111', '0111']",1,3,5,10,0,15,2.416161616161616,6,11
"['01', '0100110', '111', '0010010', '0100']",1,5,13,10,2,23,5.352958152958153,34,27
"['11001', '010', '001', '0011101', '0011110', '110011', '0110001']",1,7,18,20,5,38,13.251154401154402,69,62
"['001', '0110', '11111']",1,3,4,8,0,12,1.2658730158730158,9,4
"['1001110', '101', '10', '1011', '11100']",1,5,8,13,0,21,6.278066378066378,28,31
"['1000000', '1011', '0100110', '00011']",1,4,14,9,2,23,3.6623376623376624,20,15
"['01', '11010', '0001', '001010', '01000']",1,5,14,8,2,22,6.075180375180375,25,31
"['110000', '10000', '11100', '101110']",1,4,12,10,4,22,4.009090909090909,14,20
"['100110', '11010', '10011', '1101110']",1,4,9,14,2,23,4.123776223776224,12,25
"['110000', '10', '1010011']",1,3,8,7,0,15,1.5598290598290598,12,8
"['110', '10101', '1001', '001010', '001100', '1100']",1,6,15,13,4,28,9.8512987012987,35,39
"['111001', '10011', '000', '11']",1,4,7,9,0,16,2.7431457431457433,20,17
"['11001', '010', '00001', '101011', '110111', '001011']",1,6,14,17,5,31,8.62020202020202,40,46
"['11', '10111', '00', '01001', '101001']",1,5,9,11,4,20,5.236363636363636,29,28
"['01', '100100', '0000', '000111', '0110001']",1,5,16,9,2,25,5.454001554001554,35,29
"['00', '1000', '10110', '1110']",1,4,8,7,2,15,3.626984126984127,13,17
"['1000100', '110110', '10', '0111', '000']",1,5,12,10,0,22,4.586957486957487,36,25
"['0011001', '01101', '10']",1,3,7,7,0,14,1.8492063492063493,10,7
"['010', '111100', '011', '101011', '0001101', '000']",1,6,14,14,5,28,7.834188034188034,50,40
"['1000101', '011', '00101', '1', '100111']",1,5,10,12,0,22,5.715551115551116,32,33
"['00100', '01', '11']",1,3,5,4,2,9,1.3571428571428572,8,4
"['11001', '01', '00']",1,3,5,4,2,9,1.6428571428571428,7,5
"['0', '11101', '111']",1,3,2,7,0,9,1.0833333333333333,9,8
"['010', '101010', '1111', '0010011', '0111101']",1,5,11,16,2,27,5.348784548784549,35,23
"['010001', '001', '10', '010110']",1,4,10,7,2,17,3.1777777777777776,19,17
"['00110', '0000011', '011', '01000']",1,4,13,7,2,20,3.6166666666666667,19,21
"['1001110', '110010', '010', '00101', '1001010', '0011000', '11', '10101', '100', '0000000']",1,10,31,21,8,52,26.32139527139527,148,126
"['01', '101', '00', '1100', '1110']",1,5,7,8,4,15,5.2595238095238095,20,22
"['11', '0001', '1110101', '110', '01110']",1,5,8,13,0,21,5.25966810966811,31,26
"['01', '001111', '10']",1,3,4,6,2,10,1.25,11,6
"['0', '000010', '1111']",1,3,6,5,0,11,0.4857142857142857,14,4
"['01', '011100', '00110', '0000', '1101']",1,5,12,9,2,21,5.382034632034632,28,27
"['00111', '10110', '1011111', '0001111']",1,4,8,16,4,24,3.980952380952381,16,23
"['011101', '0010', '01101', '11010']",1,4,9,11,2,20,4.369696969696969,13,19
"['0', '00011', '101010', '0001', '1001', '010011']",1,6,15,11,4,26,8.931529581529581,40,37
['1000100'],1,1,5,2,0,7,0,0,0
"['0100010', '1001', '00001']",1,3,11,5,0,16,2.2272727272727275,7,6
"['101', '1000', '1001010']",1,3,8,6,0,14,1.8987012987012988,9,10
"['11001', '110110', '001000', '11', '10101', '00']",1,6,13,13,6,26,7.881168831168831,48,37
"['1101001', '0010', '001001']",1,3,10,7,0,17,2.114685314685315,8,11
"['0', '100110', '0101', '01000']",1,4,10,6,0,16,3.012987012987013,21,16
"['1010', '1000', '111111']",1,3,5,9,2,14,1.35,10,7
"['001', '1', '0001', '1011', '0101']",1,5,8,8,3,16,5.45,20,27
"['100', '11101', '1110']",1,3,4,8,0,12,1.9603174603174602,6,9
"['11011', '011', '0001', '1000', '0000', '0100001']",1,6,17,10,3,27,8.535786435786436,41,45
"['0', '1101001', '001111', '1101000', '110001', '0110', '1111010']",1,7,17,21,5,38,11.035814185814186,80,60
"['1011011', '1000110', '001', '11']",1,4,8,11,2,19,3.003174603174603,23,17
"['0011', '0010100', '1101110']",1,3,9,9,2,18,1.844155844155844,11,10
"['0', '0100110', '111', '01010']",1,4,8,8,0,16,2.316666666666667,22,15
"['00', '10', '0101100', '01100']",1,4,10,6,2,16,3.365079365079365,19,27
"['1011', '1', '10000']",1,3,5,5,0,10,1.1777777777777778,10,9
"['1110111', '01001', '1100', '1']",1,4,6,11,0,17,2.6954545454545453,23,16
"['0000101', '0010', '111000', '11']",1,4,11,8,0,19,3.0665889665889665,24,16
"['0001001', '101100', '00110', '01011', '0100']",1,5,16,11,2,27,6.841647241647242,25,31
"['001000', '11', '11101', '0000', '1011', '0101']",1,6,13,12,3,25,7.173953823953823,44,39
"['101001', '11110', '000', '0010011']",1,4,11,10,0,21,2.7606449106449107,21,13
"['01', '0011011', '10001']",1,3,7,7,0,14,1.5158730158730158,12,7
"['1101000', '010', '1111000']",1,3,9,8,2,17,1.8571428571428572,10,10
"['01', '01101', '01111', '0001011', '00010']",1,5,12,12,3,24,5.792063492063492,29,30
"['1000000', '100', '1110']",1,3,9,5,0,14,1.535064935064935,11,9
"['0111000', '1100000', '1000', '000', '1101010']",1,5,18,10,3,28,6.9818181818181815,30,43
"['0010', '11010', '011', '111010', '101', '111111', '011000']",1,7,13,20,5,33,12.085786435786435,60,60
"['11110', '0100000', '001', '011']",1,4,10,8,2,18,2.55,23,15
"['1011', '011010', '00001']",1,3,8,7,0,15,1.408080808080808,9,4
"['101', '00', '100001', '001011']",1,4,10,7,2,17,3.2333333333333334,19,14
"['0', '011', '0100010', '1010100', '1000010', '1111011']",1,6,17,15,4,32,7.128571428571428,63,37
"['1100111', '0101101', '100001', '01110']",1,4,11,14,2,25,3.1914751914751913,20,12
"['1011', '0010', '10']",1,3,5,5,2,10,1.8333333333333333,6,6
"['101011', '10111', '0101010', '1100', '1110']",1,5,10,16,2,26,5.9333721833721835,24,28
"['01', '010', '001011', '011000']",1,4,10,7,2,17,3.6333333333333333,18,18
"['100', '11100', '111', '1011111']",1,4,5,13,2,18,3.3333333333333335,19,27
"['101', '111111', '011', '000']",1,4,5,10,3,15,2.2222222222222223,20,12
"['11001', '01', '010', '100', '0011010', '10000', '111110']",1,7,16,15,4,31,11.311105561105562,68,52
"['011111', '101', '001110']",1,3,5,10,2,15,1.5555555555555554,10,4
"['1101001', '1', '1001011']",1,3,6,9,2,15,1.0714285714285714,14,13
"['1000', '0101111', '10', '11']",1,4,6,9,2,15,2.7525252525252526,21,15
"['00001', '00011', '101010', '100', '1100100', '10011']",1,6,18,13,3,31,9.28892773892774,41,47
"['001', '0110111', '1000101', '1010', '11111', '1110', '011000']",1,7,15,21,4,36,10.71035076035076,69,57
"['0', '11110', '0100101']",1,3,6,7,0,13,0.9166666666666666,14,6
"['0010', '010101', '111100', '110']",1,4,9,10,2,19,3.1825396825396823,17,15
"['1110010', '10011', '010110']",1,3,8,10,0,18,2.0093240093240095,9,6
"['101010', '1000', '001010', '0100001', '1011']",1,5,16,11,4,27,6.482983682983683,28,27
"['0', '1100010', '1001', '1101', '011000']",1,5,12,10,2,22,5.50949050949051,33,19
"['101011', '01010', '001101', '101111']",1,4,9,14,3,23,3.833333333333333,14,13
"['11001', '001', '011100', '001000', '10110', '1011']",1,6,15,14,4,29,9.077994227994228,42,38
"['011', '11000', '0000001', '10', '000100']",1,5,16,7,0,23,4.698934398934399,37,29
"['01', '10', '011']",1,3,3,4,2,7,1.7000000000000002,5,7
"['010000', '1', '1110']",1,3,6,5,0,11,1.0857142857142859,12,4
"['101100', '1001', '11']",1,3,5,7,0,12,1.7666666666666666,9,9
"['001100', '100001', '111011']",1,3,9,9,3,18,1.5,11,4
"['00011', '11', '0001', '00', '0101']",1,5,10,7,4,17,5.531746031746032,21,28
"['11', '101', '100010', '10', '10011']",1,5,8,10,2,18,6.3867965367965365,24,36
"['001', '011', '0001', '111110', '0101']",1,5,9,11,4,20,5.29047619047619,25,27
"['101100', '001', '1', '10001', '01110']",1,5,10,10,2,20,4.819552669552669,33,22
"['11010', '1000101', '1111101', '11', '11000', '0110', '001100']",1,7,16,20,4,36,12.48988788988789,67,53
"['1111', '100101', '000', '001001', '0100']",1,5,13,10,4,23,5.2214285714285715,28,22
"['000110', '11110', '1111']",1,3,5,10,0,15,1.8343434343434342,8,12
"['0', '10000', '11']",1,3,5,3,0,8,0.6190476190476191,10,4
"['0', '01', '11']",1,3,2,3,2,5,1.1666666666666665,4,4
"['000011', '1101000', '100', '0011111', '0111110']",1,5,14,16,3,30,5.097191697191697,43,30
"['110110', '00', '010']",1,3,6,5,0,11,1.7444444444444445,8,9
"['11', '0110', '11101', '000', '1001001']",1,5,10,11,0,21,4.8160894660894655,32,19
"['01', '11100', '1', '0000']",1,4,7,5,0,12,2.0634920634920633,19,12
"['0', '010', '100111']",1,3,5,5,0,10,1.2301587301587302,11,4
"['001', '0101111', '100']",1,3,6,7,2,13,1.4666666666666668,11,7
"['1101001', '1011001', '1011100', '1']",1,4,9,13,3,22,3.0357142857142856,25,24
"['0110001', '00000', '00100', '10101', '0110', '10100', '000001', '00010', '11100', '101001']",1,10,34,19,8,53,28.35765345765346,109,151
"['001', '0011000', '11', '10111', '0111111', '00010']",1,6,13,16,4,29,7.391269841269841,55,39
"['01', '0111111', '10']",1,3,3,8,2,11,1.1666666666666665,13,7
"['101', '100', '1', '101000']",1,4,7,6,2,13,3.2857142857142856,16,19
"['01', '100', '1001101', '1110001', '111000', '01011']",1,6,14,16,2,30,8.093367743367743,55,46
"['11', '100011', '0000', '0100101', '011000']",1,5,15,10,2,25,5.395027195027195,35,23
"['010', '11011', '110', '0000']",1,4,8,7,2,15,2.996031746031746,15,14
"['0', '0101011', '111', '01010']",1,4,7,9,0,16,2.316666666666667,22,16
"['01', '1010100', '1111000', '100000', '0000111', '01011']",1,6,19,15,3,34,7.226578976578977,62,46
"['11000', '000001', '000011']",1,3,12,5,2,17,1.9242424242424243,8,14
"['0', '101', '0010', '1011']",1,4,6,6,2,12,3.2285714285714286,13,10
"['0010', '001001', '10101', '1']",1,4,9,7,0,16,3.212987012987013,18,14
"['0001001', '01', '100100', '1010111', '10100', '000111']",1,6,18,15,4,33,9.06088356088356,48,49
"['0011', '0111111', '1']",1,3,3,9,0,12,1.1954545454545453,13,7
"['101', '001001', '1111111', '100110']",1,4,8,14,2,22,3.0153846153846153,23,16
"['10110', '011', '0000']",1,3,7,5,0,12,1.4801587301587302,8,6
"['01', '11000', '10110', '001010', '0000']",1,5,14,8,2,22,5.474314574314574,29,30
"['1110100', '00', '11100', '0000010']",1,4,13,8,2,21,3.0555555555555554,25,27
"['0010', '10111', '101', '1111', '100111']",1,5,7,15,2,22,6.029725829725829,22,39
"['1001100', '100011', '1']",1,3,7,7,0,14,1.304945054945055,14,10
"['00', '110001', '1', '1101100']",1,4,8,8,0,16,2.0955433455433456,25,14
"['00', '011010', '0000001']",1,3,11,4,0,15,1.2521367521367521,13,10
"['110110', '1', '10001', '0101011', '100010', '011101']",1,6,14,17,3,31,7.7866300366300365,52,40
"['0011', '01', '0010']",1,3,6,4,2,10,2.083333333333333,5,8
"['101', '1', '01011']",1,3,3,6,0,9,1.5833333333333333,8,8
"['1101001', '10101', '0111']",1,3,6,10,0,16,2.0454545454545454,8,10
"['0010', '010001', '111', '101', '1001', '100111', '1110100']",1,7,15,18,6,33,12.759102009102008,61,66
"['0011001', '101100', '10100']",1,3,10,8,0,18,2.344988344988345,6,12
"['01', '1000111', '11']",1,3,4,7,2,11,1.3888888888888888,11,10
"['01', '10011', '111', '00001']",1,4,7,8,2,15,2.892857142857143,16,17
"['1000010', '000111', '0']",1,3,9,5,0,14,1.151098901098901,14,6
"['1110111', '0101', '0011010', '0000']",1,4,11,11,4,22,3.071428571428571,22,12
"['0010', '0000011', '011000']",1,3,12,5,0,17,1.606993006993007,11,12
"['11110', '0010', '11100', '011']",1,4,7,10,2,17,3.2603174603174603,15,18
"['0111', '001', '011000', '1111']",1,4,7,10,2,17,3.0515873015873014,17,17
"['10', '0011000', '11']",1,3,6,5,2,11,1.3888888888888888,11,4
"['1101', '110', '011000']",1,3,6,7,0,13,2.123809523809524,7,6
"['110', '101111', '11']",1,3,2,9,0,11,1.7444444444444445,9,13
"['11001', '11010', '0', '11']",1,4,5,8,2,13,2.6095238095238096,18,16
"['00010', '011010', '1', '0000011']",1,4,12,7,0,19,2.7245254745254743,24,14
"['1011', '010', '111', '00001']",1,4,7,8,2,15,2.6706349206349205,15,12
['1000010'],1,1,5,2,0,7,0,0,0
"['010', '1001', '0110', '1111001']",1,4,8,10,2,18,3.601298701298701,19,13
"['00', '0101110', '0000010', '1010011']",1,4,14,9,3,23,3.0476190476190474,24,15
"['101100', '11110', '010001', '100010', '0000', '001100']",1,6,20,13,4,33,8.822222222222223,40,45
"['100110', '000010', '11111']",1,3,8,9,2,17,1.2121212121212122,10,5
"['00', '10', '101111']",1,3,4,6,2,10,1.25,10,5
"['010001', '1010100', '1', '1000']",1,4,11,7,0,18,2.8965534465534466,22,14
"['0110101', '0101111', '0110', '0101010', '00']",1,5,13,14,3,27,6.142857142857142,34,37
"['101100', '0010000', '11', '0110', '1011000', '101001']",1,6,18,14,4,32,9.476756576756577,46,41
"['11110', '10101', '11']",1,3,3,9,2,12,1.5428571428571427,9,10
"['0010110', '101', '00101', '00011']",1,4,11,9,2,20,4.15,15,18
"['01', '00', '0110100', '110111']",1,4,8,9,2,17,2.7542735042735043,23,13
"['101110', '111', '1000010', '1110']",1,4,8,12,0,20,3.702830502830503,18,22
"['010001', '1', '001101', '111101']",1,4,8,11,3,19,2.357142857142857,23,19
"['0001011', '1', '001111']",1,3,6,8,0,14,1.304945054945055,13,8
"['101000', '11000', '00', '0111', '0101']",1,5,12,9,2,21,5.61940836940837,28,29
"['11', '111010', '0000100', '111011']",1,4,9,12,2,21,2.824786324786325,24,21
"['00111', '1', '1110']",1,3,3,7,0,10,1.4,10,8
"['11001', '0010', '111000', '11', '000101', '10000', '01010', '1011011', '0100']",1,9,24,20,7,44,21.413070263070264,106,94
"['00101', '0110100', '0011', '011101', '01000']",1,5,15,12,2,27,6.454079254079254,26,35
"['0000011', '011100', '1111']",1,3,8,9,0,17,1.425174825174825,13,7
"['0001101', '1100', '000001', '0100']",1,4,14,7,2,21,3.0744755244755244,18,21
"['01100', '010101', '01111', '1110']",1,4,8,12,2,20,3.787878787878788,13,18
"['0', '101', '0110', '111']",1,4,4,7,2,11,2.7095238095238097,14,8
"['11000', '11101', '1']",1,3,4,7,2,11,1.2666666666666666,10,9
"['0111101', '11011', '111']",1,3,3,12,0,15,2.0166666666666666,9,12
"['0010001', '0010', '11']",1,3,8,5,0,13,1.505050505050505,11,7
"['01', '10000', '1110', '11']",1,4,6,7,2,13,2.515873015873016,17,14
"['01', '111', '101', '100000', '0100100']",1,5,12,9,2,21,4.997008547008547,34,22
"['11', '11000', '1101101', '0110', '100111', '0101', '1011111']",1,7,12,23,4,35,12.516600066600066,68,66
"['0001', '1', '01011']",1,3,5,5,0,10,1.1777777777777778,9,6
"['00', '011010', '1']",1,3,5,4,0,9,0.7857142857142857,11,4
"['1100011', '101', '00', '110']",1,4,7,8,2,15,3.111111111111111,19,13
"['101111', '0110', '000', '1']",1,4,6,8,0,14,2.079365079365079,21,8
"['0', '001111', '111', '0010100', '0011111']",1,5,10,14,2,24,4.562271062271062,39,40
"['000101', '111', '111100']",1,3,6,9,2,15,1.4444444444444444,11,11
"['0', '11110', '001010']",1,3,6,6,0,12,0.9826839826839826,12,9
"['000110', '101110', '100010']",1,3,10,8,3,18,2.1666666666666665,6,11
"['1100011', '0001010', '110000', '010011']",1,4,15,11,4,26,4.137362637362638,18,22
"['11110', '0101110', '00001', '0110', '100110']",1,5,13,14,2,27,6.047008547008547,28,37
"['0', '11011', '111', '00100', '01111', '0011111']",1,6,9,17,3,26,6.833333333333333,51,48
"['1000', '001', '1001', '0000']",1,4,11,4,3,15,4.0,9,21
"['110000', '01', '110']",1,3,6,5,0,11,1.3166666666666667,10,8
"['0101110', '011', '00011', '100', '0000011', '011111', '1011']",1,7,16,19,4,35,12.333993783993783,66,67
"['0', '11010', '1001', '011111', '1011011']",1,5,8,15,0,23,5.044338994338994,35,22
"['1000100', '101100', '111100', '1', '1010011', '1101010']",1,6,16,18,5,34,7.98992673992674,55,46
"['0010', '0110100', '11', '1100010', '00', '100101']",1,6,16,12,4,28,8.131224331224331,52,36
"['0', '0011101', '1101111', '0000010', '1000011']",1,5,15,14,4,29,4.428571428571429,45,19
"['1110001', '1110110', '0110100']",1,3,9,12,3,21,2.142857142857143,8,7
"['11', '000', '1011', '101001', '111001']",1,5,9,12,2,21,5.074603174603174,29,34
"['0', '011', '101110']",1,3,4,6,0,10,1.4523809523809523,10,6
"['0001110', '111', '1001010', '1110011', '0010011', '1011111']",1,6,15,23,5,38,9.228571428571428,51,54
"['10101', '00', '000100', '1']",1,4,9,5,0,14,2.2359307359307357,21,12
"['01', '00', '01111']",1,3,4,5,2,9,1.3571428571428572,8,7
"['1101', '010', '11']",1,3,3,6,0,9,1.638095238095238,6,6
"['01', '1101111', '00100', '000101', '0111']",1,5,11,13,0,24,5.476401376401376,34,25
"['110001', '0000001', '10', '0101', '01110']",1,5,14,10,0,24,5.084792984792984,36,25
"['0111011', '11', '0000010', '1001001', '1011']",1,5,13,14,3,27,5.167388167388167,40,28
"['00010', '001011', '0100']",1,3,10,5,0,15,1.993939393939394,7,11
"['0', '101', '0010000']",1,3,8,3,0,11,1.15,13,4
"['11000', '0110', '1001101', '00', '011111', '01110']",1,6,13,16,2,29,8.859756909756909,47,42
"['01100', '000', '11']",1,3,6,4,0,10,1.0714285714285714,8,6
"['0010110', '001', '10010', '0000']",1,4,13,6,0,19,3.982034632034632,16,21
"['11001', '100101', '011']",1,3,6,8,0,14,1.893939393939394,8,10
"['1001110', '101100', '0010', '101101', '1011110', '000001', '0111', '000']",1,8,22,21,7,43,16.221289821289822,83,84
"['0001', '100', '1', '001110']",1,4,8,6,0,14,2.8015873015873014,19,13
"['0000', '1010', '01', '11']",1,4,7,5,4,12,2.6666666666666665,14,10
"['01', '0010000', '101', '1001', '111011', '110011']",1,6,13,15,2,28,9.049605949605949,47,43
"['00', '111', '11010']",1,3,4,6,0,10,1.3214285714285714,8,6
"['1100001', '10101', '0000']",1,3,10,6,0,16,1.8383838383838382,9,5
"['010100', '1101', '110111', '01010']",1,4,9,12,2,21,4.0212121212121215,14,16
"['101', '00', '010', '0001']",1,4,8,4,2,12,3.676190476190476,11,13
"['11010', '10101', '10110', '00', '11101', '11111']",1,6,9,18,5,27,8.6,36,42
"['0', '11001', '0101110', '10101', '10001', '01111']",1,6,12,16,4,28,7.75,49,33
"['000011', '11', '1001010', '1011100', '011111', '001100']",1,6,16,18,5,34,7.868742368742369,55,41
"['1', '1000110', '10001', '1101', '0100101']",1,5,12,12,2,24,5.553679653679653,36,34
"['101100', '0100010', '10001', '1110011', '10', '0101']",1,6,16,15,2,31,9.167876567876569,49,35
"['00', '001101', '01100', '101101']",1,4,10,9,2,19,3.8593073593073592,16,19
"['1001100', '1', '001101']",1,3,7,7,0,14,1.304945054945055,13,7
"['10001', '010', '110', '011']",1,4,7,7,3,14,3.5,13,13
"['000100', '100', '0110001', '11']",1,4,11,7,0,18,2.9764957264957266,23,13
"['00', '010111', '1001111', '11']",1,4,6,11,2,17,2.658119658119658,23,16
"['10111', '1110', '1101100']",1,3,5,11,0,16,1.8787878787878787,8,10
"['1100', '111100', '10']",1,3,5,7,0,12,1.9666666666666668,8,10
"['0', '1011001', '1010', '000010', '011111']",1,5,12,12,2,24,4.512803862803863,40,22
"['0010', '001', '111', '0100']",1,4,8,6,4,14,3.083333333333333,13,14
"['100', '1110', '00000']",1,3,8,4,0,12,1.2936507936507935,9,8
"['1', '000', '000010']",1,3,8,2,0,10,0.9523809523809523,11,8
"['010', '1000111', '10', '000010', '001011']",1,5,14,10,2,24,6.029059829059829,33,25
"['0101010', '110', '0110']",1,3,7,7,0,14,1.9844155844155844,8,13
"['11010', '00001', '01000', '00', '1011100', '0101', '0011100']",1,7,21,14,5,35,12.095670995670995,66,75
"['110101', '010', '110', '00000']",1,4,10,7,2,17,3.1136363636363633,18,13
"['1011110', '110101', '110001', '0']",1,4,8,12,2,20,2.7316849816849818,26,13
"['101', '0101110', '00101', '1']",1,4,7,9,0,16,3.1,21,12
"['00', '0101', '00101']",1,3,7,4,0,11,2.126984126984127,6,11
"['001', '000001', '01010', '0000', '110']",1,5,15,6,2,21,4.909668109668109,27,34
"['1000', '10', '1100110']",1,3,7,6,0,13,1.8383838383838382,10,8
"['1100111', '1100010', '110', '100110']",1,4,10,13,2,23,3.8117216117216115,17,25
"['00', '110', '001101', '1011100']",1,4,9,9,0,18,3.2264957264957266,21,17
"['101011', '010', '011']",1,3,5,7,2,12,2.0,7,7
"['01101', '1000101', '1']",1,3,6,7,0,13,1.25,13,10
"['101100', '010', '00101', '00000', '11', '1001', '00010']",1,7,19,11,3,30,11.29018759018759,57,53
"['0', '0011000', '110001', '11101', '11100']",1,5,12,12,2,24,5.392823842823843,34,24
"['01', '1010', '10100', '000']",1,4,9,5,0,14,3.598412698412698,12,17
"['0', '1100', '001011']",1,3,6,5,0,11,1.0857142857142859,12,8
"['100101', '0100', '11']",1,3,6,6,0,12,1.4333333333333333,10,4
"['0101', '0100101', '0000']",1,3,10,5,2,15,1.7727272727272727,8,11
"['001', '00111', '00', '01010', '1101']",1,5,10,9,2,19,5.8087301587301585,24,26
"['0101', '1101', '0111111', '011']",1,4,5,13,2,18,3.8694805194805193,16,21
"['11', '0100', '100101', '100011', '1111011']",1,5,10,15,2,25,5.405516705516706,36,35
"['101', '100100', '110', '0010101']",1,4,10,9,2,19,3.547008547008547,19,16
"['1100010', '111001', '001000']",1,3,11,8,2,19,1.8846153846153846,9,5
"['010', '111110', '0010', '0101100']",1,4,10,10,0,20,3.4624264624264622,19,25
"['10', '10000', '00000']",1,3,10,2,2,12,1.657142857142857,8,13
"['111111', '011', '10', '00000']",1,4,7,9,0,16,1.6301587301587301,25,12
"['0010000', '1000', '0110', '0001000']",1,4,17,5,4,22,3.9025974025974026,19,32
"['01', '011011', '1000', '0000', '00010', '000111']",1,6,17,10,4,27,8.483044733044732,44,53
"['010', '110', '001111', '1']",1,4,5,8,2,13,2.841269841269841,18,12
"['1011', '00', '0100']",1,3,6,4,2,10,1.5,8,6
"['01101', '0011', '111011', '10', '0000', '011111']",1,6,11,16,4,27,7.487085137085137,47,39
"['011', '00111', '0110000', '0001100', '110']",1,5,14,11,4,25,6.197619047619048,35,33
"['0', '1111110', '1101100']",1,3,5,10,2,15,0.9285714285714286,14,7
"['01', '01101', '10000']",1,3,7,5,2,12,1.2571428571428571,11,8
"['110000', '110111', '0000111', '0100']",1,4,12,11,2,23,3.0944055944055946,22,23
"['1010110', '1001010', '11', '0100001', '0101']",1,5,14,13,3,27,6.038961038961039,35,25
"['01', '011', '11', '0010100', '011001']",1,5,10,10,2,20,5.717094017094017,31,25
"['1000001', '0010', '001', '0100100']",1,4,15,6,2,21,4.044155844155844,19,16
"['1000000', '00', '1000', '100101', '0100011', '01110']",1,6,20,11,2,31,8.478987678987679,53,42
"['110000', '01', '1101111', '000011', '001110', '0001010', '0100']",1,7,21,17,5,38,11.2506771006771,77,64
"['10010', '1', '011']",1,3,4,5,0,9,1.3333333333333333,9,6
"['1110101', '01', '1001000', '111011']",1,4,9,13,2,22,3.344932844932845,23,20
"['10111', '1111001', '000', '00010', '000111']",1,5,13,13,2,26,5.382750582750583,34,34
"['100110', '00', '100']",1,3,7,4,0,11,1.9666666666666668,8,10
"['11110', '1000', '110', '101110']",1,4,7,11,0,18,3.9416305916305916,14,21
"['1001110', '11110', '1', '0001110', '00111', '1010']",1,6,12,17,4,29,8.352092352092352,48,46
"['0', '0110100', '0011', '1001', '1010011', '0001010']",1,6,17,13,5,30,8.118181818181817,58,33
"['01101', '1', '001101']",1,3,5,7,0,12,1.528138528138528,10,10
"['1101001', '0101000', '000', '0001010', '001100']",1,5,20,10,3,30,6.420512820512821,31,42
"['111', '01111', '1010', '000010', '110']",1,5,9,12,2,21,5.134271284271284,28,29
"['1110111', '1', '0110', '1010', '000000']",1,5,11,11,2,22,3.8447552447552447,42,17
"['1010', '01', '0000000']",1,3,10,3,0,13,1.2525252525252526,13,6
"['01', '110010', '00000', '100', '0000010']",1,5,17,6,0,23,5.190997890997891,34,36
"['011011', '00101', '1101100']",1,3,8,10,0,18,1.9965034965034967,9,8
"['0000101', '00', '10011']",1,3,9,5,0,14,1.6825396825396823,11,6
"['1000100', '0010010', '11011', '1']",1,4,11,9,2,20,2.5476190476190474,27,11
"['0010', '00', '100', '011']",1,4,8,4,2,12,3.342857142857143,12,19
"['00', '0010111', '10000']",1,3,9,5,0,14,1.5158730158730158,13,11
"['0', '110001', '10', '1100110', '01110']",1,5,10,11,0,21,4.866272616272616,37,25
"['110000', '00', '01']",1,3,7,3,2,10,1.25,10,8
"['0001', '1100110', '100010']",1,3,10,7,0,17,2.114685314685315,8,7
"['1010', '1001', '0110100', '1000']",1,4,11,8,3,19,4.068181818181818,14,15
"['01', '0100000', '0110', '1000', '000010']",1,5,17,6,2,23,5.6864024864024865,32,37
"['0', '0100000', '010101', '1111111']",1,4,10,11,2,21,1.7554945054945055,31,12
"['01', '0011', '11111', '0000110', '0100101']",1,5,12,13,2,25,5.287878787878788,37,23
"['1001', '101110', '11']",1,3,4,8,0,12,1.7666666666666666,9,9
"['0100', '0111', '11']",1,3,4,6,2,10,1.5,7,7
"['0', '010100', '011100', '11000', '110011', '111111', '1011']",1,7,14,20,4,34,10.647041847041846,71,57
"['0001', '01010', '011000']",1,3,10,5,0,15,1.7717171717171718,7,11
"['010', '110', '011']",1,3,4,5,3,9,2.0,4,9
"['01', '0111010', '00111', '1000', '1110100', '101110']",1,6,14,17,2,31,8.564701964701964,52,38
"['11000', '110', '1']",1,3,4,5,0,9,1.5833333333333333,8,8
"['0011', '000001', '1100110', '01110']",1,4,12,10,0,22,3.319114219114219,19,16
"['0', '01', '01011']",1,3,4,4,0,8,1.5714285714285714,8,7
"['11011', '1000', '1001']",1,3,6,7,2,13,1.8611111111111112,6,10
"['0', '1001', '00001', '11']",1,4,7,5,0,12,2.3523809523809525,17,12
"['0', '0011', '100']",1,3,5,3,0,8,1.4714285714285715,8,7
"['10110', '011', '11']",1,3,3,7,0,10,2.1214285714285714,6,8
"['01', '10110', '110100', '101101']",1,4,8,11,2,19,3.8744588744588744,17,17
"['0001', '0101', '1011111']",1,3,6,9,2,15,1.4090909090909092,10,7
"['0111', '01', '110100']",1,3,5,7,0,12,1.5666666666666667,10,8
"['1001110', '100', '110011', '00', '1011011']",1,5,11,14,2,25,6.308302808302808,34,27
"['00', '100', '0000110', '00010']",1,4,13,4,0,17,3.549206349206349,19,29
"['11001', '011', '101', '10000', '10', '11111']",1,6,9,14,5,23,7.695238095238095,41,45
"['010', '0010111', '011', '0011001', '0110', '1000000', '0000', '1110']",1,8,23,16,8,39,15.543290043290042,92,88
"['11110', '10000', '1111']",1,3,5,9,2,14,1.511111111111111,8,12
"['0010110', '01', '001111', '011', '001000', '0100']",1,6,16,12,2,28,9.159385059385059,45,53
"['1110011', '000', '1110']",1,3,6,8,0,14,1.412987012987013,11,8
"['01', '110010', '11010']",1,3,6,7,0,13,1.9805194805194803,8,10
"['11001', '00100', '1110001', '00011']",1,4,12,10,3,22,3.8,19,17
"['00100', '00010', '01111', '011']",1,4,10,8,3,18,3.35,16,19
"['010100', '1010', '001', '000000']",1,4,14,5,2,19,2.9936507936507937,17,19
"['010', '101011', '11101', '0111', '000']",1,5,9,12,2,21,5.197041847041847,26,21
"['1111100', '11', '101', '101000', '10000', '0101']",1,6,13,14,0,27,8.371373071373071,47,44
"['1000010', '0011', '1001011']",1,3,10,8,2,18,1.987012987012987,9,10
"['0001100', '0001', '100100', '1100']",1,4,14,7,2,21,3.923776223776224,16,27
"['0010', '01001', '01011', '110010']",1,4,11,9,2,20,4.206060606060606,13,18
"['00100', '0011', '10110', '111111', '1100', '1001111']",1,6,12,19,4,31,8.166899766899768,47,49
"['0011', '11111', '101110', '011000']",1,4,8,13,2,21,3.22020202020202,19,13
"['01', '11110', '1100100', '1000', '10010', '10011', '00010', '1111111', '111001']",1,9,20,26,6,46,19.782883782883783,114,110
"['0010110', '101', '0110', '111']",1,4,7,10,2,17,3.536796536796537,17,11
"['10111', '010000', '10', '110001']",1,4,10,9,2,19,3.1471861471861473,20,12
"['0010', '100', '0100001', '1011', '01000']",1,5,15,8,2,23,6.028210678210678,27,26
"['1100111', '1101101', '1', '111010']",1,4,6,15,2,21,2.8846153846153846,25,25
"['100001', '1', '0110', '1101110', '0001010']",1,5,13,12,2,25,4.688611388611388,40,20
"['001', '011', '0001', '00', '1101', '1100']",1,6,11,9,5,20,8.997619047619047,30,45
"['00', '010', '11']",1,3,4,3,2,7,1.2000000000000002,5,4
"['0', '0100111', '001']",1,3,6,5,0,11,1.35,12,6
"['00110', '0000001', '0101001']",1,3,13,6,2,19,1.7142857142857144,9,9
"['1001100', '00100', '1000']",1,3,11,5,0,16,1.893939393939394,7,14
"['0110101', '101100', '10101', '1001', '000', '000010']",1,6,18,13,2,31,9.05907425907426,42,43
"['10100', '100', '01100', '11']",1,4,8,7,2,15,3.842857142857143,14,17
"['0101111', '0101110', '01101', '001', '10', '0000']",1,6,14,14,2,28,7.6090909090909085,49,43
"['1010', '100', '1100', '11']",1,4,6,7,2,13,4.197619047619048,10,17
"['0001101', '00010', '01110']",1,3,10,7,2,17,2.1,7,12
"['0', '1010', '10010']",1,3,6,4,0,10,1.6222222222222222,8,9
"['01', '011', '10010', '01000', '1110']",1,5,10,9,2,19,5.536507936507936,25,25
"['01', '00011', '10111', '10001', '0110', '1010', '010011', '110']",1,8,16,18,5,34,17.18982683982684,70,74
"['010', '110', '000001']",1,3,8,4,2,12,1.3333333333333333,10,7
"['11000', '010', '1']",1,3,5,4,0,9,1.3333333333333333,9,4
"['1100010', '1110010', '101111']",1,3,8,12,2,20,1.934065934065934,9,13
"['101', '010', '110', '01111']",1,4,5,9,3,14,3.5,14,13
"['1011', '001011', '111']",1,3,4,9,0,13,1.8158730158730159,6,15
"['01', '0010', '1000110', '0001', '10', '0000111']",1,6,16,10,6,26,8.58044733044733,49,39
"['11001', '110', '1', '000']",1,4,6,6,2,12,2.4166666666666665,16,12
"['000011', '1011110', '10001', '0010011', '11100']",1,5,15,15,4,30,5.980286380286381,33,29
"['0', '1011', '110']",1,3,3,5,0,8,1.4714285714285715,7,5
"['1101', '0100011', '1']",1,3,5,7,0,12,1.0136363636363637,13,9
"['01', '00110', '00']",1,3,6,3,2,9,1.6428571428571428,7,10
"['1110011', '001', '000']",1,3,7,6,2,13,1.6666666666666665,10,6
"['1111100', '001000', '101', '0001', '101000', '1100000', '1000000', '101111']",1,8,27,19,6,46,15.05063825063825,96,103
"['001', '0010101', '1110']",1,3,7,7,0,14,1.2493506493506494,11,9
"['100', '1100', '111', '01100']",1,4,7,8,2,15,3.9007936507936507,11,19
"['00', '0100111', '10']",1,3,6,5,2,11,1.3888888888888888,11,6
"['0010001', '1010', '100001', '0111']",1,4,12,9,2,21,3.36013986013986,20,16
"['0111000', '0110100', '0110001', '10101', '00', '0101', '01000']",1,7,22,15,5,37,14.036507936507936,61,77
"['111111', '1000', '0101100']",1,3,7,10,0,17,1.053146853146853,12,5
"['0001001', '010', '111', '101', '1000110', '1110100', '000', '000100']",1,8,23,16,7,39,15.088644688644688,91,82
"['100011', '100001', '101101']",1,3,9,9,3,18,2.1666666666666665,6,18
"['1100', '0101', '1']",1,3,4,5,2,9,1.3,8,6
"['01101', '11', '01100', '100000', '00010', '1110']",1,6,15,12,3,27,8.159379509379509,44,38
"['01101', '100', '1001', '110011', '1110100', '01011']",1,6,13,17,2,30,9.235153735153736,41,44
"['00', '1110010', '1001']",1,3,7,6,0,13,1.8383838383838382,10,4
"['100100', '1', '1001101']",1,3,7,7,0,14,1.304945054945055,13,11
"['1110111', '01', '1001010', '0011110', '00110']",1,5,12,16,3,28,5.928571428571429,37,25
"['0010', '000', '0111', '1101']",1,4,8,7,3,15,2.9285714285714284,14,13
"['111100', '11', '1001', '0000010', '101110']",1,5,12,13,2,25,5.236907536907537,38,23
['0011110'],1,1,3,4,0,7,0,0,0
"['0010110', '1', '011', '100100', '1000', '0001010']",1,6,17,11,2,28,7.902386502386502,54,38
"['11110', '11', '0100010', '101', '101011', '10011']",1,6,11,17,2,28,8.492080142080143,45,49
"['0001001', '1110010', '1101111', '1001', '0010010']",1,5,16,16,4,32,6.298701298701299,34,29
"['0', '11011', '1100', '011110']",1,4,6,10,0,16,2.831168831168831,20,13
"['0', '01010', '001101', '101001']",1,4,10,8,2,18,2.8593073593073592,22,11
"['1010', '001', '100']",1,3,6,4,2,10,2.095238095238095,5,8
"['1110110', '0110100', '10']",1,3,7,9,2,16,1.6031746031746033,12,7
"['101100', '111010', '00101']",1,3,8,9,2,17,1.7575757575757573,8,7
"['0', '1011010', '101001', '11']",1,4,7,9,0,16,2.0955433455433456,24,12
"['11010', '1010110', '1001101', '110011', '00', '000010', '110']",1,7,18,18,4,36,12.50001665001665,67,57
"['0', '11101', '001', '11']",1,4,4,7,0,11,2.3047619047619046,16,13
"['01', '11110', '0100011', '11111']",1,4,6,13,2,19,2.4825396825396826,23,22
"['1100011', '1101', '10']",1,3,5,8,0,13,1.8383838383838382,10,11
"['0', '0110010', '0001', '111011', '1101']",1,5,10,12,2,22,4.951798201798202,34,19
"['0010', '001', '01111', '10010', '001110']",1,5,12,11,2,23,6.761688311688312,24,33
"['11001', '11010', '101', '1001', '100101', '1101']",1,6,11,16,4,27,11.818831168831169,25,77
"['0100010', '1100', '01110']",1,3,9,7,0,16,1.8787878787878787,9,10
"['0110101', '010000', '111', '0110', '11100']",1,5,12,13,0,25,5.811249861249861,30,28
"['0110101', '0110110', '101001', '0001', '1111', '01000', '0101', '110', '01100', '0111100']",1,10,25,27,8,52,27.573304473304475,125,136
"['1010110', '100', '1111']",1,3,5,9,0,14,1.2493506493506494,10,7
"['100', '010001', '1', '110101']",1,4,8,8,2,16,3.071428571428571,20,15
"['00101', '00011', '100', '10000', '0001101', '000']",1,6,19,9,5,28,10.0,40,65
"['000100', '010', '111100', '110']",1,4,10,8,4,18,3.388888888888889,18,19
"['110110', '1011110', '1001', '111110', '01110']",1,5,9,19,2,28,6.2882672882672885,25,36
"['1000001', '01101', '111010', '111', '000', '1011011']",1,6,14,17,4,31,8.223914973914974,50,39
"['00110', '0110100', '10', '01000']",1,4,12,7,2,19,3.5206349206349206,19,23
"['0010', '00011', '00001', '10101', '0000101', '10']",1,6,18,10,3,28,9.114574314574314,40,46
"['1010', '1101', '00011']",1,3,6,7,2,13,1.6388888888888888,8,7
"['0111101', '0011100', '111', '011110']",1,4,8,15,2,23,4.273260073260073,16,15
"['011111', '001', '110']",1,3,4,8,2,12,1.222222222222222,11,7
"['001000', '11000', '0001100', '10', '1001100']",1,5,18,9,2,27,6.416527916527916,31,44
"['0', '0110111', '10100', '10010', '0111', '1000011']",1,6,14,15,4,29,7.123520923520924,56,39
"['01', '11011', '1000010', '0000', '1001001']",1,5,15,10,2,25,5.351370851370851,35,21
"['0101111', '11', '10111', '100100', '1001', '000', '110', '0111100']",1,8,16,21,4,37,14.622860472860472,92,74
"['101', '001001', '10', '011100']",1,4,9,8,2,17,3.5777777777777775,19,13
"['1101000', '001101', '1110', '11']",1,4,8,11,0,19,3.371950271950272,21,18
"['01', '010', '110']",1,3,4,4,2,8,1.8666666666666667,4,8
"['1', '10', '000']",1,3,4,2,0,6,1.0666666666666667,6,4
"['0001', '1100110', '011100', '1110']",1,4,10,11,2,21,3.1562937062937064,21,16
"['0110', '10', '1011', '111101', '0100']",1,5,8,12,3,20,6.1,26,20
"['10100', '100', '100000', '0111']",1,4,11,7,0,18,2.8922799422799423,18,20
"['101100', '0100010', '00', '11111', '101111']",1,5,11,15,2,26,4.362276612276612,38,27
"['10100', '00', '000101']",1,3,9,4,0,13,1.6168831168831168,10,11
"['1', '10', '001010']",1,3,5,4,0,9,1.4523809523809523,10,5
"['00', '110', '0111']",1,3,4,5,0,9,1.3047619047619048,7,7
"['0', '0010', '1101', '11']",1,4,5,6,2,11,2.3,16,10
"['000110', '00101', '111', '11101', '000000', '000100', '01000']",1,7,23,13,6,36,11.00909090909091,64,75
"['101010', '1011', '101111', '0001100']",1,4,10,13,2,23,3.7351981351981354,18,18
"['10100', '0010', '10']",1,3,7,4,0,11,1.9047619047619047,7,9
"['1110110', '011', '111']",1,3,3,10,2,13,1.8666666666666667,9,13
"['1', '101', '010010', '10000', '00110', '1001001']",1,6,16,11,2,27,8.092823842823844,49,33
"['010', '11011', '00001', '0011', '0110', '10011', '0001011', '1011']",1,8,18,19,6,37,18.37222222222222,66,87
"['01', '11', '1001', '01111', '01000']",1,5,8,10,4,18,5.344444444444444,26,24
"['01', '0100', '011000', '001000']",1,4,13,5,2,18,4.1,15,28
"['0010', '01101', '111100', '1', '1011001', '10100', '000', '1001001']",1,8,20,18,4,38,15.001620601620601,87,71
"['00011', '0110', '10', '0000', '01001']",1,5,13,7,4,20,5.601587301587301,25,28
"['110110', '1100', '11']",1,3,4,8,0,12,1.9666666666666668,8,12
"['0', '100101', '101101']",1,3,6,7,2,13,1.0714285714285714,11,7
"['01111', '1011001', '1101111']",1,3,5,14,2,19,2.2142857142857144,8,13
"['001', '100', '10', '0101', '0110110', '1111011']",1,6,11,15,4,26,8.352092352092352,48,33
"['0', '0010001', '110100', '0100100', '0011011']",1,5,17,11,3,28,4.881868131868132,42,32
"['11', '11010', '1101', '111011']",1,4,4,13,0,17,4.154256854256854,14,33
"['0010', '001', '101101', '1100100', '001010', '0111', '000']",1,7,19,14,6,33,13.284326784326783,58,64
"['101', '00', '101110', '1011010']",1,4,8,10,0,18,3.534188034188034,19,18
"['1', '0101101', '10111', '1101101', '100010', '1010000']",1,6,15,18,3,33,7.927322677322677,56,46
"['101', '010', '01111', '101011']",1,4,6,11,2,17,3.5454545454545454,16,14
"['0', '1100101', '1001111']",1,3,6,9,2,15,1.2142857142857144,15,5
"['1010010', '0011010', '100000', '10', '0111', '1011000', '0101']",1,7,21,16,5,37,11.80870795870796,69,58
"['10101', '01101', '0110', '000001']",1,4,11,9,2,20,3.0606060606060606,16,17
"['101', '00', '1101']",1,3,4,5,0,9,1.5904761904761904,6,6
"['101', '0010', '11101', '1001']",1,4,7,9,2,16,4.0396825396825395,12,17
"['11000', '0001', '101']",1,3,7,5,0,12,1.7380952380952381,8,9
"['011101', '101', '0000100']",1,3,9,7,0,16,1.528205128205128,12,6
"['1110111', '00011', '00111', '101', '1111001', '111011', '0001111', '10']",1,8,14,28,5,42,16.138283938283937,97,122
"['1100111', '1', '111011']",1,3,3,11,0,14,1.304945054945055,13,17
"['01', '110', '10', '111']",1,4,3,7,4,10,3.166666666666667,10,15
"['0001011', '001', '001010']",1,3,10,6,0,16,2.0358974358974358,9,10
"['1000100', '0010', '11110', '11', '0101']",1,5,11,11,2,22,5.260822510822511,32,22
"['01', '001', '00000', '10101', '111101']",1,5,11,10,2,21,4.728860028860029,31,27
"['0010', '0111001', '011', '01111', '1111000', '100010', '1100111']",1,7,17,22,3,39,12.623137973137974,74,64
"['1011', '010', '111']",1,3,3,7,2,10,1.476190476190476,5,6
"['1100011', '01011', '0']",1,3,6,7,0,13,1.25,13,7
"['010100', '010', '000', '11']",1,4,9,5,2,14,2.6777777777777776,16,16
"['010100', '0101110', '001111', '1111', '1001111', '101111']",1,6,12,24,5,36,10.435730935730936,39,62
"['110001', '1', '00101']",1,3,6,6,0,12,1.1645021645021645,12,9
"['0', '011100', '1111011']",1,3,5,9,0,14,1.151098901098901,14,4
"['011111', '01001', '1110000']",1,3,8,10,0,18,1.506993006993007,12,9
"['0', '1110010', '100101']",1,3,7,7,0,14,1.304945054945055,14,4
"['0000101', '0010', '010111', '1']",1,4,10,8,0,18,2.8783716283716285,23,11
"['00101', '10111', '100', '1111010', '100101', '01100']",1,6,14,17,3,31,8.898717948717948,41,42
"['1000101', '1011100', '0011100', '0100']",1,4,14,11,3,25,3.7142857142857144,18,22
"['11101', '1', '011000']",1,3,5,7,0,12,1.1645021645021645,12,4
"['011100', '0011', '00100', '1100', '101', '110']",1,6,13,12,4,25,9.309812409812409,38,46
"['000110', '0010', '011100', '1000000', '1010', '111111', '1110']",1,7,19,18,6,37,10.935314685314685,68,62
"['1100010', '001', '1100', '110100']",1,4,11,9,0,20,3.9123765123765124,18,23
"['010', '00101', '1111001', '111111', '110', '1110']",1,6,9,19,2,28,8.416489066489067,46,49
"['00111', '0011110', '110', '111101']",1,4,7,14,0,21,3.9146853146853147,18,20
"['111', '0001', '100110', '1010', '0101']",1,5,10,11,3,21,5.623015873015873,25,23
"['0', '111010', '1001', '110011', '1000']",1,5,10,11,4,21,5.388095238095238,30,22
"['011111', '1100010', '000111', '10000']",1,4,12,12,2,24,3.1503496503496504,22,18
"['1011100', '01100', '111001']",1,3,8,10,0,18,2.3298368298368297,7,7
"['111', '000101', '000', '0001010', '1100']",1,5,14,9,2,23,4.940681540681541,32,37
"['1', '0110', '0111']",1,3,3,6,2,9,1.55,7,6
"['00111', '101', '0011', '1100010', '000', '00010', '0101', '110']",1,8,19,15,7,34,16.76075036075036,72,82
"['101', '001', '00001']",1,3,7,4,2,11,1.9166666666666665,6,11
"['1001', '001', '000010']",1,3,9,4,0,13,2.123809523809524,7,7
"['0', '11', '1001000', '00010', '000111']",1,5,13,8,0,21,3.9546842046842046,39,27
"['10111', '10011', '000010']",1,3,8,8,2,16,1.709090909090909,8,6
"['001', '100001', '011', '1011110', '1100010', '0001111', '00110', '01000']",1,8,23,20,7,43,16.41094461094461,97,73
"['110001', '111100', '1']",1,3,5,8,2,13,1.2380952380952381,13,9
"['100', '0110', '100101', '110', '01011']",1,5,10,11,2,21,6.2002886002886,24,24
"['0011001', '10', '0']",1,3,6,4,0,10,1.3611111111111112,12,6
"['1000010', '11100', '001011', '0000010']",1,4,16,9,2,25,3.284881784881785,20,21
"['0010001', '010', '0100110', '1010', '1100011', '010011']",1,6,19,15,3,34,9.964568764568764,45,45
"['0111000', '110010', '0100111', '00', '0100']",1,5,15,11,2,26,6.066144966144966,36,37
"['0001101', '01', '0010', '10']",1,4,9,6,2,15,3.4494949494949494,19,15
"['011', '1000', '1', '0010']",1,4,7,5,2,12,2.657142857142857,15,11
"['1001100', '010', '10']",1,3,7,5,0,12,1.6444444444444444,10,8
"['001101', '0100010', '0011', '100', '0010100', '1100110']",1,6,20,14,3,34,9.76971916971917,49,48
"['10111', '01', '0100']",1,3,5,6,0,11,1.6825396825396823,8,5
"['01', '1100', '1']",1,3,3,4,0,7,1.4,7,6
"['1101001', '0010', '1', '011110']",1,4,8,10,0,18,2.5427072927072927,25,9
"['001', '00101', '1001101', '1000010', '110111', '1101', '0100']",1,7,18,18,4,36,12.770934620934622,62,62
"['01', '0110', '011110']",1,3,5,7,0,12,1.9666666666666668,8,14
"['0', '0100111', '0110111', '01011', '0100']",1,5,11,13,2,24,5.696536796536797,33,37
"['0', '101', '1010100', '1110110', '11100']",1,5,10,13,2,23,5.414285714285715,35,25
"['10111', '100', '001110', '110100']",1,4,9,11,2,20,3.3838383838383836,19,16
"['0010', '001', '000010', '0111110', '01110']",1,5,14,11,0,25,6.276257076257076,29,49
"['0010101', '00', '00101', '111101']",1,4,10,10,0,20,3.1061993561993564,21,25
"['0100010', '1001111', '1110', '011001']",1,4,11,13,2,24,3.465134865134865,21,14
"['11001', '001000', '0001', '00', '1100']",1,5,14,7,2,21,6.205772005772006,26,37
"['000110', '10110', '111010']",1,3,8,9,2,17,1.9545454545454546,8,11
"['00111', '1000110', '0100101']",1,3,10,9,2,19,2.0476190476190474,10,6
"['010', '0011000', '1100010', '110011', '000', '0111']",1,6,17,13,4,30,8.602508602508601,52,46
"['111100', '000011', '101101', '1001101', '10010', '0000', '1110']",1,7,19,19,5,38,12.53919968919969,62,63
"['11', '11101', '000', '111000', '11100', '0100']",1,6,12,13,2,25,8.111760461760461,39,54
"['10111', '1011001', '0111100']",1,3,7,12,2,19,2.2142857142857144,9,7
"['01001', '10', '000']",1,3,7,3,0,10,1.4714285714285715,7,6
"['11001', '1100111', '0100111', '01101', '0000100', '010000', '1000011', '000111', '1100']",1,9,29,25,8,54,23.12128982128982,108,125
"['0111000', '00001', '1111', '10', '01010', '0001000']",1,6,18,12,4,30,7.087590187590187,55,43
"['1100001', '110100', '000', '1101', '110', '1001011']",1,6,15,15,4,30,9.14074814074814,44,50
"['11110', '10', '001000']",1,3,7,6,0,13,1.435064935064935,11,7
"['11110', '01', '111']",1,3,2,8,0,10,1.4357142857142857,8,10
"['001', '10', '111']",1,3,3,5,2,8,1.1333333333333333,6,6
"['011111', '10', '00011']",1,3,5,8,0,13,1.081168831168831,12,7
"['0101111', '110100', '0111', '000', '1100']",1,5,11,13,2,24,5.154034854034854,34,35
"['1000001', '0011101', '11', '010101', '1011100', '0011111']",1,6,16,20,4,36,8.167887667887667,54,45
"['11001', '1001010', '00011', '11', '0110', '001011']",1,6,14,15,2,29,9.026229326229325,44,40
"['011011', '10101', '111010']",1,3,6,11,2,17,2.121212121212121,7,7
"['1', '00100', '101011', '0111', '0100011']",1,5,11,12,0,23,4.84029859029859,35,23
"['00011', '10000', '110011', '00', '10010', '11100']",1,6,16,12,4,28,9.112987012987013,42,47
"['01', '1011', '0010', '111']",1,4,5,8,2,13,3.09047619047619,12,12
"['110000', '101', '0001', '00110', '1100']",1,5,13,9,2,22,5.866089466089466,28,29
"['001', '111', '10111', '110', '01110']",1,5,6,13,5,19,5.883333333333333,23,27
"['1110010', '110001', '11111']",1,3,6,12,0,18,1.9813519813519813,8,15
"['00010', '100101', '0111']",1,3,8,7,0,15,1.7717171717171718,8,4
"['11', '1000110', '10101', '100', '1100']",1,5,10,11,0,21,6.168470418470418,28,30
"['1001000', '1000101', '111']",1,3,9,8,2,17,1.7142857142857144,12,10
"['0', '11110', '10100', '1001100', '001011']",1,5,12,12,2,24,4.293523143523143,37,26
"['101', '01', '100', '0111']",1,4,5,7,2,12,3.3904761904761904,11,15
"['1000000', '001111', '10']",1,3,9,6,0,15,1.0021367521367521,15,8
"['1000001', '0101', '10', '1101110']",1,4,10,10,2,20,3.075036075036075,25,15
"['11101', '0100101', '011001']",1,3,8,10,0,18,2.163170163170163,7,11
"['1011', '1110011', '0101110', '0100']",1,4,9,13,4,22,3.7987012987012987,20,13
"['0010001', '110110', '01', '01101', '110000', '011101', '01100']",1,7,19,18,5,37,12.85991230991231,67,65
"['010', '1111001', '1000', '000', '110101']",1,5,12,11,2,23,5.921034521034521,30,22
"['01101', '11101', '11']",1,3,3,9,2,12,1.9428571428571428,7,13
"['011111', '0010010', '1100']",1,3,8,9,0,17,1.406993006993007,12,8
"['1111100', '01010', '1110']",1,3,6,10,0,16,1.6717171717171717,9,9
"['0', '1010110', '010100']",1,3,8,6,0,14,1.304945054945055,13,8
"['0', '101', '00001']",1,3,6,3,0,9,1.3333333333333333,9,5
"['101', '111100', '01000', '1011']",1,4,8,10,0,18,3.1914862914862914,17,14
"['101100', '001011', '11']",1,3,6,8,2,14,1.6666666666666665,12,9
"['0011', '0001', '0110', '10', '001001', '1011111']",1,6,13,14,3,27,8.193861693861693,47,37
"['01101', '0111101', '001', '000000']",1,4,12,9,0,21,2.8491064491064493,21,21
"['1110101', '010011', '001', '10110']",1,4,9,12,0,21,3.575990675990676,19,14
"['0110101', '110000', '1000', '00', '1100111']",1,5,14,12,2,26,5.748662448662449,35,28
"['0011', '1101', '1010']",1,3,5,7,3,12,1.75,7,7
"['01', '111000', '001010']",1,3,8,6,2,14,1.25,12,7
"['10010', '10', '001010']",1,3,8,5,0,13,1.7987012987012987,9,11
"['0101000', '010', '011', '11', '0111', '00010']",1,6,13,11,2,24,8.631962481962482,41,47
"['00', '111', '101001']",1,3,5,6,0,11,1.1666666666666665,10,4
"['0001', '01', '10010', '001111']",1,4,9,8,0,17,3.55021645021645,18,14
"['101010', '100111', '1']",1,3,5,8,2,13,1.2380952380952381,13,9
"['0', '001', '011']",1,3,4,3,2,7,1.6666666666666665,5,6
"['0', '0011001', '1111', '0111101', '101110']",1,5,9,16,2,25,4.757342657342657,38,19
"['110000', '11011', '11000', '0000001', '1101', '01011']",1,6,17,15,3,32,8.586091686091686,43,65
"['101', '1000', '11101']",1,3,5,7,0,12,1.7658730158730158,7,11
"['100', '001', '000010', '111001']",1,4,11,7,4,18,3.6111111111111107,19,15
"['0011', '11010', '110', '0111']",1,4,6,10,2,16,3.753968253968254,14,20
"['1100001', '01', '1101']",1,3,6,7,0,13,1.8383838383838382,10,13
"['10010', '0110100', '111101', '11']",1,4,8,12,0,20,3.1767121767121766,21,12
"['0001011', '0011', '1000', '10']",1,4,10,7,2,17,3.217171717171717,20,19
"['0', '1011000', '111011']",1,3,6,8,0,14,1.151098901098901,14,4
"['110010', '010000', '011', '00011', '100', '0000']",1,6,18,9,4,27,8.486940836940837,42,53
"['0011', '111', '100110', '00000']",1,4,10,8,0,18,2.8057720057720057,18,14
"['101', '00', '101110', '11']",1,4,5,8,2,13,2.8666666666666667,16,12
"['010000', '00101', '0010011', '10010', '11100', '01000']",1,6,21,12,4,33,9.627505827505827,39,50
"['100110', '00', '111', '1101110']",1,4,7,11,0,18,2.758119658119658,21,14
"['00001', '1', '00101', '00011']",1,4,10,6,3,16,3.2,16,17
"['11', '11110', '0100100', '0000']",1,4,10,8,0,18,2.2987012987012987,23,14
"['00111', '00110', '0']",1,3,6,5,2,11,1.4666666666666668,9,11
"['0010110', '11110', '001', '111', '10110', '100110']",1,6,12,17,4,29,9.15003885003885,38,51
"['0001011', '1010', '11110']",1,3,7,9,0,16,1.323232323232323,11,8
"['1000', '00', '011', '111011']",1,4,7,8,0,15,2.669047619047619,19,15
"['1100', '001011', '010111', '1111']",1,4,7,13,4,20,3.1333333333333333,17,24
"['010', '100011', '01000']",1,3,9,5,0,14,1.9217171717171717,9,6
"['101011', '10111', '001001', '11']",1,4,7,12,2,19,3.5108225108225106,17,25
"['0100110', '1', '00000', '100', '010010']",1,5,15,7,0,22,4.7709124209124205,34,27
"['011', '00000', '101010', '0011010', '1001101', '1000']",1,6,19,13,2,32,8.787962037962037,46,42
"['1011', '0001', '00100', '11']",1,4,8,7,2,15,2.8968253968253967,16,14
"['1', '101', '1000010', '010111', '1010010']",1,5,12,12,2,24,5.086446886446886,38,29
"['0001', '010', '001011']",1,3,8,5,0,13,1.838095238095238,7,7
"['01', '101', '0011110', '0000', '110']",1,5,10,9,2,19,4.761327561327561,32,23
"['10111', '110010', '0001000', '11']",1,4,10,10,0,20,2.787823287823288,25,15
['1111111'],1,1,0,7,0,7,0,0,0
"['101', '01111', '1000', '1010000', '01011']",1,5,12,12,2,24,5.248701298701299,31,28
"['101', '1111', '0111', '011111', '0010010']",1,5,8,16,2,24,5.907930957930958,30,33
"['11110', '00', '0010']",1,3,6,5,0,11,1.3968253968253967,9,11
"['011', '1', '000001']",1,3,6,4,0,10,1.2301587301587302,11,6
"['11001', '111000', '000101', '1010011']",1,4,12,12,2,24,3.9906759906759905,18,20
"['100110', '100', '000011']",1,3,9,6,2,15,1.7777777777777777,10,9
"['110', '0001110', '0000100']",1,3,11,6,2,17,1.7142857142857144,11,13
"['110', '1', '01010']",1,3,4,5,0,9,1.3333333333333333,8,5
"['0', '110', '111']",1,3,2,5,2,7,1.1666666666666665,6,6
"['01', '0010', '100', '110111']",1,4,7,8,0,15,2.9825396825396826,18,11
"['11110', '0110', '011110']",1,3,5,10,0,15,2.375757575757576,5,18
"['1011', '000', '11']",1,3,4,5,0,9,0.9523809523809523,8,6
"['0001', '11101', '00', '011']",1,4,7,7,0,14,2.8682539682539683,16,14
"['101011', '0001', '1011', '1']",1,4,6,9,2,15,2.7857142857142856,18,23
"['000100', '001101', '1001011']",1,3,11,8,2,19,2.051282051282051,8,6
"['1011110', '01', '11']",1,3,3,8,2,11,1.3888888888888888,11,6
"['101', '00', '100001', '00110']",1,4,10,6,0,16,3.1835497835497835,19,12
"['011011', '00100', '1111', '00110', '000000', '01110', '110', '1110']",1,8,19,19,7,38,16.17049062049062,75,95
"['001', '011', '1110000', '0111011', '0010101', '000', '11111', '0100101']",1,8,20,22,7,42,14.864285714285714,101,87
"['1111000', '1111010', '011', '1111110']",1,4,7,17,3,24,3.4857142857142858,19,26
"['1010110', '100001', '00011', '1111010', '00', '100101']",1,6,17,16,4,33,8.78116328116328,50,37
"['011011', '11100', '1001111']",1,3,6,12,0,18,1.8146853146853146,10,10
"['1011101', '0001', '1000111']",1,3,8,10,2,18,1.8051948051948052,10,10
"['0001', '1001', '1101']",1,3,6,6,3,12,2.0,4,12
"['1010110', '1001', '00']",1,3,7,6,0,13,1.8383838383838382,10,5
"['011', '101', '010111', '110111', '01100', '1110']",1,6,9,18,4,27,9.517099567099567,39,46
"['11000', '10110', '000']",1,3,8,5,2,13,1.85,8,10
"['011', '1100010', '101', '1111000', '1101', '1000', '0110010']",1,7,17,18,7,35,12.91991341991342,66,58
"['1001110', '1101100', '10', '111']",1,4,7,12,2,19,2.9174603174603173,22,16
"['10101', '0010', '01011']",1,3,7,7,2,14,2.1333333333333333,6,4
"['1100010', '01010', '00001']",1,3,11,6,2,17,1.5666666666666667,9,8
"['0', '0101', '110', '110100']",1,4,7,7,0,14,3.0238095238095237,18,14
"['1101001', '110110', '01', '0000100', '100100', '01001', '1101', '000100']",1,8,25,18,5,43,17.341458541458543,84,90
"['0', '01101', '11011']",1,3,4,7,2,11,1.4666666666666668,10,4
"['001', '00000', '01000', '11']",1,4,11,4,2,15,2.2857142857142856,18,17
"['0001010', '00', '1101111', '101101']",1,4,10,12,2,22,2.826007326007326,24,10
"['01', '1', '0100110']",1,3,5,5,0,10,1.3611111111111112,12,5
"['10100', '101111', '11']",1,3,4,9,0,13,1.6168831168831168,10,12
"['0011', '000', '01000']",1,3,9,3,0,12,1.7658730158730158,7,15
"['010111', '110111', '01010', '101001', '1110']",1,5,10,17,3,27,6.211111111111111,26,32
"['1001', '111100', '0111']",1,3,5,9,2,14,1.7,10,8
"['01', '100', '1111000', '100010', '1111010']",1,5,12,13,2,25,5.521245421245421,36,29
"['0010110', '111', '00000', '00110', '0001011', '0001000']",1,6,22,12,5,34,8.719047619047618,47,69
"['010', '0110', '01100', '11']",1,4,7,7,0,14,4.134126984126984,11,18
"['1101', '111100', '000', '111001']",1,4,8,11,2,19,3.407936507936508,18,17
"['0000100', '1011111', '10100', '00110', '101111', '110101']",1,6,16,20,6,36,8.357042957042957,49,47
"['0100000', '010', '1000110', '1110011', '01111', '10000', '11101', '001010']",1,8,24,21,6,45,16.16017316017316,95,77
"['0100001', '10001', '0000011', '0100']",1,4,16,7,2,23,4.1147186147186146,17,17
"['01100', '0110', '111', '000']",1,4,8,7,2,15,3.0317460317460316,13,17
"['01', '001110', '11']",1,3,4,6,2,10,1.5,9,4
"['011011', '000100', '0111110']",1,3,9,10,2,19,1.7307692307692308,10,10
"['1000110', '11110', '010001', '0010']",1,4,12,10,0,22,3.5712509712509712,19,16
"['101100', '110', '00001', '1001', '0010101', '10', '1110110', '11100']",1,8,19,20,4,39,15.603807303807304,90,80
"['0', '1110101', '0010111', '011000']",1,4,10,11,2,21,2.4340659340659343,27,13
"['11', '1010', '10010', '01010', '0001011']",1,5,12,11,2,23,6.51053391053391,27,28
"['11100', '110', '1', '0000']",1,4,7,6,0,13,2.3134920634920633,18,13
"['0101', '100', '11101', '111101']",1,4,6,12,0,18,3.6916305916305916,15,24
"['01', '1000', '1', '010010']",1,4,8,5,0,13,2.9857142857142858,18,11
"['0', '1010', '111111', '0010011']",1,4,7,11,0,18,1.9031468531468532,27,12
"['110', '101', '10111', '0111', '11100', '101001']",1,6,9,17,4,26,9.63073593073593,36,53
"['0001001', '1', '101', '10001', '0111100']",1,5,12,11,2,23,4.621428571428571,41,26
"['01', '010', '11', '1100100', '1100']",1,5,9,9,2,18,5.487590187590188,28,28
"['0', '010', '011011', '1010', '1110001']",1,5,10,11,0,21,5.1203629703629705,35,22
"['00110', '110', '10']",1,3,5,5,0,10,2.1214285714285714,6,10
"['110000', '101', '01', '000011']",1,4,10,7,2,17,3.1055555555555556,22,17
"['1111010', '00', '10000', '101001']",1,4,11,9,0,20,3.1767121767121766,21,13
"['0010', '001', '001111', '10', '110']",1,5,9,9,2,18,5.589682539682539,26,30
"['0111010', '010001', '100', '0000001', '1111010', '10010']",1,6,20,15,3,35,8.516333666333667,52,46
"['1110111', '0000101', '10100']",1,3,9,10,2,19,1.4285714285714286,12,7
"['0001', '1011011', '1', '00101']",1,4,8,9,0,17,2.5136363636363637,21,16
"['110110', '01', '001', '00001', '0011001', '110101']",1,6,15,14,2,29,8.49998334998335,48,50
"['100111', '0110', '11111']",1,3,4,11,0,15,1.5898989898989897,8,8
"['1100111', '1011', '010', '10110']",1,4,7,12,0,19,3.8375901875901874,16,16
"['010000', '1', '10000']",1,3,9,3,0,12,1.528138528138528,10,8
"['110', '10110', '1111111']",1,3,3,12,0,15,1.4833333333333334,11,10
"['1000', '100', '1']",1,3,5,3,0,8,1.7571428571428571,6,9
"['10100', '1110110', '0101100']",1,3,9,10,2,19,2.2142857142857144,8,8
"['1000100', '001111', '111', '1000', '011010', '1001011']",1,6,16,17,4,33,8.562237762237762,51,45
"['011', '1100010', '100', '1000010', '00', '000010', '1011', '0110110']",1,8,23,16,5,39,15.550527250527251,94,87
"['0', '1010010', '100101', '0010101']",1,4,12,9,2,21,3.0384615384615383,25,14
"['0', '1101010', '1110001', '11']",1,4,7,10,2,17,2.1031746031746033,27,15
"['0011001', '1010', '1', '1110000']",1,4,10,9,2,19,2.5623376623376624,27,13
"['00100', '10', '110111', '0000000']",1,4,13,7,0,20,2.477799977799978,26,14
"['101', '010', '1110000', '11']",1,4,7,8,2,15,3.111111111111111,20,12
"['1001101', '1101', '110111', '0010011']",1,4,9,15,2,24,3.835964035964036,17,28
"['101000', '10001', '1000', '00001']",1,4,14,6,2,20,4.428282828282828,11,27
"['0', '1000', '0101']",1,3,6,3,2,9,1.3,9,6
"['0101101', '000100', '1']",1,3,8,6,0,14,1.151098901098901,14,4
"['00', '0011110', '111100', '10']",1,4,8,9,2,17,3.158119658119658,22,20
"['0010001', '1011', '01', '001111']",1,4,9,10,0,19,3.371950271950272,21,16
"['00101', '00111', '1110011', '0110', '1111', '00', '01011']",1,7,13,19,5,32,12.553679653679653,58,64
"['01', '011', '0011001', '110001', '10000', '1000', '1100011']",1,7,19,15,2,34,12.107387057387058,68,66
"['011100', '11000', '10', '000', '01001']",1,5,13,8,2,21,5.791847041847042,26,30
"['1110010', '0000100', '00100', '110001', '10100', '0010010']",1,6,24,13,5,37,10.406060606060606,43,58
"['010000', '101110', '1101100']",1,3,10,9,2,19,1.8846153846153846,9,7
"['0', '1011', '010']",1,3,4,4,0,8,1.4714285714285715,7,4
"['0001010', '1010', '0110100']",1,3,11,7,2,18,2.168831168831169,9,12
"['1001110', '0101000', '0100110', '00001', '0011010', '1111']",1,6,20,17,4,37,8.635642135642135,50,40
"['0010110', '00010', '100', '1']",1,4,10,6,0,16,2.65,21,14
"['0010', '111000', '11']",1,3,6,6,0,12,1.4333333333333333,11,7
"['1100101', '1111001', '11']",1,3,5,11,2,16,1.6031746031746033,13,18
"['0', '010', '0110']",1,3,5,3,0,8,1.7571428571428571,6,14
"['0001', '00', '011110', '001100', '1001011']",1,5,14,11,2,25,5.4001554001554,35,28
"['0001011', '0101011', '011', '101111']",1,4,9,14,2,23,3.9545787545787547,17,24
"['1111100', '001101', '11000', '10000', '00', '011110']",1,6,16,15,4,31,8.451404151404152,51,48
"['0010010', '1', '0011010']",1,3,9,6,2,15,1.3571428571428572,13,8
"['01', '001', '0111100']",1,3,6,6,0,12,1.6444444444444444,11,9
"['0', '011100', '1000', '0101100', '01010', '010011', '0111110']",1,7,19,17,4,36,11.52957042957043,69,84
"['11110', '001', '00001', '1010', '000', '101110']",1,6,14,12,4,26,7.8600288600288595,42,46
"['11001', '00101', '11', '100010', '10011', '111101']",1,6,12,17,5,29,9.414285714285715,43,57
"['1011011', '000101', '000001']",1,3,11,8,2,19,1.435897435897436,8,9
"['0011001', '111110', '111011']",1,3,6,13,2,19,1.5897435897435899,9,9
"['11001', '1101001', '11', '0001', '1101011', '10']",1,6,11,16,4,27,8.368686868686869,47,67
"['111110', '1', '000', '111001']",1,4,6,10,2,16,1.9047619047619047,25,12
"['110000', '110', '11111']",1,3,5,9,0,14,1.5303030303030303,10,12
"['0011', '11000', '1']",1,3,5,5,0,10,1.1777777777777778,11,8
"['0010001', '100', '10100', '000', '1111111', '1101010']",1,6,16,16,5,32,7.7785714285714285,56,41
"['111', '0001', '010010', '1101100', '1010', '000', '0100011', '0100']",1,8,22,16,7,38,15.978194028194029,82,84
"['0', '10', '111011']",1,3,3,6,0,9,1.4523809523809523,10,4
"['100', '001011', '11']",1,3,5,6,0,11,1.3444444444444446,10,9
"['101100', '000100', '10011', '111']",1,4,10,10,2,20,3.106060606060606,18,16
"['0', '11010', '101011', '0110', '1111']",1,5,7,13,2,20,4.5796536796536795,29,22
"['0011001', '1000000', '01', '10101']",1,4,13,8,2,21,2.833333333333333,25,17
"['0011', '1110001', '10010', '01110']",1,4,10,11,2,21,3.612121212121212,19,12
"['11110', '01', '100', '000']",1,4,7,6,2,13,2.5023809523809524,16,14
"['110000', '0111000', '1101101', '0111', '011111', '1101', '0101', '01100']",1,8,18,25,7,43,17.31105561105561,81,97
"['111010', '00000', '101', '00110', '000111']",1,5,14,11,4,25,5.142929292929293,33,28
"['101', '1100101', '1010011']",1,3,7,10,2,17,2.057142857142857,10,17
"['01', '0001', '111011', '10010', '0011111', '000000', '0111', '100000', '001011', '1011111']",1,10,26,27,8,53,23.15048285048285,156,143
"['0', '0101', '0110', '11001']",1,4,7,7,2,14,2.9944444444444445,17,12
"['0', '010', '101111', '111011']",1,4,5,11,2,16,2.626984126984127,22,11
"['01', '00001', '10100', '0111', '011111', '000111', '1110']",1,7,14,18,6,32,11.133261183261183,63,65
"['0000', '000100', '11']",1,3,9,3,0,12,1.05,11,10
"['0010', '110001', '1110101', '11101', '10', '1011', '01001']",1,7,14,19,4,33,12.961582861582862,58,65
"['0011', '100', '011101', '0000010', '0100100', '000', '011010', '1110']",1,8,24,16,8,40,15.708535908535909,89,94
"['0101000', '00101', '11000', '1000', '0001010']",1,5,19,9,4,28,6.975901875901876,28,41
"['00111', '01', '0100011']",1,3,7,7,0,14,1.6825396825396823,11,8
"['111', '00', '10', '0000110', '01000']",1,5,12,7,2,19,4.0817460317460315,34,27
"['1001100', '11000', '1011100', '1101010']",1,4,13,13,3,26,4.309523809523809,15,20
"['010', '1001000', '0111110']",1,3,9,8,2,17,1.4857142857142858,13,10
"['0100001', '01', '011', '111']",1,4,7,8,2,15,3.311111111111111,18,18
"['010010', '1101101', '10011']",1,3,8,10,0,18,2.0093240093240095,8,5
"['000111', '0101', '111', '011100']",1,4,8,11,2,19,3.7714285714285714,18,16
"['00', '1110', '11']",1,3,3,5,2,8,1.0,7,6
"['11110', '00101', '100', '1000111', '100011', '10']",1,6,13,15,2,28,8.734620934620935,48,50
"['010101', '110100', '11']",1,3,6,8,2,14,1.6666666666666665,10,8
"['101', '00', '01011', '0111']",1,4,6,8,0,14,3.2928571428571427,13,12
"['10101', '010110', '111']",1,3,5,9,0,14,1.9217171717171717,8,4
"['1110111', '11', '10101', '1101101', '0001111', '1000']",1,6,11,21,3,32,8.359307359307358,55,62
"['100', '1', '01110']",1,3,4,5,0,9,1.3333333333333333,9,4
"['0011001', '1000', '0010', '00101']",1,4,13,7,2,20,3.9393939393939394,15,23
"['00010', '100010', '001', '00001']",1,4,14,5,2,19,4.6030303030303035,12,22
"['01', '101', '10111', '0011', '0010011', '000001', '0111']",1,7,15,16,2,31,12.656632256632257,57,64
"['11110', '110', '1110100']",1,3,5,10,0,15,2.0166666666666666,8,12
"['10100', '10', '0000']",1,3,8,3,0,11,1.349206349206349,8,9
"['011', '1001', '10110', '100000', '100011', '011001']",1,6,16,14,3,30,9.576984126984128,42,49
"['00111', '01', '10010', '00001']",1,4,10,7,3,17,3.5142857142857142,17,14
"['0', '1101', '100', '100111']",1,4,6,8,0,14,3.0238095238095237,18,13
"['010100', '00111', '0011', '11000', '1011', '01001', '110']",1,7,16,16,5,32,12.665079365079364,54,62
"['100001', '11101', '10', '0101', '110']",1,5,9,11,0,20,6.116089466089466,26,29
"['0000', '1', '1001010', '001000']",1,4,13,5,0,18,2.6322177822177824,22,16
"['10111', '1100001', '01010', '0100']",1,4,11,10,2,21,3.4787878787878785,19,11
"['101100', '01', '001', '0001101', '111111', '0111', '0000']",1,7,15,17,4,32,10.118770118770119,71,59
"['01', '1001100', '00010', '001111']",1,4,11,9,0,20,3.343378843378843,21,15
"['010001', '11', '0011', '10001', '100', '000101', '010101', '1011000', '0100101']",1,9,26,20,5,46,23.032151182151182,100,114
"['1110100', '100', '001111', '10']",1,4,8,10,0,18,3.154273504273504,25,19
"['111', '1110100', '10', '011001', '001001']",1,5,11,13,2,24,5.619658119658119,34,28
"['00111', '10111', '11010', '01001']",1,4,8,12,4,20,3.6,17,17
"['0100110', '1', '111010', '1000', '1110']",1,5,10,12,2,22,5.151798201798202,33,25
"['1001', '010110', '1100011', '0011011', '011000']",1,5,15,15,4,30,6.48005328005328,33,21
"['101', '1001', '10100', '0100011', '111000', '110']",1,6,14,14,2,28,9.45961260961261,43,41
"['01101', '010', '110']",1,3,5,6,2,11,2.1666666666666665,5,8
"['0010', '10101', '1100110', '0101', '0000110']",1,5,15,12,4,27,6.565295815295815,29,28
"['0', '1111', '1000', '010110', '101001']",1,5,10,11,4,21,4.088095238095238,34,17
"['0101101', '100', '1010101', '111110', '1000011', '011111']",1,6,14,22,5,36,8.365934065934066,52,45
"['1000101', '0100110', '10']",1,3,9,7,2,16,1.6031746031746033,13,6
"['10110', '00', '110', '111']",1,4,5,8,2,13,2.888095238095238,13,14
"['01', '1', '101000', '10001', '001110']",1,5,11,9,2,20,4.748917748917749,35,21
"['100', '00101', '101001']",1,3,8,6,0,14,1.712121212121212,8,9
"['0', '11', '0010101', '011001']",1,4,8,8,0,16,1.9416971916971917,24,11
"['001', '1000101', '11', '1000010', '00', '100101', '1101']",1,7,17,14,4,31,12.038050838050838,65,68
"['00', '0100', '11']",1,3,5,3,2,8,1.0,7,6
"['010101', '10', '0100101']",1,3,8,7,0,15,1.5598290598290598,10,11
"['011111', '1000', '001', '111']",1,4,6,10,2,16,2.5015873015873016,19,17
"['101100', '01', '1011001', '10111', '0011', '1100011']",1,6,13,18,2,31,9.646398046398046,46,56
"['010', '000011', '00111', '1111', '00110', '1100111']",1,6,13,17,2,30,8.806654456654456,43,52
"['010001', '10', '111']",1,3,5,6,0,11,1.3444444444444446,10,6
"['0', '101100', '0010', '0011001', '0011110', '0111', '1010000']",1,7,20,16,5,36,11.022027972027972,75,65
"['001111', '0011', '1010100', '00', '1101', '1010010']",1,6,15,15,4,30,7.572405372405372,51,45
"['01011', '1000', '11101', '1111000']",1,4,9,12,2,21,3.216161616161616,20,19
"['01', '0001', '110001', '000000', '110']",1,5,14,7,2,21,4.891269841269841,32,29
"['10111', '00010', '00100', '100110']",1,4,12,9,3,21,3.781818181818182,14,14
"['01', '0110', '1101', '1111', '10011', '0110010', '011000']",1,7,14,18,3,32,12.673293373293372,58,56
"['1110111', '1001110', '0011', '1010', '1010000']",1,5,13,16,5,29,5.707792207792208,35,29
"['01', '00010', '1100']",1,3,7,4,0,11,1.349206349206349,9,7
"['0010', '000011', '11', '1010', '011001', '1011']",1,6,13,13,5,26,8.733333333333333,42,39
"['00', '01111', '01010']",1,3,6,6,2,12,1.457142857142857,9,9
"['010', '001000', '0101011', '1110101', '110011', '110111']",1,6,15,20,5,35,9.290354090354091,47,44
"['00', '1000', '01011', '01010']",1,4,10,6,2,16,3.7206349206349207,14,19
"['01', '011', '0000000', '0100']",1,4,12,4,0,16,2.8239538239538238,21,19
"['0', '111000', '1000101', '101101', '10101', '0011110', '10100', '11101', '011010']",1,9,22,26,8,48,20.848151848151847,112,97
"['1000000', '100', '1100', '010111']",1,4,12,8,0,20,3.1547341547341547,22,19
"['1', '10101', '0001', '10010', '1011']",1,5,9,10,4,19,5.433333333333334,25,31
"['00', '0011110', '010']",1,3,7,5,0,12,1.8444444444444446,10,15
"['1111010', '110', '1100']",1,3,5,9,0,14,2.1844155844155844,8,11
"['1100011', '0011011', '110']",1,3,7,10,2,17,1.7714285714285714,12,13
"['110000', '1000100', '001', '111', '101', '1010101', '1101011', '1000010', '01001', '0100011']",1,10,29,26,8,55,27.596736596736598,142,140
"['01', '010000', '00000', '01111', '10100', '1010', '1100', '01011']",1,8,21,15,6,36,15.08030303030303,76,85
"['0', '1110101', '0110']",1,3,5,7,0,12,1.1954545454545453,13,4
"['11', '00010', '110101']",1,3,6,7,0,13,1.331168831168831,11,6
"['00', '000010', '1010011', '0000110', '1101010']",1,5,18,11,3,29,5.690476190476191,36,33
"['100110', '01', '1']",1,3,4,5,0,9,1.4523809523809523,10,6
"['01', '010001', '1']",1,3,5,4,0,9,1.4523809523809523,10,8
"['11010', '001', '1', '10110', '1001101', '1001011']",1,6,12,16,4,28,8.157142857142857,51,44
"['100001', '101', '100', '1000000', '11111', '0110110']",1,6,16,15,4,31,7.806310356310356,56,43
"['011', '111', '101000', '100', '10100', '1010000']",1,6,15,12,3,27,8.704390054390053,43,56
"['01000', '010', '0110110', '11']",1,4,9,8,0,17,3.1468253968253967,20,17
"['10111', '1111001', '11']",1,3,3,11,0,14,1.5158730158730158,11,18
"['100', '100000', '1']",1,3,7,3,0,10,1.4523809523809523,10,9
"['0', '110000', '101101']",1,3,7,6,2,13,1.0714285714285714,14,4
"['1000', '001', '011']",1,3,6,4,2,10,1.5238095238095237,6,7
"['1011', '0101111', '011110']",1,3,5,12,0,17,2.0965034965034963,8,6
"['010', '0110', '101110', '000000']",1,4,12,7,2,19,3.5015873015873016,18,23
"['011011', '10010', '1']",1,3,5,7,0,12,1.1645021645021645,12,6
"['101', '00110', '10']",1,3,5,5,0,10,1.8714285714285714,7,6
"['1101', '000111', '111010']",1,3,6,10,2,16,1.9,11,10
"['1011', '01', '10010', '1111000']",1,4,8,10,0,18,3.1572871572871573,21,14
"['1', '1010', '100101', '01001', '01000']",1,5,12,9,2,21,5.54025974025974,30,23
"['1111101', '00001', '00111', '100010', '000']",1,5,14,12,2,26,5.284265734265734,34,28
"['0', '1010110', '01100']",1,3,7,6,0,13,1.25,13,8
"['00111', '1000100', '101', '0']",1,4,9,7,0,16,2.683333333333333,23,12
"['01', '0010', '0100010', '0011', '0001100', '0111', '000']",1,7,20,11,5,31,12.735642135642136,60,77
"['101', '1111', '011001', '1011', '011010']",1,5,8,15,4,23,6.495238095238095,24,28
"['101', '11111', '00101', '011001']",1,4,7,12,2,19,3.4075757575757573,16,18
"['00101', '11', '01111', '000101', '00110']",1,5,11,12,3,23,6.396103896103896,25,28
"['01010', '110111', '000']",1,3,7,7,0,14,1.5176767676767677,10,4
"['01001', '0001', '010010', '111']",1,4,10,8,0,18,3.828138528138528,14,16
"['0', '01111', '0101011', '10010', '110']",1,5,9,12,2,21,4.216666666666667,34,25
"['0', '0010', '10110', '01010', '11111']",1,5,9,11,3,20,4.222222222222222,30,24
"['110', '1', '010110']",1,3,4,6,0,10,1.4523809523809523,10,6
"['0', '0010111', '111100', '1100111', '01001']",1,5,11,15,2,26,4.6223776223776225,43,28
"['00100', '01', '011010', '0011100']",1,4,12,8,0,20,3.8457098457098455,19,25
"['1110111', '011100', '0101101', '011011', '00110', '0000']",1,6,16,19,4,35,9.132001332001332,47,41
"['011', '11', '010101', '111000', '01110']",1,5,9,13,2,22,6.187085137085137,30,27
"['0010', '110', '1']",1,3,4,4,0,8,1.4714285714285715,7,5
"['1001', '10110', '01110', '00011']",1,4,9,10,3,19,3.7777777777777777,16,13
"['01', '0001', '1100100', '110100']",1,4,11,8,0,19,3.4796425796425794,20,20
"['0011110', '10', '11']",1,3,4,7,2,11,1.3888888888888888,11,5
"['101', '01', '1100', '1001011']",1,4,7,9,0,16,3.2946608946608946,19,17
"['11001', '1000', '01100']",1,3,8,6,2,14,2.1333333333333333,6,5
"['1000011', '10100', '00010', '1000']",1,4,14,7,2,21,3.827272727272727,15,19
"['1000', '01001', '10011', '11']",1,4,8,8,2,16,3.6095238095238096,15,18
"['10', '011100', '101101']",1,3,6,8,2,14,1.6666666666666665,11,5
"['0010', '0011000', '0011010', '1101', '0100']",1,5,16,10,5,26,6.607142857142857,27,40
"['11110', '111100', '111', '0000', '0101']",1,5,9,13,2,22,4.863852813852814,29,32
"['1111010', '001', '111010']",1,3,6,10,0,16,1.7675213675213675,10,13
"['0001110', '101', '10000', '1100100', '00', '011111', '111000', '110']",1,8,20,19,6,39,14.81904206904207,102,82
"['1000001', '001', '1110100']",1,3,10,7,2,17,1.4285714285714286,13,9
"['1101', '1', '0010']",1,3,4,5,2,9,1.3,9,4
"['1011', '001001', '100111']",1,3,7,9,2,16,2.0666666666666664,8,10
"['0110110', '1100100', '010101', '10', '1011011', '1110']",1,6,14,19,3,33,9.014885114885114,51,37
"['01', '110001', '111011']",1,3,5,9,2,14,1.6666666666666665,10,11
"['111', '1011110', '1010', '00', '1110100', '011001', '1101', '011000']",1,8,17,22,6,39,16.725990675990676,87,72
"['011011', '101011', '111']",1,3,4,11,2,15,1.9444444444444444,8,15
"['001', '1', '00101', '1011101', '101001']",1,5,10,12,0,22,5.0003996003996,33,38
"['0', '10000', '111']",1,3,5,4,0,9,0.5833333333333333,11,4
"['010', '0100111', '1', '0101000', '1011']",1,5,11,11,2,22,5.015584415584415,38,23
"['01', '100100', '00', '011110', '110']",1,5,10,9,4,19,4.7444444444444445,31,27
"['01', '011', '00100', '10', '1011111']",1,5,8,11,2,19,5.165079365079365,33,21
"['110', '1', '01011', '011000']",1,4,7,8,0,15,2.831168831168831,20,12
"['010', '001', '0111010', '1111101', '011010', '00011', '0110111', '0010011', '0000', '000111']",1,10,27,28,8,55,25.639088689088688,146,152
"['010011', '110', '1']",1,3,4,6,0,10,1.2301587301587302,11,7
"['100101', '110', '0']",1,3,5,5,0,10,1.2301587301587302,10,4
"['00101', '1100000', '010010', '100010', '1100111', '01011']",1,6,20,16,6,36,9.714085914085913,44,41
"['101100', '001', '00000', '1101', '1111', '00010', '011010']",1,7,18,15,6,33,10.668253968253968,59,54
"['1000001', '001101', '001000', '1100011', '110']",1,5,17,12,4,29,5.7997557997558,34,25
"['01101', '11101', '01011']",1,3,5,10,3,15,2.0,6,11
"['11001', '111', '101101', '001010', '10', '0100']",1,6,12,14,2,26,8.79098124098124,43,32
"['000000', '0010101', '1111']",1,3,10,7,0,17,1.1608391608391608,13,6
"['01111', '110110', '000110', '001']",1,4,9,11,2,20,3.3686868686868685,18,17
"['0100001', '101', '0']",1,3,7,4,0,11,1.15,12,5
"['01', '00', '0110', '011']",1,4,6,5,2,11,3.8904761904761904,9,18
"['01000', '01', '0001110', '1111111']",1,4,9,12,2,21,2.333333333333333,28,13
"['01', '11011', '10111', '01111', '10100', '011001']",1,6,10,18,4,28,9.494805194805195,41,45
"['0001001', '1010110', '101011', '1011000', '01110']",1,5,16,16,3,32,6.246919746919747,29,31
"['011', '100', '100110', '00', '010110']",1,5,11,9,4,20,6.033333333333333,28,30
"['01', '010000', '011', '00001']",1,4,11,5,0,16,3.543145743145743,17,19
"['0110101', '0111011', '00011', '0110', '010111', '000', '1101']",1,7,16,20,4,36,12.836974136974137,60,63
"['00100', '001', '110101']",1,3,8,6,0,14,1.7398989898989898,8,8
"['1111100', '01', '0001101']",1,3,7,9,2,16,1.0952380952380951,15,8
"['111', '101101', '01111', '010010', '1000000', '1010', '0101', '110']",1,8,18,20,6,38,15.777788877788877,82,75
"['11011', '1', '1010100', '1000000', '0100']",1,5,14,10,2,24,4.379076479076479,39,24
"['11', '100', '0010100', '011101', '0000010', '00010', '1111011']",1,7,20,17,3,37,10.151925851925851,81,57
"['110010', '101110', '000']",1,3,8,7,2,15,1.6111111111111112,10,7
"['00', '0011101', '101001', '1001']",1,4,10,9,0,19,3.418104118104118,20,18
"['110000', '100101', '01010', '000100', '110']",1,5,16,10,3,26,5.888888888888888,28,24
"['110011', '10101', '1111011']",1,3,5,13,0,18,2.163170163170163,8,17
"['00111', '00110', '10101', '100']",1,4,9,9,3,18,3.75,15,16
"['0', '101', '101011', '0010010', '1110']",1,5,10,11,0,21,4.652830502830502,35,20
"['0', '101000', '10001', '0011', '1111']",1,5,10,10,2,20,4.157431457431457,33,22
"['000110', '00101', '10000', '00001']",1,4,15,6,3,21,4.181818181818182,14,23
"['01101', '00011', '00111', '1110101', '0111', '001100', '010011', '110101']",1,8,19,25,6,44,18.99222999222999,72,95
"['1101001', '100', '10011', '101101']",1,4,9,12,0,21,4.025990675990676,16,24
"['011', '111', '101', '00', '01001', '110', '01011']",1,7,10,14,6,24,12.142857142857142,44,55
"['1000', '110', '010111', '00011']",1,4,9,9,0,18,3.3098124098124098,19,17
"['1011001', '101101', '000101', '1111001', '0000']",1,5,15,15,4,30,5.8998001998002,28,38
"['110011', '01', '1', '0101001']",1,4,7,9,0,16,2.916056166056166,24,16
"['11001', '10001', '01101', '010100']",1,4,11,10,3,21,4.2,14,15
"['0010', '00011', '010010', '100010', '1000010', '11101', '1000011', '1010001', '101110']",1,9,30,23,8,53,23.57957597957598,98,118
"['1010', '0010100', '0100']",1,3,10,5,2,15,2.2045454545454546,8,12
"['0', '001', '011100']",1,3,6,4,0,10,1.2301587301587302,11,9
"['100', '11101', '100011', '110', '001011', '011000']",1,6,14,15,5,29,8.537878787878787,45,40
"['11011', '11', '1000', '10011', '0111']",1,5,7,13,4,20,5.637301587301587,25,42
"['001', '000011', '1101011', '0001100', '10100', '000', '110']",1,7,20,14,5,34,11.464124764124763,70,72
"['110110', '0111010', '0101101', '00', '10011']",1,5,12,15,2,27,6.24986124986125,33,21
"['10110', '0011010', '0000', '0111110', '1110']",1,5,13,14,4,27,5.994588744588745,29,38
"['0010001', '110000', '1', '0000100', '111110', '0111100']",1,6,19,15,5,34,6.90934065934066,62,41
"['001', '10', '0010101']",1,3,7,5,0,12,1.4444444444444444,11,9
"['0100001', '10010', '111', '00000']",1,4,13,7,2,20,2.6666666666666665,20,10
"['010', '00001', '11', '1100000', '10011', '1110']",1,6,14,12,2,26,7.318470418470418,49,41
"['00', '11101', '111010', '011000']",1,4,9,10,2,19,3.4069264069264067,18,16
"['11010', '010', '1001101', '0111101', '110']",1,5,10,15,4,25,6.614285714285714,30,28
"['100110', '00', '1111110']",1,3,6,9,0,15,1.3376068376068377,13,8
"['0101', '01110', '00001']",1,3,8,6,2,14,1.511111111111111,8,8
"['011101', '01001', '01101', '110001']",1,4,10,12,4,22,4.557575757575758,12,25
"['0010', '1101111', '11000', '0011', '100', '1010011']",1,6,14,16,4,30,8.816738816738816,50,48
"['0001', '0100110', '10']",1,3,8,5,0,13,1.505050505050505,11,7
"['0010010', '10', '011', '000']",1,4,10,5,2,15,2.7777777777777777,19,17
"['1', '0000100', '000']",1,3,9,2,0,11,0.85,13,10
"['010001', '011', '100010', '0111', '0011011']",1,5,13,13,2,26,6.205783105783106,31,28
"['0010', '111010', '1010101', '011010', '110']",1,5,12,14,2,26,6.314319014319015,26,30
"['110010', '1110010', '011', '111011', '110', '1110']",1,6,10,19,4,29,10.025929625929626,39,69
"['111101', '111100', '0100', '11']",1,4,6,12,2,18,3.1666666666666665,19,20
"['101011', '01', '10', '111']",1,4,4,9,2,13,2.7444444444444445,17,17
"['0001001', '1010', '101000']",1,3,11,6,0,17,1.9608391608391609,9,11
"['01010', '1', '01110', '0100']",1,4,8,7,2,15,3.422222222222222,15,17
"['0001', '100001', '111011']",1,3,8,8,2,16,1.7000000000000002,9,11
"['0010', '101', '01111', '00', '10011', '0111', '01110']",1,7,12,16,5,28,12.443650793650793,49,55
"['110110', '001', '1111111']",1,3,4,12,0,16,1.2598290598290598,13,8
"['00', '1100', '111']",1,3,4,5,0,9,1.2380952380952381,7,8
"['001', '1', '0110111']",1,3,4,7,0,11,1.15,12,6
"['0010', '111110', '0110001']",1,3,8,9,0,17,1.406993006993007,12,7
"['1011', '1001', '00101']",1,3,6,7,2,13,2.083333333333333,5,10
"['00', '010', '1110']",1,3,5,4,0,9,1.7047619047619047,6,9
"['100', '1', '010110', '000']",1,4,8,5,2,13,2.7857142857142856,17,12
"['01', '00100', '1000', '10100', '100111', '101111']",1,6,14,14,4,28,8.442857142857143,42,45
"['1000110', '0101', '001', '1']",1,4,8,7,0,15,2.866883116883117,20,13
"['01', '0010', '0011', '00', '111000', '01110']",1,6,13,10,4,23,8.870129870129869,41,49
"['0010', '11011', '110011', '00110', '1010', '001110', '10010', '1100011', '110']",1,9,21,24,7,45,24.67879342879343,88,125
"['01', '010000', '001000', '11', '1000010', '1011']",1,6,17,10,4,27,7.785625485625486,53,33
"['0100110', '010110', '0011100', '10']",1,4,12,10,2,22,3.7954822954822953,21,25
"['0011101', '001', '00001', '101011', '010010', '100000', '00010']",1,7,24,14,5,38,13.147863247863247,60,63
"['11011', '010001', '0001', '100', '0110']",1,5,12,10,2,22,5.866089466089466,27,23
"['010', '101010', '00', '1011', '1100']",1,5,10,9,2,19,6.0095238095238095,24,25
"['1011', '0001', '010', '010110']",1,4,9,8,2,17,3.5095238095238095,14,13
"['010001', '011', '1001010', '00011', '100010', '1111', '0000', '01001']",1,8,23,17,6,40,16.983172383172384,76,75
"['001', '1110010', '00100', '10110', '111111', '00110', '10010', '1100111', '1101', '01000']",1,10,24,28,7,52,27.166172716172717,131,128
"['11101', '1', '0110']",1,3,3,7,0,10,1.4,9,4
"['0010', '11', '101', '0111', '0101']",1,5,7,10,3,17,6.466666666666667,18,23
"['0101101', '10001', '0001000']",1,3,12,7,2,19,1.5714285714285714,10,5
"['0011', '011', '1001010']",1,3,7,7,0,14,2.1844155844155844,8,8
"['1000100', '0011110', '100', '1110101', '1101']",1,5,13,15,3,28,5.703896103896104,37,27
"['0', '101100', '1111111', '0111']",1,4,5,13,0,18,2.138861138861139,26,14
"['11110', '0111010', '101', '000', '0100001', '001100', '1101010']",1,7,20,18,5,38,11.554184704184705,72,54
"['0110', '1', '10000', '1101110']",1,4,8,9,0,17,2.655050505050505,23,12
"['0110000', '010011', '10']",1,3,9,6,0,15,1.4059829059829059,12,7
"['01', '10100', '010']",1,3,6,4,0,10,2.1214285714285714,6,7
"['0', '110010', '011011', '100100', '1111010']",1,5,12,14,3,26,5.107142857142858,38,25
"['0011', '010', '1101010']",1,3,7,7,0,14,1.7168831168831167,10,9
"['1100001', '10001', '011', '110101']",1,4,10,11,0,21,3.8965034965034966,17,27
"['00', '10001', '1', '000101']",1,4,9,5,0,14,2.4177489177489178,20,13
"['1000100', '0100000', '011', '1000110', '111111', '10', '0011111', '01001', '1010010']",1,9,26,25,5,51,19.141414141414142,138,101
"['111011', '0001101', '0001100', '00', '10011', '110', '0110001']",1,7,19,18,3,37,12.083866133866133,75,57
"['001', '011100', '1111', '010111', '0111110']",1,5,9,17,2,26,5.553157953157953,30,28
"['0101101', '001011', '000001']",1,3,11,8,2,19,1.576923076923077,8,8
"['1010100', '1001', '10']",1,3,7,6,0,13,1.6565656565656566,10,9
"['1100111', '10001', '1111011']",1,3,6,13,2,19,1.880952380952381,10,17
"['111', '111011', '1010', '001010', '0000', '110']",1,6,12,14,6,26,7.717460317460318,41,43
"['0', '0101110', '10000', '111011', '100101', '001100']",1,6,16,15,3,31,7.2435064935064934,58,30
"['010001', '00001', '00110', '00', '0101']",1,5,15,7,2,22,6.2751803751803745,27,34
"['011011', '10000', '0000101', '000', '110']",1,5,15,9,2,24,5.34013209013209,33,32
"['0', '01001', '000100', '01110', '011000']",1,5,15,8,4,23,5.065367965367965,34,39
"['111', '100', '0110', '10000', '100101', '000']",1,6,14,10,3,24,8.236002886002886,37,39
"['111000', '10010', '00101']",1,3,9,7,2,16,1.890909090909091,9,7
"['0', '00001', '101', '1001', '010110']",1,5,11,8,0,19,5.173160173160173,29,21
"['10101', '100', '100111']",1,3,6,8,0,14,2.143939393939394,7,12
"['010001', '001101', '00111', '10101', '10110', '1100110']",1,6,16,18,5,34,10.051282051282051,38,43
"['011101', '01', '111001']",1,3,5,9,2,14,1.8333333333333335,10,10
"['00', '001', '11']",1,3,4,3,2,7,1.2000000000000002,5,6
"['10111', '10', '0000']",1,3,6,5,0,11,1.126984126984127,10,5
"['1000', '010', '1100']",1,3,7,4,2,11,1.8928571428571428,5,7
"['1110011', '100', '1101']",1,3,5,9,0,14,1.8987012987012988,9,10
"['1011', '0001', '00']",1,3,6,4,2,10,1.5,7,6
"['0', '111110', '01110']",1,3,4,8,0,12,1.3463203463203464,11,11
"['100010', '1001', '00011']",1,3,9,6,0,15,2.193939393939394,6,8
"['011', '00111', '0011001', '1100001', '100011', '000', '01010', '0100']",1,8,23,17,6,40,17.437212787212786,84,76
"['010', '011', '1110', '0110', '0010100', '0111', '1111111', '011000']",1,8,16,22,7,38,16.78926073926074,83,97
"['111100', '100111', '0001000']",1,3,10,9,2,19,1.4230769230769231,12,8
"['11101', '1', '00000']",1,3,6,5,2,11,0.5333333333333333,13,4
"['101100', '00111', '1111', '0000010', '1100011', '1101', '001011']",1,7,18,21,6,39,11.874264624264624,67,72
"['0101011', '10', '0000']",1,3,8,5,0,13,1.323232323232323,12,6
"['11', '11000', '0110', '0000101', '01100']",1,5,13,10,2,23,5.988311688311688,31,27
"['1010', '000111', '011', '0000']",1,4,10,7,2,17,3.0238095238095237,17,17
"['0011000', '1111', '1011100', '10', '111001']",1,5,11,15,2,26,5.53021423021423,35,25
"['0010', '11', '10111', '1100100', '1001011']",1,5,11,14,2,25,5.573593073593074,34,31
['1001011'],1,1,3,4,0,7,0,0,0
"['0', '111110', '001001', '11']",1,4,6,9,2,15,1.9047619047619047,25,12
"['00', '1011001', '011', '1110']",1,4,7,9,0,16,3.0764790764790764,19,11
"['000100', '101', '010', '011001']",1,4,11,7,4,18,3.7777777777777777,18,12
"['00111', '110010', '0111', '1110']",1,4,7,12,2,19,4.0510101010101005,16,23
"['10101', '001001', '1', '011']",1,4,7,8,0,15,3.262987012987013,18,15
"['010', '00111', '0001101', '00', '1011100']",1,5,13,11,2,24,6.031746031746032,33,31
"['0010', '001101', '011011', '10', '000010']",1,5,14,10,3,24,6.366666666666667,29,31
"['10001', '10110', '11100', '101111', '0100']",1,5,11,14,3,25,6.218181818181818,27,27
['0010110'],1,1,4,3,0,7,0,0,0
"['0111001', '1101110', '011110', '0111', '110']",1,5,9,18,2,27,6.945387945387946,29,40
"['001', '000011', '00011', '011011', '0001100']",1,5,16,11,2,27,6.6336052836052835,26,42
"['01', '010011', '10101']",1,3,6,7,0,13,1.7987012987012987,10,8
"['011', '00011', '011111', '000100', '110']",1,5,11,12,4,23,5.5227272727272725,32,33
"['101', '10000', '0100']",1,3,8,4,0,12,1.7380952380952381,7,6
"['1101111', '000', '01010']",1,3,7,8,0,15,1.45,12,4
"['0101000', '0110', '0101010', '111110', '1011', '110']",1,6,14,17,4,31,8.845038295038295,43,48
"['01', '0101101', '1001', '000', '0011011']",1,5,12,11,2,23,5.493217893217893,33,24
"['0', '1011010', '0110', '011101', '011010']",1,5,11,13,2,24,6.074342324342324,32,40
"['00', '10010', '111101']",1,3,6,7,0,13,1.3668831168831168,11,4
"['1110001', '0111001', '1001']",1,3,8,10,2,18,2.311688311688312,8,15
"['01', '0011111', '11']",1,3,3,8,2,11,1.3888888888888888,11,8
"['01', '001', '100001', '10', '110111', '1110']",1,6,10,13,4,23,7.5968253968253965,46,41
"['100', '00101', '01010', '11']",1,4,8,7,2,15,3.592857142857143,15,11
"['0011', '01101', '011', '111010']",1,4,7,11,0,18,3.8455266955266953,15,18
"['11001', '110010', '1100010', '1111001', '010110']",1,5,14,17,4,31,7.104728604728605,24,40
"['0', '111101', '01101', '0101001']",1,4,8,11,0,19,2.7245254745254743,22,16
"['0100010', '110', '1000001']",1,3,11,6,2,17,1.5142857142857142,12,5
"['111111', '011', '1110']",1,3,2,11,0,13,1.615873015873016,9,13
"['101100', '11010', '011100', '10101', '100', '00', '01001']",1,7,17,15,5,32,14.312770562770563,56,59
"['0', '01', '0110', '001111']",1,4,6,7,0,13,3.119047619047619,18,15
"['010011', '100111', '01011', '11111']",1,4,7,15,4,22,3.778787878787879,13,28
"['00', '0101000', '11']",1,3,7,4,2,11,0.8888888888888888,12,6
"['1001', '10', '0100']",1,3,6,4,2,10,2.083333333333333,6,5
"['0', '001100', '011001', '00001']",1,4,12,6,2,18,3.0108225108225106,21,18
"['001', '101010', '1100101', '01010', '000']",1,5,14,10,2,24,6.572766122766122,26,25
"['0001100', '1000', '110', '1']",1,4,9,6,0,15,2.866883116883117,21,13
"['100110', '11011', '00011']",1,3,7,9,2,16,2.0545454545454547,6,9
"['0110', '00101', '11']",1,3,5,6,0,11,1.9047619047619047,7,4
"['101', '01101', '1100', '11']",1,4,5,9,0,14,4.026190476190476,12,18
"['11', '01', '0000']",1,3,5,3,2,8,0.8333333333333333,8,4
"['0', '01101', '100001', '1001', '0110', '0000001']",1,6,17,10,2,27,7.077672327672328,51,42
"['111100', '1000', '10', '1100011', '1001001']",1,5,13,13,2,26,5.901309801309801,35,29
"['1010', '111000', '1', '1110']",1,4,6,9,2,15,2.9857142857142858,17,16
"['011', '1100000', '10', '0001010', '0001000']",1,5,18,8,3,26,5.276190476190476,40,36
"['0000', '1001', '111011']",1,3,7,7,2,14,1.3,10,4
"['11000', '1', '010110', '0001000']",1,4,12,7,0,19,2.6965534465534464,24,15
"['1101001', '00', '11111', '01100', '1011111']",1,5,9,17,4,26,4.876190476190476,38,29
"['0', '0001110', '001111', '110001', '10110']",1,5,12,13,2,25,4.796953046953047,42,22
"['100111', '10', '010111']",1,3,5,9,2,14,1.8333333333333335,10,10
"['1010', '1', '110111', '10011']",1,4,5,11,0,16,3.012987012987013,19,21
"['111', '000011', '0000', '1101', '001001', '1110']",1,6,14,13,5,27,7.91984126984127,44,49
"['0', '101', '11110', '11010']",1,4,5,9,2,14,3.0166666666666666,16,12
"['010', '1110000', '101', '1110101', '011101']",1,5,11,15,4,26,6.0989010989010985,34,28
"['0000101', '1010', '111010']",1,3,9,8,0,17,1.806993006993007,10,9
"['101011', '001100', '01', '000']",1,4,10,7,2,17,3.1777777777777776,21,14
"['11', '101000', '10000', '0011111', '1011011']",1,5,12,15,2,27,4.872571872571872,39,35
"['0011', '110', '01100']",1,3,6,6,0,12,1.9880952380952381,8,8
"['11000', '111', '0000']",1,3,7,5,0,12,1.1666666666666665,9,10
"['1100001', '01', '011100', '00001']",1,4,12,8,0,20,3.328227328227328,22,18
"['01010', '1110100', '101111', '11']",1,4,7,13,0,20,3.343378843378843,22,16
"['11111', '100', '010110', '0011111', '0111']",1,5,8,17,0,25,5.408674658674658,31,34
"['001', '101', '1111', '0000', '110']",1,5,8,9,5,17,4.238095238095238,25,23
"['011', '1000010', '1000000', '10', '0110010']",1,5,17,9,3,26,5.076190476190476,40,33
"['1110010', '111100', '010001', '00111', '1001', '0101']",1,6,15,17,4,32,9.431585081585082,47,43
"['101', '001110', '0001010', '000100', '110']",1,5,15,10,4,25,6.0256410256410255,30,32
"['010100', '00', '10101', '11']",1,4,8,7,2,15,2.87012987012987,18,10
"['1000100', '0101101', '101', '00100', '100', '110111']",1,6,16,15,4,31,9.093611943611943,48,44
"['11101', '10', '0010011']",1,3,6,8,0,14,1.349206349206349,12,7
"['01', '11110', '010000', '10']",1,4,8,7,2,15,2.720779220779221,21,14
"['101', '00', '011100', '1111']",1,4,6,9,0,15,2.515873015873016,19,10
"['110000', '0010111', '11', '1100', '101110']",1,5,11,14,2,25,5.451670551670552,37,34
"['0110010', '10010', '101110', '111']",1,4,9,12,0,21,4.096503496503496,17,17
"['1110111', '011100', '1010100', '10000', '0101010', '01100', '111001']",1,7,21,22,7,43,13.827272727272728,58,58
"['11', '1000110', '0000']",1,3,8,5,0,13,1.1717171717171717,12,4
"['001100', '10001', '1111001']",1,3,9,9,0,18,1.8275058275058274,10,6
"['101110', '11000', '011010', '10000']",1,4,12,10,4,22,3.83030303030303,14,16
"['0010', '100010', '111', '111001']",1,4,9,10,2,19,3.4634920634920636,19,17
"['001', '000000', '11']",1,3,8,3,0,11,0.8444444444444444,12,6
"['101', '0001100', '00', '10', '0000110']",1,5,14,7,4,21,5.134920634920634,36,31
"['010', '00', '10', '01011', '101111']",1,5,8,10,2,18,5.914574314574315,26,23
"['110000', '0001', '0111110', '0001011']",1,4,13,11,2,24,3.1964035964035964,24,20
"['01', '1', '01000', '1011001']",1,4,8,7,0,15,2.9325396825396823,22,12
"['101011', '11000', '110100', '10', '0111', '01110']",1,6,12,16,4,28,8.821645021645022,44,41
"['0111010', '011', '0100010', '00111', '100', '0111']",1,6,14,15,4,29,8.883044733044732,46,50
"['000100', '10', '101001']",1,3,9,5,2,14,1.6666666666666665,11,5
"['100', '001111', '10', '11']",1,4,5,8,2,13,2.8944444444444444,18,16
"['10101', '0110010', '0000100', '101110']",1,4,14,11,2,25,3.838994338994339,20,13
"['11000', '0001', '1001', '1100']",1,4,10,7,3,17,4.222222222222222,12,21
"['01', '11011', '1001', '1000111', '111101']",1,5,8,16,0,24,6.031956931956932,31,43
"['11011', '0010111', '00000', '11111']",1,4,9,13,3,22,2.6666666666666665,20,22
"['01', '1000', '10000', '11']",1,4,8,5,2,13,2.626984126984127,16,17
"['101100', '0110', '0111110']",1,3,7,10,0,17,2.1426573426573428,8,12
"['010', '11', '11000', '1100100', '1110']",1,5,10,11,0,21,5.799422799422799,28,31
"['0100110', '1001', '10', '0111', '1011']",1,5,9,12,3,21,6.111111111111111,27,24
"['001', '01100', '00000']",1,3,10,3,2,13,1.4,8,13
"['1001', '0011100', '0100', '11']",1,4,9,8,2,17,3.467171717171717,20,11
"['1100', '110', '100011', '011']",1,4,7,9,2,16,3.806349206349206,16,20
"['110110', '1', '00101', '10000', '1010111', '1110001', '010011']",1,7,17,20,6,37,10.899533799533799,77,58
"['1110001', '10110', '1', '1110']",1,4,6,11,0,17,3.2661616161616163,21,19
"['001', '1001000', '0100', '1011111']",1,4,11,10,2,21,3.090909090909091,23,14
"['1111000', '1010', '1000', '0100001', '1101', '01110']",1,6,16,15,5,31,8.748196248196248,46,36
"['0110', '0011100', '11']",1,3,6,7,0,13,1.8383838383838382,10,4
"['101011', '11011', '000011', '11111']",1,4,7,15,4,22,3.6484848484848484,13,35
"['1001110', '1111011', '100010']",1,3,8,12,2,20,1.9450549450549453,10,9
"['00111', '00', '0101', '01100']",1,4,9,7,2,16,3.742857142857143,15,20
"['11010', '11100', '11']",1,3,4,8,2,12,1.9428571428571428,8,11
"['01', '01010', '11']",1,3,4,5,2,9,1.6428571428571428,7,5
"['0111010', '1001', '0110', '00', '1010', '000001', '01001']",1,7,19,13,3,32,12.491242091242091,61,61
"['101100', '111', '100', '00', '110111']",1,5,8,12,4,20,4.772222222222222,31,31
"['0001', '010', '11100', '11111']",1,4,7,10,2,17,2.588095238095238,19,15
"['01', '010', '00']",1,3,5,2,2,7,2.1,3,9
"['1100', '1110', '0010011']",1,3,7,8,2,15,1.6590909090909092,10,10
"['01101', '11', '01111', '100111', '0000']",1,5,9,13,2,22,4.9640692640692645,31,26
"['1110000', '1010', '10011', '11111', '0101', '101111']",1,6,11,20,4,31,8.397397047397048,46,56
"['1111100', '0001001', '0', '10111', '1111110', '0111101']",1,6,12,22,4,34,7.071428571428571,61,38
"['10100', '00', '10110', '110100']",1,4,10,8,2,18,4.079220779220779,14,22
"['1011', '0111010', '110']",1,3,5,9,0,14,1.7168831168831167,10,6
"['0001100', '01001', '101']",1,3,9,6,0,15,1.5666666666666667,11,5
"['11110', '0010', '001', '00000', '11100']",1,5,13,9,3,22,5.0626984126984125,28,35
"['01', '00101', '001000', '1011101', '1010', '1000', '1011011']",1,7,18,17,4,35,12.496597846597846,65,63
"['0100110', '00001', '10001', '11111', '1001111', '101001', '011000']",1,7,20,21,7,41,12.378854478854478,63,60
"['110001', '10110', '00', '011001', '011111', '010011']",1,6,14,17,4,31,8.866883116883116,47,37
"['0001110', '10011', '1', '0000']",1,4,10,7,0,17,2.4217171717171717,23,12
"['010100', '0', '001', '1001101', '001100', '01011']",1,6,16,12,2,28,8.205033855033856,51,41
"['00010', '000111', '10']",1,3,8,5,0,13,1.5487012987012987,10,10
"['0111000', '0', '00001', '1101000', '0111111']",1,5,14,13,3,27,4.273809523809524,45,33
"['111', '10001', '100', '11100', '1001100', '0000110', '001011']",1,7,19,17,6,36,11.893034743034743,68,67
"['101', '0010', '01011', '11']",1,4,6,8,0,14,3.6928571428571426,13,12
"['010111', '10', '0100']",1,3,6,6,0,12,1.7666666666666666,9,8
"['11001', '110001', '1', '011100']",1,4,8,10,2,18,3.207792207792208,21,17
"['1011011', '001', '011', '000011']",1,4,9,10,2,19,3.4615384615384617,18,19
"['00', '0110', '011001']",1,3,7,5,0,12,1.9666666666666668,8,11
"['000110', '001111', '0011000', '011101', '101111']",1,5,14,17,4,31,6.794871794871795,26,30
"['11110', '0000001', '111', '1101']",1,4,8,11,0,19,3.004112554112554,22,22
"['010', '00011', '1001101', '000000', '111101']",1,5,15,12,2,27,4.962082362082362,36,24
"['0', '1011', '0010010', '1010110']",1,4,10,9,2,19,2.8870129870129873,24,13
"['01', '10011', '01010']",1,3,6,6,2,12,1.7428571428571429,9,5
"['1101', '010', '1000']",1,3,6,5,2,11,1.6428571428571428,6,4
['1000011'],1,1,4,3,0,7,0,0,0
"['11110', '010', '100010', '10', '010110', '11111', '11100']",1,7,13,19,5,32,11.602813852813853,60,67
"['0', '01001', '011', '00001']",1,4,9,5,2,14,3.216666666666667,16,15
"['0110101', '101', '11']",1,3,4,8,0,12,1.8444444444444446,10,10
"['01', '1100010', '001010', '10', '000010', '1011']",1,6,16,11,4,27,8.137140637140638,49,42
"['1100111', '00110', '100010']",1,3,9,9,0,18,2.0093240093240095,8,5
"['110110', '0101010', '00', '10110']",1,4,10,10,0,20,4.027528027528027,17,20
"['0', '1110000', '001101', '0100']",1,4,11,7,0,18,2.342707292707293,26,17
"['001', '11', '10111', '1101000', '1011', '0100101']",1,6,12,16,2,28,8.292496392496393,50,50
"['0011', '111010', '0110011']",1,3,7,10,0,17,1.7426573426573428,10,11
"['0001110', '1100100', '000000']",1,3,14,6,2,20,1.8021978021978022,10,15
"['1000011', '10110', '01110', '0000']",1,4,12,9,2,21,3.5828282828282827,20,13
"['11011', '000', '1001']",1,3,6,6,0,12,1.4880952380952381,8,4
"['1001', '010111', '0000']",1,3,8,6,2,14,1.5,9,4
"['01000', '011', '011100']",1,3,8,6,0,14,1.893939393939394,8,13
"['001', '1000101', '011', '000001', '10', '1100']",1,6,15,10,2,25,7.842585192585192,48,39
"['00111', '101011', '10001', '100011', '01010', '0111', '1101010']",1,7,17,21,5,38,14.127039627039627,51,66
"['11000', '0011', '010110', '0000']",1,4,12,7,2,19,3.5565656565656565,16,22
"['01', '10000', '11']",1,3,5,4,2,9,1.0714285714285714,9,6
"['0001', '111101', '1', '0010101']",1,4,8,10,0,18,2.342707292707293,24,19
"['0010111', '011', '00111', '110001', '111011', '1000', '000010', '0101', '11100']",1,9,22,24,7,46,20.890215340215338,112,113
"['0', '0011', '1001']",1,3,5,4,2,9,1.55,8,4
"['11011', '111', '00011', '0000', '0100101']",1,5,12,12,2,24,5.384343434343434,29,31
"['01', '101011', '1111001', '1100100', '00']",1,5,11,13,4,24,5.222832722832723,39,24
"['1100011', '101', '01']",1,3,5,7,0,12,1.8444444444444446,10,9
"['10101', '0010', '001', '01111']",1,4,8,9,2,17,3.568253968253968,14,13
"['0110001', '0101011', '0110100', '000']",1,4,14,10,3,24,3.6,20,21
"['11001', '00000', '1001', '00110', '100111']",1,5,14,11,3,25,6.218181818181818,27,25
"['01', '00', '011']",1,3,4,3,2,7,1.7000000000000002,4,7
"['1101111', '000', '01110']",1,3,6,9,0,15,1.3666666666666667,12,4
"['01', '0110', '00000']",1,3,8,3,0,11,1.3968253968253967,9,9
"['1110111', '0', '1111', '1110110', '11100']",1,5,6,18,2,24,5.311688311688312,34,49
"['100110', '100101', '0110110']",1,3,9,10,2,19,2.0641025641025643,8,10
"['0011', '010', '100001', '11']",1,4,8,7,0,15,3.1825396825396823,17,12
"['101000', '011', '011110']",1,3,7,8,2,15,1.4444444444444444,11,8
"['101', '100', '110']",1,3,4,5,3,9,2.0,4,7
"['111', '10011', '1101010']",1,3,5,10,0,15,1.7666666666666666,9,13
"['001', '100001', '010001', '011', '1111', '1010010']",1,6,15,14,4,29,8.731657231657232,46,43
"['1', '011', '000']",1,3,4,3,2,7,0.8333333333333333,7,4
"['01', '0101000', '01111']",1,3,7,7,0,14,1.5158730158730158,12,9
"['0', '10111', '101100', '11']",1,4,5,9,0,14,2.4177489177489178,20,15
"['00101', '11', '10110', '0010101', '1010', '010101', '000']",1,7,17,15,2,32,13.402514152514152,55,62
"['00', '001001', '1100']",1,3,8,4,0,12,1.7666666666666666,9,11
"['1101001', '01', '0100111', '00001', '110001', '010111', '11111']",1,7,16,22,6,38,11.91905871905872,66,83
"['1000010', '001', '1001000']",1,3,12,5,2,17,1.7714285714285714,10,9
"['1', '00011', '00001', '101000', '10101', '0001100']",1,6,18,11,3,29,7.76928071928072,50,49
"['000110', '1000101', '010110']",1,3,11,8,2,19,2.217948717948718,8,7
"['001', '00101', '11', '101', '100100', '110100', '1000', '10011', '110111']",1,9,19,21,7,40,22.29278499278499,93,126
"['111', '00000', '101', '110111', '1100011', '1001001', '001001']",1,7,18,19,6,37,11.974231324231324,70,77
"['0', '001101', '101101', '100110', '111111']",1,5,9,16,4,25,4.690476190476191,34,23
"['11000', '0001', '00000']",1,3,11,3,2,14,1.9333333333333331,7,16
"['0001', '010101', '1']",1,3,6,5,0,11,1.0857142857142859,10,7
"['1000', '10010', '10011', '1110']",1,4,9,9,4,18,3.7444444444444445,11,21
"['0111001', '0101110', '111', '01111', '0101', '01000']",1,6,13,18,4,31,9.506926406926407,42,49
"['010', '001', '10111', '10101', '01000']",1,5,11,10,5,21,5.966666666666667,25,22
"['010100', '10000', '000', '1100111', '1110']",1,5,14,11,0,25,4.9308968808968805,33,28
"['11010', '100001', '1', '1000', '11101']",1,5,10,11,2,21,5.154401154401154,31,31
"['011011', '10101', '00001']",1,3,8,8,2,16,1.490909090909091,8,7
"['101100', '110', '11111']",1,3,4,10,0,14,1.5303030303030303,9,8
"['101100', '011', '000']",1,3,7,5,2,12,1.4444444444444444,8,8
"['1011010', '11010', '101', '1101000', '11100', '01011']",1,6,14,18,5,32,10.047619047619047,41,46
"['101000', '0101', '110100', '0100']",1,4,12,8,4,20,4.383333333333334,13,19
"['110001', '111', '000010']",1,3,8,7,2,15,1.5555555555555554,11,6
"['010', '001', '0110110', '000', '01100', '1110']",1,6,14,11,3,25,8.538311688311689,38,56
"['0011', '10', '010110', '000010', '110']",1,5,12,9,2,21,5.715873015873016,29,31
"['0011110', '10', '011']",1,3,5,7,0,12,1.4444444444444444,11,7
"['010100', '0010', '00', '011']",1,4,10,5,0,15,3.4047619047619047,15,24
"['0010001', '0', '11']",1,3,6,4,0,10,0.6944444444444444,13,4
"['01', '11', '100', '0110', '0001000']",1,5,11,7,2,18,5.0168831168831165,30,21
"['0010', '1', '100010']",1,3,7,4,0,11,1.4857142857142858,10,7
"['0', '000111', '1001110', '10']",1,4,8,8,0,16,2.666056166056166,24,14
"['11000', '0110010', '10', '011100']",1,4,11,9,0,20,3.8457098457098455,18,18
"['1000101', '011100', '00000', '00111', '1001', '01110']",1,6,18,14,3,32,8.61103341103341,46,38
"['011', '10001', '1111110', '00', '01001']",1,5,10,12,2,22,4.881746031746031,36,22
"['000011', '101', '11101', '010111', '010101', '0111', '00010', '0100']",1,8,19,20,7,39,16.565584415584414,72,82
"['10', '000', '0100001', '110', '01110']",1,5,12,8,2,20,5.299206349206349,31,27
"['0010', '0100111', '1001', '10', '0111']",1,5,10,11,3,21,5.861111111111111,29,24
"['001111', '001000', '00', '1100011', '110']",1,5,13,11,2,24,5.064102564102564,38,33
"['010', '001', '10111', '010101', '01011', '0100']",1,6,13,13,4,26,9.803823953823954,33,44
"['0101111', '111100', '00011', '010111', '0011111', '1011']",1,6,12,23,4,35,9.843856143856144,44,63
"['11110', '010101', '11']",1,3,4,9,0,13,1.435064935064935,10,8
"['0110000', '0110111', '1111']",1,3,7,11,2,18,1.4805194805194803,11,11
"['10100', '011', '111001']",1,3,6,8,0,14,1.6717171717171717,9,7
"['0', '111011', '1000', '010101', '1010000', '0010010']",1,6,18,13,4,31,7.6146187146187145,57,33
"['110010', '111000', '1', '11010', '1101', '000100']",1,6,14,14,3,28,8.461183261183262,47,43
"['110010', '11011', '00011', '100', '10011', '000', '1110']",1,7,15,16,5,31,12.462698412698412,51,69
"['010', '10010', '000', '1']",1,4,8,4,2,12,3.0,14,12
"['0010010', '100', '001110', '10']",1,4,11,7,0,18,3.558119658119658,20,22
"['1000', '110111', '011000']",1,3,8,8,2,16,1.7000000000000002,10,7
"['00', '110001', '1110']",1,3,6,6,0,12,1.4333333333333333,10,5
"['010', '10101', '0001', '01111', '011110', '0111']",1,6,11,16,4,27,9.076695526695527,36,45
"['000110', '011', '11', '010010', '000001']",1,5,14,9,3,23,5.9944444444444445,32,24
"['00', '1001', '0101011', '110']",1,4,8,8,0,16,3.2098124098124097,18,11
"['1111101', '0011110', '100111', '000', '0101']",1,5,11,16,2,27,5.451837051837051,36,22
"['001', '1111', '00', '110101', '01100', '1011111']",1,6,10,17,0,27,7.538184038184038,50,41
"['01', '000101', '01000']",1,3,9,4,0,13,1.6168831168831168,10,10
"['001110', '01110', '00000']",1,3,10,6,2,16,1.8545454545454545,7,18
"['1000001', '00', '0001']",1,3,10,3,0,13,1.8383838383838382,10,9
"['1011', '110', '11']",1,3,2,7,0,9,2.038095238095238,5,13
"['01', '100000', '0100', '00000']",1,4,14,3,0,17,3.155916305916306,17,26
"['1101001', '01111', '10011', '0100']",1,4,9,12,2,21,3.771717171717172,19,14
"['01', '11100', '11']",1,3,3,6,2,9,1.3571428571428572,8,8
"['0101111', '101', '0011', '1010', '010110']",1,5,10,14,2,24,6.837196137196138,25,26
"['0', '0010', '10011', '1011', '0101']",1,5,9,9,3,18,5.7555555555555555,25,19
"['01', '0011', '0010100', '00', '0110010', '0111100']",1,6,17,12,5,29,8.318181818181818,54,61
"['0110101', '101000', '1001', '000']",1,4,12,8,0,20,3.417116217116217,19,16
"['110000', '11011', '011', '0011', '1001', '010111', '000111']",1,7,15,19,5,34,13.324531024531025,57,75
"['0001100', '1', '01100']",1,3,8,5,0,13,1.4166666666666667,12,9
"['0', '0011', '01']",1,3,4,3,0,7,1.7333333333333334,6,6
"['0010', '001', '1', '0101101', '01010']",1,5,11,9,0,20,5.2859307359307355,28,26
"['0010', '0111011', '0011001', '0001', '000', '0100']",1,6,18,11,5,29,9.454545454545455,41,56
"['0011', '110', '10011']",1,3,5,7,0,12,1.9603174603174602,7,11
"['110110', '0110', '0011100']",1,3,8,9,0,17,2.1426573426573428,9,11
"['11010', '111', '10010', '10011', '1011']",1,5,8,14,3,22,6.5436507936507935,17,43
"['100', '0110', '1']",1,3,4,4,0,8,1.4714285714285715,7,4
"['110000', '10', '0111', '1100111', '1100']",1,5,10,13,2,23,5.714374514374515,33,38
"['1110001', '00', '110', '0010011']",1,4,10,9,2,19,2.8603174603174604,24,15
"['111011', '1000101', '0', '00001']",1,4,10,9,0,19,2.5147352647352648,24,11
"['11001', '101100', '011100', '000', '1100110', '111000']",1,6,17,16,3,33,10.324553224553224,42,47
"['0111101', '0101011', '110101']",1,3,7,13,2,20,1.8131868131868132,7,10
"['0010110', '111100', '0000100', '11', '010010', '0001111', '1101', '0110110']",1,8,23,23,6,46,15.942002442002442,99,83
"['101', '110110', '11']",1,3,3,8,0,11,1.9666666666666668,8,10
"['1011', '00', '010000', '101000']",1,4,12,6,2,18,3.1666666666666665,20,18
"['11010', '11011', '1111']",1,3,3,11,2,14,2.3555555555555556,4,18
"['1000001', '0111000', '10001', '0011110', '101001', '011000']",1,6,22,16,5,38,9.681651681651681,47,44
"['110110', '1', '011001', '000111', '1110']",1,5,9,14,3,23,4.89047619047619,37,26
"['010001', '1110101', '000000', '000010', '1101', '01110']",1,6,20,14,3,34,8.066433566433567,48,39
"['01', '0001110', '0011001', '1111110', '10100', '00', '0111110', '01100']",1,8,20,22,8,42,14.887301587301586,102,99
"['10101', '100', '01000']",1,3,8,5,2,13,2.1,7,6
"['101', '0101', '1']",1,3,3,5,0,8,1.7571428571428571,6,10
"['0001101', '00', '010001', '10011']",1,4,12,8,0,20,3.5251970251970253,20,13
"['11101', '1', '10011']",1,3,3,8,2,11,1.0666666666666667,11,13
"['101010', '1111', '000011', '0']",1,4,8,9,2,17,2.071428571428571,24,12
"['110100', '00', '1', '011110']",1,4,7,8,2,15,2.071428571428571,23,12
"['0111000', '1011', '010000', '001']",1,4,12,8,0,20,3.1305583305583307,22,15
"['011', '0101011', '0110']",1,3,6,8,0,14,2.0025974025974023,8,12
"['011', '0011', '01111', '1000', '100000', '10']",1,6,13,11,2,24,7.071500721500722,46,45
"['1000', '00', '001001']",1,3,9,3,0,12,1.7666666666666666,9,11
"['1101101', '001', '010', '1']",1,4,6,8,2,14,2.716666666666667,20,11
"['011111', '111010', '01111', '1100100']",1,4,8,16,2,24,3.7132867132867133,19,26
"['00', '0010100', '0110110', '1011100']",1,4,13,10,3,23,3.4761904761904763,22,27
"['0101101', '00110', '1010010', '010010']",1,4,14,11,2,25,4.6338661338661336,13,23
"['1011010', '1100', '100001', '1100110']",1,4,12,12,2,24,3.9996003996004,18,17
"['0101', '001101', '11']",1,3,5,7,0,12,1.9666666666666668,8,8
"['0010', '111010', '011100', '0001', '0001101', '111111', '1010']",1,7,17,20,6,37,11.692307692307693,67,60
"['0', '001', '011000']",1,3,7,3,0,10,1.2301587301587302,11,9
"['0110010', '1001000', '1001111']",1,3,11,10,3,21,1.8571428571428572,11,7
"['111', '011011', '10', '110', '111001']",1,5,6,14,4,20,6.2,26,34
"['0010', '0011', '111111', '0010010', '110', '101110']",1,6,13,17,4,30,8.08159063159063,48,49
"['0', '00100', '1110011', '111000']",1,4,10,9,0,19,2.6837329337329336,24,17
['1111100'],1,1,2,5,0,7,0,0,0
"['010', '0010111', '001111', '000']",1,4,10,9,2,19,3.5247863247863247,18,22
"['1011010', '0010', '00101', '1000110', '10', '0111110', '1110']",1,7,17,19,5,36,12.919913419913419,68,70
"['1101', '11101', '01001']",1,3,5,9,2,14,2.1555555555555554,5,14
"['101', '00', '10001', '1101']",1,4,7,7,0,14,3.5785714285714283,13,17
"['0000101', '1000', '0000110', '011']",1,4,14,7,2,21,3.4337662337662334,21,20
"['100001', '1000110', '00', '1011', '1101']",1,5,12,11,2,23,5.603069153069153,32,27
"['110000', '11101', '10', '0000']",1,4,10,7,0,17,2.972438672438672,19,17
"['101', '0001', '100', '110001', '010110', '010011', '101001']",1,7,18,16,6,34,14.276190476190475,53,60
"['010100', '001100', '000011', '00000']",1,4,17,6,3,23,3.8181818181818183,16,36
"['000', '0110', '0011111', '111101']",1,4,8,12,0,20,3.1083361083361085,22,15
"['000111', '0011010', '00001']",1,3,11,7,0,18,1.9965034965034967,8,10
"['101', '00010', '100001', '000']",1,4,12,5,2,17,3.643939393939394,16,14
"['1001110', '00010', '10011', '011001']",1,4,12,11,2,23,4.16993006993007,17,15
"['0', '000101', '1111000']",1,3,8,6,0,14,0.9972527472527473,16,8
"['100001', '0011000', '0011110', '1010', '00', '101110']",1,6,18,14,4,32,8.722288822288823,53,49
"['1010', '1101111', '1', '000']",1,4,6,9,0,15,1.966883116883117,24,10
"['11011', '00', '001', '1100110']",1,4,8,9,0,17,3.4634920634920636,19,15
"['0100000', '101', '0000000', '1000', '1011100', '0101']",1,6,22,10,5,32,7.972727272727273,53,54
"['1011', '0101', '000']",1,3,6,5,2,11,1.6071428571428572,7,4
"['110100', '01110', '0100']",1,3,8,7,0,15,2.012121212121212,7,12
"['0', '1011101', '011']",1,3,4,7,0,11,1.35,12,4
"['000110', '101', '00011']",1,3,8,6,0,14,1.8535353535353534,8,8
"['01', '1001', '1111001', '1001100', '01001']",1,5,12,13,2,25,6.518037518037518,32,38
"['110111', '10', '11']",1,3,2,8,2,10,1.5,9,12
"['0', '0011', '1101', '0111011']",1,4,6,10,2,16,2.8227272727272728,21,14
"['00110', '110111', '1010011']",1,3,7,11,0,18,1.9813519813519813,9,6
"['00001', '101', '1', '0100']",1,4,8,5,0,13,2.749206349206349,16,12
"['1', '011', '10000', '110011', '1001100', '0101']",1,6,13,13,0,26,7.8807747807747806,50,39
"['01', '000011', '1111', '011101', '110011', '0111110']",1,6,11,20,3,31,8.364024864024865,50,44
"['0', '0001', '0111001']",1,3,7,5,0,12,1.3772727272727274,12,8
"['0011', '11101', '111100']",1,3,5,10,0,15,1.5717171717171716,9,11
"['110000', '001101', '11']",1,3,7,7,2,14,1.5,13,9
"['001', '10111', '0001', '1000110', '010010', '0101', '101111']",1,7,17,18,4,35,13.129348429348429,57,56
"['010100', '101', '0010', '0000']",1,4,12,5,2,17,3.2738095238095237,13,17
"['0011', '010', '1101101', '1101']",1,4,7,11,2,18,3.5155844155844154,18,18
"['00', '110', '01000', '11']",1,4,7,5,2,12,2.557142857142857,15,14
"['011111', '0110', '0110011']",1,3,6,11,0,17,2.0965034965034963,8,14
"['101011', '00', '010000', '110010']",1,4,12,8,3,20,3.1666666666666665,21,13
"['0', '001', '11']",1,3,3,3,0,6,0.9,6,4
"['1010', '0001', '0111', '01000']",1,4,10,7,3,17,3.2777777777777777,15,15
"['11110', '0000001', '0001100', '00', '1101']",1,5,15,10,2,25,4.321789321789321,41,29
"['0001111', '01', '0110', '1111']",1,4,6,11,2,17,3.217171717171717,19,17
"['10001', '1011001', '110010']",1,3,9,9,0,18,2.163170163170163,7,11
"['11111', '000101', '10000', '0000']",1,4,12,8,2,20,2.9797979797979797,19,22
"['00111', '00100', '011011', '00', '10', '110']",1,6,12,11,4,23,8.239393939393938,41,45
"['11011', '010', '11', '0111', '11100']",1,5,6,13,2,19,5.714285714285714,26,33
"['1111100', '0011', '00', '01']",1,4,7,8,2,15,2.8636363636363633,21,18
"['0', '00100', '01110']",1,3,7,4,2,11,1.2666666666666666,10,12
"['100', '110', '0000000']",1,3,10,3,2,13,1.2666666666666666,12,8
"['001', '00', '010111', '1011100', '1101', '1111011']",1,6,11,18,2,29,7.944644244644245,53,40
"['1111010', '01', '1100100']",1,3,7,9,2,16,1.6031746031746033,13,7
"['01', '0011', '1000', '10001']",1,4,9,6,2,15,3.626984126984127,14,17
"['000100', '1', '1010101']",1,3,8,6,0,14,1.151098901098901,14,4
"['0001011', '11010', '0000010']",1,3,12,7,2,19,1.7142857142857144,10,11
"['101110', '01010', '1001101']",1,3,8,10,0,18,1.8554778554778555,8,6
"['00', '10', '1110']",1,3,4,4,2,8,1.5,6,7
"['0001011', '0110010', '001001', '1']",1,4,12,9,2,21,3.0384615384615383,25,11
"['0111000', '1101001', '111', '1001010', '100']",1,5,13,14,5,27,5.933333333333334,36,23
"['00111', '110010', '001010', '10']",1,4,10,9,2,19,3.225108225108225,21,19
"['0011101', '0010000', '011011', '01010', '001100']",1,5,18,13,4,31,6.795204795204795,28,39
"['11010', '001', '111', '0010100', '110011', '001100']",1,6,15,15,4,30,9.354118104118104,47,47
"['111111', '0010', '10']",1,3,4,8,0,12,1.1166666666666667,12,5
"['0101', '110001', '10']",1,3,6,6,0,12,1.5666666666666667,9,7
"['0', '01101', '0110']",1,3,5,5,0,10,1.6222222222222222,8,11
"['0011', '10101', '010011', '100']",1,4,9,9,0,18,4.182034632034632,15,17
"['01', '100', '101001']",1,3,6,5,0,11,1.5666666666666667,9,8
"['11001', '1111101', '11', '0001', '10110', '0100011']",1,6,12,18,4,30,8.119480519480518,53,49
"['110010', '1111110', '1000', '10', '00010', '111000', '1101010']",1,7,18,19,4,37,12.621756021756022,64,72
"['11110', '1', '0000100', '0100001', '11100']",1,5,14,11,4,25,4.347619047619047,42,23
"['01', '11000', '1101', '1000']",1,4,8,7,2,15,3.341269841269841,14,18
"['001', '0011110', '1000', '11111', '1001100', '1011', '011000']",1,7,17,19,4,36,11.611960261960261,69,57
"['0', '101', '110']",1,3,3,4,2,7,1.6666666666666665,6,4
"['0', '101', '1101', '1111100']",1,4,5,10,0,15,2.9525974025974024,21,13
"['111', '101', '1111001', '100010', '100011']",1,5,10,15,4,25,6.1529914529914524,31,46
"['0', '1100010', '01111', '10']",1,4,7,8,0,15,2.4801587301587302,25,14
"['0', '100000', '111']",1,3,6,4,0,10,0.5079365079365079,13,4
"['0', '100', '0100101']",1,3,7,4,0,11,1.35,12,6
"['0', '11110', '00111', '01010', '001001']",1,5,11,11,3,22,4.703896103896104,34,27
"['010', '0010111', '1', '000011', '0110001']",1,5,13,11,2,24,4.743345543345543,39,21
"['01', '010', '001101', '11101', '0110010']",1,5,11,12,0,23,6.245709845709846,31,28
"['10100', '00', '100111', '0111', '0101', '110']",1,6,11,13,2,24,8.365295815295815,38,37
"['0001001', '01001', '0011', '1']",1,4,10,7,0,17,3.2106060606060605,20,17
"['0110100', '101', '0110', '10000', '0000', '0010010', '1100']",1,7,22,12,5,34,12.577705627705628,59,70
"['101010', '010', '1001', '001']",1,4,9,7,2,16,4.006349206349206,14,15
"['11000', '00', '010', '101']",1,4,8,5,2,13,3.4380952380952383,14,12
"['0110010', '00110', '11101']",1,3,8,9,2,17,1.9333333333333331,9,5
"['1010110', '010', '0100111', '11', '101', '1000', '000']",1,7,15,14,5,29,11.275901875901877,63,51
"['1011000', '101101', '0100101', '1001101']",1,4,13,14,3,27,4.153846153846154,14,28
"['1001', '1101011', '111']",1,3,4,10,0,14,1.8987012987012988,9,16
"['1000100', '010001', '0010111', '100001', '11011', '11', '100', '0010100']",1,8,24,19,5,43,16.02131202131202,96,90
"['0', '1011', '111', '0110110']",1,4,5,10,0,15,2.5487012987012987,20,10
"['11000', '01', '011010', '10000']",1,4,11,7,2,18,3.1441558441558444,18,15
"['0010', '0010100', '10100', '111110', '110111', '000', '1001100', '1101', '1001011']",1,9,24,25,7,49,20.37185037185037,111,110
"['01', '110', '111']",1,3,2,6,2,8,1.4666666666666668,5,8
"['101100', '1001', '000']",1,3,8,5,0,13,1.615873015873016,8,7
"['00100', '1000110', '010111']",1,3,10,8,0,18,1.8275058275058274,9,6
"['010', '001', '0000']",1,3,8,2,2,10,1.8095238095238093,6,10
"['010100', '1101001', '00']",1,3,9,6,0,15,1.7136752136752138,11,6
"['11000', '01', '10']",1,3,5,4,2,9,1.3571428571428572,9,6
"['01', '11101', '1101011', '1110']",1,4,5,13,0,18,3.45021645021645,17,22
"['001', '0010010', '000', '010011', '101111']",1,5,14,11,4,25,5.541880341880342,33,25
"['001100', '0010', '101']",1,3,8,5,0,13,1.8158730158730159,8,7
"['101', '0110000', '10', '00101']",1,4,10,7,0,17,3.465873015873016,20,14
"['110000', '00', '01101', '0001000']",1,4,14,6,0,20,3.1767121767121766,23,24
"['100001', '101011', '100000', '000000', '000100']",1,5,22,8,5,30,6.333333333333333,23,39
"['001', '0101011', '0001111', '00110', '10011', '1101']",1,6,14,17,4,31,9.661471861471862,41,40
"['000110', '11', '0110', '001110', '100111', '0000', '011111']",1,7,16,18,6,34,12.133333333333333,61,62
"['11', '10110', '00', '1110', '011000']",1,5,9,10,2,19,5.359018759018759,28,24
"['0010110', '10', '11']",1,3,5,6,2,11,1.3888888888888888,11,5
"['0011101', '11011', '011', '11000', '10101', '0010011', '000', '1011']",1,8,18,21,7,39,16.94256854256854,82,94
"['1010100', '110001', '001111', '1000111']",1,4,12,14,4,26,3.5439560439560442,20,20
"['11101', '101001', '11']",1,3,4,9,0,13,1.6168831168831168,9,15
"['101000', '110', '0010000']",1,3,11,5,0,16,1.6136752136752137,10,9
"['1000', '010010', '110100']",1,3,10,6,2,16,2.0666666666666664,7,7
"['11010', '00', '111']",1,3,4,6,0,10,1.3214285714285714,8,6
"['011', '00111', '100', '1001', '1010', '0111111', '01001']",1,7,13,18,6,31,12.65108225108225,61,58
"['10001', '1111000', '1111']",1,3,6,10,0,16,1.8383838383838382,10,14
"['100', '1', '000011']",1,3,6,4,0,10,1.2301587301587302,11,7
"['110110', '010', '1', '111101']",1,4,5,11,2,16,2.626984126984127,21,12
"['0001', '0100111', '000', '00001']",1,4,13,6,0,19,4.28997113997114,14,25
"['001', '1011110', '0011010', '0010100', '11101', '111001']",1,6,16,19,3,35,9.047552447552448,49,42
"['0110101', '110010', '1111101', '10011']",1,4,9,16,2,25,3.5166500166500168,17,19
"['101', '100', '000101', '0100']",1,4,10,6,2,16,3.806349206349206,14,17
"['0', '001', '0101101', '10110', '11101', '100111']",1,6,11,16,2,27,8.077672327672328,48,36
"['101101', '11', '00', '100101', '001011']",1,5,10,12,5,22,5.0,32,27
"['1110001', '010', '1']",1,3,5,6,0,11,1.15,13,4
"['1000010', '001111', '1101111', '001011']",1,4,11,15,4,26,3.7234432234432235,17,22
"['101001', '10001', '001100', '110', '1001011']",1,5,14,13,2,27,6.014607614607614,29,27
"['011101', '1111101', '0110111']",1,3,5,15,2,20,1.9560439560439562,7,14
"['11', '1011', '0000010', '011001']",1,4,10,9,0,19,2.967909867909868,23,12
"['11010', '000100', '1101', '0100']",1,4,11,8,2,19,3.801010101010101,14,17
"['110000', '1011', '01']",1,3,6,6,0,12,1.3166666666666667,11,7
"['101000', '110', '1100']",1,3,7,6,0,13,2.1015873015873017,6,9
"['110000', '010', '00001', '101', '11111']",1,5,11,11,4,22,4.596464646464646,34,24
"['11011', '0000110', '110']",1,3,7,8,0,15,1.85,10,9
"['101', '0110010', '001', '1']",1,4,7,7,2,14,3.1166666666666667,19,11
"['0001', '1110011', '10110', '10', '000']",1,5,11,10,0,21,5.162914862914863,33,24
"['110001', '00', '1000', '1100', '0011100', '1110']",1,6,15,12,3,27,9.426495726495727,41,48
"['1', '00101', '0000']",1,3,7,3,0,10,1.0,10,6
"['11001', '1100010', '0110', '010111', '01011']",1,5,12,15,2,27,6.128205128205128,28,33
"['0010001', '11110', '1110001', '001111']",1,4,11,14,2,25,3.6723276723276723,21,25
"['0010001', '1101001', '011', '100', '0011010', '1100101', '01010']",1,7,21,18,6,39,13.552380952380952,69,54
"['1001101', '1000', '00', '010110', '01010', '01011']",1,6,16,13,2,29,9.913098013098013,42,45
"['00111', '11000', '1011101', '1100', '101001']",1,5,12,15,2,27,6.287412587412588,30,33
"['0', '0001', '111']",1,3,4,4,0,8,0.6857142857142857,9,4
"['0101000', '00111', '100110', '00', '10']",1,5,13,9,2,22,5.0886890886890885,36,29
"['00111', '110001', '10000', '10', '0001011', '0101']",1,6,16,13,2,29,8.694749694749694,49,39
"['000100', '010111', '000']",1,3,10,5,2,15,1.6111111111111112,10,14
"['010', '1', '00000', '0110', '011110']",1,5,11,8,0,19,4.8176046176046174,31,32
"['01', '1', '1010100', '0000101', '01100', '0111100']",1,6,16,13,3,29,7.226190476190476,59,43
"['0', '1101000', '0011110']",1,3,8,7,2,15,0.9285714285714286,17,9
"['011', '101', '0111111', '10011', '000']",1,5,8,13,3,21,5.033333333333333,32,25
"['0', '1110010', '010', '111111', '101001']",1,5,9,14,2,23,4.4092185592185595,39,22
"['01101', '0011', '1110001', '00', '1010', '1011']",1,6,12,14,3,26,8.803751803751803,42,37
"['011', '111', '00011']",1,3,4,7,2,11,1.9166666666666665,6,12
"['01', '1000', '1111001', '0100']",1,4,9,8,2,17,3.285353535353535,20,13
"['011', '111', '00', '1011', '101001']",1,5,7,11,2,18,5.461904761904762,23,28
"['01', '1', '1111000']",1,3,4,6,0,10,1.1388888888888888,13,6
"['010', '00000', '1101110', '0101010', '1110']",1,5,14,12,2,26,5.298845598845599,33,38
"['100', '1001000', '10000', '1111', '01000']",1,5,15,9,2,24,5.493795093795094,30,35
"['0', '110101', '00011']",1,3,6,6,0,12,0.9826839826839826,12,5
"['0', '00110', '010']",1,3,6,3,0,9,1.5833333333333333,8,13
"['1000', '10010', '11']",1,3,6,5,0,11,1.7936507936507935,7,8
"['0111001', '11', '0001', '1001', '111011', '010110', '0011011']",1,7,15,21,6,36,12.488372738372739,65,62
"['00100', '11101', '001', '000011']",1,4,11,8,2,19,3.2257575757575756,18,18
"['010100', '01', '0010011', '00110', '110111', '0000011', '01110', '0110011']",1,8,23,22,7,45,17.444855144855143,89,88
"['101010', '1111001', '11']",1,3,5,10,0,15,1.5598290598290598,13,10
"['100000', '01', '0111001', '1']",1,4,9,7,0,16,2.3583638583638584,26,14
"['11000', '0110110', '101001']",1,3,9,9,0,18,2.0093240093240095,9,4
"['00111', '10', '01001', '001001', '110']",1,5,11,10,2,21,5.837950937950938,28,28
"['1100010', '100', '1111']",1,3,6,8,0,14,1.431168831168831,11,8
"['0001001', '11', '00100', '1010100', '10000', '0100']",1,6,20,10,4,30,8.951370851370852,44,50
"['10', '0111', '1011', '0101', '1100']",1,5,7,11,4,18,6.083333333333333,22,25
"['1000011', '1100010', '0100000', '1']",1,4,14,8,3,22,2.892857142857143,25,11
"['11110', '1000101', '0011', '00', '1011']",1,5,10,12,2,22,4.975108225108225,30,25
"['1010111', '001100', '1110010', '100000']",1,4,14,12,4,26,3.379120879120879,21,15
"['001', '011', '1101101', '1000', '000', '1100', '01000']",1,7,17,12,5,29,12.323520923520924,54,66
"['0111001', '1', '100', '1011011', '0101']",1,5,9,13,2,22,5.158441558441559,36,25
"['011010', '001', '101111']",1,3,6,9,2,15,1.5555555555555554,10,4
"['100100', '0101111', '1001']",1,3,8,9,0,17,1.6251748251748253,10,9
"['01', '100', '0100']",1,3,6,3,0,9,1.9238095238095236,5,9
"['11011', '11100', '00001']",1,3,7,8,3,15,1.4,10,9
"['001', '0001000', '1001']",1,3,10,4,0,14,2.0025974025974023,9,8
"['01', '101001', '0110', '0100100', '000010', '1011', '01100']",1,7,20,14,4,34,12.923526473526474,61,56
"['11000', '111', '0100']",1,3,6,6,0,12,1.4523809523809523,8,7
"['1101000', '011010', '11']",1,3,7,8,0,15,1.7136752136752138,12,6
"['00', '1', '010010', '1110']",1,4,7,6,0,13,1.9190476190476191,20,11
"['0101', '11011', '0111011', '1111']",1,4,5,15,2,20,4.343434343434343,13,26
"['01', '11011', '010001', '00001', '00111']",1,5,12,11,3,23,5.814285714285714,28,29
"['01', '01111', '000010']",1,3,7,6,0,13,1.435064935064935,11,7
"['111', '0011000', '00001', '001010', '0001011']",1,5,17,11,2,28,5.316455766455767,31,33
"['001', '0110', '110']",1,3,5,5,2,10,1.7619047619047619,6,8
"['11110', '010000', '1', '100011']",1,4,9,9,2,18,2.2987012987012987,25,11
"['101', '01', '111110', '001011']",1,4,6,11,2,17,2.9944444444444445,21,14
"['000111', '1100', '111']",1,3,5,8,0,13,1.638095238095238,10,14
"['0110000', '1101', '10001', '110010']",1,4,12,10,0,22,4.175291375291375,15,13
"['0010', '011', '11', '101', '1000111', '100010']",1,6,12,13,2,25,9.113098013098012,43,44
"['1', '10000', '0111', '0100']",1,4,8,6,2,14,2.522222222222222,18,12
"['1000100', '01101', '1100001', '1101100', '10', '000']",1,6,18,13,3,31,7.9523809523809526,54,38
"['0101111', '011', '101010', '00', '110']",1,5,9,12,2,21,5.137606837606837,33,25
"['1110100', '001', '011']",1,3,6,7,2,13,1.4666666666666668,11,8
"['0001111', '1', '01010', '1110']",1,4,7,10,0,17,2.473232323232323,23,13
"['1111', '101', '00011', '001000']",1,4,9,9,0,18,2.7057720057720056,20,15
"['1001', '10010', '00101', '001000']",1,4,13,7,2,20,4.41010101010101,13,18
"['101000', '111100', '10', '11']",1,4,7,9,4,16,3.1666666666666665,19,16
"['1001', '0101011', '10', '11']",1,4,6,9,2,15,3.4494949494949494,18,17
"['0011', '1010', '010010']",1,3,8,6,2,14,1.7,7,8
"['101', '01', '001101']",1,3,5,6,0,11,1.9666666666666668,8,10
"['010000', '100111', '1001111']",1,3,9,10,2,19,1.8846153846153846,10,11
"['111', '1100100', '10', '000111', '110']",1,5,9,12,2,21,5.3337606837606835,33,34
"['01', '100', '10011']",1,3,5,5,0,10,1.7214285714285715,7,8
"['0', '0010000', '101101']",1,3,9,5,0,14,0.9972527472527473,15,4
"['000010', '011', '01000']",1,3,10,4,0,14,1.4898989898989898,9,11
"['01011', '011', '0001111']",1,3,6,9,0,15,2.0166666666666666,9,11
"['001', '11', '0011001', '101', '100101', '01011', '111101']",1,7,13,19,4,32,12.413813963813963,62,76
"['11011', '1000101', '0011100', '00011', '10111', '0001111', '000', '101111']",1,8,20,25,6,45,16.990670440670442,85,100
"['0010', '11010', '1001010', '1110110', '1010100', '1011', '1101', '11100']",1,8,19,24,8,43,18.93167388167388,70,86
"['101101', '1111', '00', '10', '10011', '000100', '101110']",1,7,14,17,5,31,10.653968253968253,64,53
"['000100', '1100', '10']",1,3,8,4,0,12,1.7666666666666666,9,9
"['001101', '000011', '001000', '100', '01111']",1,5,15,11,3,26,5.275252525252525,32,32
"['00111', '01010', '11']",1,3,5,7,2,12,1.7428571428571429,9,6
"['110011', '101', '1110']",1,3,4,9,0,13,1.838095238095238,8,10
"['010', '100000', '0110']",1,3,9,4,0,13,1.7015873015873015,9,10
"['100101', '10000', '0111', '111011']",1,4,9,12,2,21,3.17979797979798,19,19
"['01', '0000011', '10011', '1111']",1,4,8,10,0,18,2.8239538239538238,21,21
"['0000111', '011', '0']",1,3,6,5,0,11,1.35,12,7
"['0', '010', '0101011', '1110']",1,4,7,8,0,15,2.685064935064935,21,18
"['011101', '100100', '11']",1,3,6,8,2,14,1.5,12,6
"['1111010', '01', '00']",1,3,5,6,2,11,1.3888888888888888,11,6
"['1001001', '1110001', '001', '101111']",1,4,10,13,2,23,3.5894993894993896,22,27
"['0010110', '011', '100', '00', '1101']",1,5,10,9,2,19,4.999422799422799,30,24
"['111', '10111', '000101', '1000', '0000']",1,5,12,10,2,22,4.8422799422799425,29,33
"['0011', '01', '10']",1,3,4,4,2,8,1.5,7,6
"['0001011', '100', '11']",1,3,6,6,0,12,1.2444444444444445,12,9
"['0011001', '0001', '10011']",1,3,9,7,0,16,1.8787878787878787,9,9
"['0100110', '10110', '0110', '011101', '0111', '0000']",1,6,15,15,3,30,9.312354312354312,37,55
"['101', '01', '110', '10000']",1,4,7,6,2,13,3.1523809523809523,15,14
"['001', '1', '0100110', '1100101']",1,4,9,9,2,18,2.914285714285714,25,11
"['0010', '0001', '00', '11111', '1110']",1,5,9,10,3,19,4.277777777777778,30,28
"['001', '1', '00000', '110']",1,4,8,4,2,12,2.0833333333333335,19,12
"['0', '0110', '10000', '000101']",1,4,11,5,0,16,2.790764790764791,21,16
"['1000101', '111010', '111', '011011', '0011', '01000']",1,6,14,17,2,31,8.581490731490732,47,42
"['01', '00', '011100', '101101']",1,4,8,8,4,16,3.1666666666666665,20,14
"['0100110', '11', '100100', '011110', '111000']",1,5,13,14,3,27,5.457264957264957,35,24
"['100', '0100011', '11']",1,3,6,6,0,12,1.4444444444444444,11,8
"['11100', '01111', '110101']",1,3,5,11,2,16,1.8727272727272726,8,10
"['0011', '01', '10', '011100']",1,4,7,7,2,14,3.1,18,14
"['1000001', '11110', '100001', '1001000', '00']",1,5,17,10,2,27,4.814796314796315,36,32
"['010', '0111110', '1101110']",1,3,6,11,2,17,1.9142857142857141,10,14
"['11010', '110', '0100']",1,3,6,6,0,12,1.9880952380952381,6,9
"['11', '00', '0111011', '0111100']",1,4,7,11,4,18,2.492063492063492,25,17
"['00', '1001', '0110001']",1,3,8,5,0,13,1.8383838383838382,10,6
"['110010', '001101', '11010']",1,3,8,9,2,17,2.3030303030303028,8,10
"['00', '10001', '000101', '1']",1,4,9,5,0,14,2.4177489177489178,20,13
"['110010', '001111', '10111', '10101', '0011', '010010', '1001101', '10100', '11100', '01110']",1,10,24,30,8,54,28.478399378399377,118,127
"['0010111', '011', '10011', '011001', '1001001']",1,5,13,15,2,28,6.635148185148185,29,34
"['10001', '0110', '10']",1,3,6,5,0,11,1.6825396825396823,9,6
"['110000', '0011', '0001', '1001', '111111', '000100']",1,6,16,14,6,30,7.85,47,48
"['1000101', '111010', '110100', '1111']",1,4,9,14,2,23,3.855710955710956,17,21
"['011', '0011001', '1101000', '1001000', '1101', '0110000', '0011111', '01001', '01110']",1,9,27,25,7,52,22.005194805194805,120,109
"['0010110', '0100000', '100000', '1011', '0000110']",1,5,21,10,3,31,6.486913086913087,32,38
"['11000', '010011', '1001001']",1,3,10,8,0,18,1.9813519813519813,9,7
"['00100', '001', '0100011']",1,3,10,5,0,15,2.0166666666666666,10,9
"['00', '0100011', '1001']",1,3,8,5,0,13,1.8383838383838382,10,4
"['0011101', '000011', '11', '100', '1011']",1,5,10,12,0,22,5.187823287823288,34,32
"['0010111', '1001111', '111']",1,3,5,12,2,17,1.9142857142857141,10,18
"['100', '10', '00001']",1,3,7,3,0,10,1.5857142857142859,8,8
"['0010', '1111101', '101', '00110', '01110']",1,5,10,14,2,24,6.057287157287157,28,24
"['0001', '01010', '011', '011100']",1,4,10,8,0,18,3.5598124098124098,15,19
"['010', '011', '10111', '10', '0000110']",1,5,10,10,2,20,5.832539682539682,29,24
"['0100001', '00110', '010001']",1,3,12,6,0,18,1.9685314685314685,9,13
"['00010', '0101', '0011000']",1,3,11,5,0,16,1.712121212121212,9,11
"['1001100', '01', '100011']",1,3,8,7,0,15,1.7136752136752138,12,8
"['0000100', '0110', '1110001', '000', '1001111']",1,5,16,12,3,28,5.379220779220779,41,24
"['1010000', '1000', '1', '0010']",1,4,11,5,2,16,2.8227272727272728,21,15
"['110', '10', '111001']",1,3,4,7,0,11,1.9666666666666668,8,8
"['100101', '01101', '100011', '0000100']",1,4,14,10,2,24,3.836829836829837,18,14
"['010', '1000101', '010001', '000010', '0000', '010011']",1,6,22,10,3,32,10.33972693972694,38,46
"['0001011', '1000100', '1']",1,3,9,6,2,15,1.2142857142857144,15,7
"['110110', '010001', '100', '1101110', '000', '01011']",1,6,15,15,4,30,9.116938616938617,45,42
"['0', '1100010', '010011', '10110']",1,4,10,9,0,19,2.7117049617049616,24,14
"['0', '11010', '100101', '001100', '1011']",1,5,11,11,2,22,5.125974025974026,32,18
"['111', '10101', '0001', '0111', '110']",1,5,7,12,4,19,5.527777777777778,20,30
"['011', '0101010', '1100101', '000', '1011']",1,5,12,12,4,24,5.72034632034632,31,21
"['10100', '10110', '10']",1,3,6,6,2,12,1.9428571428571428,7,11
"['110', '10', '11']",1,3,2,5,2,7,2.1,3,9
"['1100', '111', '00001']",1,3,6,6,0,12,1.2658730158730158,9,9
"['0100000', '110010', '111', '0011', '0110', '0010100', '10000', '0111110', '101111', '1111011']",1,10,26,30,8,56,24.19095349095349,158,131
"['0', '1101', '1010100', '0110011']",1,4,9,10,2,19,2.8870129870129873,25,11
"['0', '100011', '10010', '1100101']",1,4,10,9,0,19,3.198884448884449,21,13
"['010', '0011101', '111', '110111', '0001011']",1,5,10,16,4,26,5.589499389499389,35,29
"['01', '10110', '010110']",1,3,6,7,0,13,1.9805194805194803,8,11
"['1110010', '00', '010101', '010010']",1,4,12,9,2,21,3.5085470085470085,21,20
"['01100', '00', '010000', '0111']",1,4,11,6,0,17,3.1987012987012986,18,27
"['0010110', '01', '11110', '111', '011010', '00110', '001001']",1,7,16,18,4,34,11.977616827616828,62,65
"['10111', '101110', '0000']",1,3,7,8,0,15,1.5313131313131314,9,8
"['0', '101', '011111', '001011', '0110011']",1,5,9,14,2,23,4.9171550671550674,35,24
"['0111000', '100', '01111']",1,3,7,8,0,15,1.5166666666666666,11,10
"['111100', '101111', '001000']",1,3,8,10,3,18,1.5,10,9
"['11000', '00011', '00001']",1,3,10,5,3,15,2.0,8,13
"['1001110', '01', '1000', '1']",1,4,7,7,0,14,2.8217171717171716,21,14
"['000110', '1', '01100', '0010011']",1,4,11,8,0,19,2.8655511155511157,24,13
"['0', '10001', '1001', '101010']",1,4,9,7,0,16,3.435209235209235,17,16
"['11110', '0000011', '0100']",1,3,9,7,0,16,1.1414141414141414,13,8
"['011111', '11010', '001']",1,3,5,9,0,14,1.308080808080808,10,7
"['010011', '0010000', '1111']",1,3,9,8,0,17,1.1972027972027972,12,6
"['100100', '00100', '1010101']",1,3,11,7,0,18,2.344988344988345,6,10
"['1001', '1111', '10', '010110', '0111', '1001100', '000']",1,7,14,16,3,30,10.557181707181707,63,51
"['0', '0000001', '1110']",1,3,8,4,0,12,0.8318181818181818,15,6
"['01', '100100', '1101101', '0110000', '010111', '10', '0100001', '01110']",1,8,22,20,7,42,15.413253413253413,100,73
"['0011', '1000000', '1010', '000100', '110']",1,5,16,8,2,24,5.0579309579309575,32,29
"['11011', '0000010', '0110011']",1,3,10,9,2,19,1.7380952380952381,10,7
"['0', '1110111', '011101']",1,3,4,10,0,14,1.304945054945055,14,4
"['101011', '01011', '0000']",1,3,8,7,0,15,1.7535353535353535,8,8
"['100000', '10010', '100011', '0000']",1,4,15,6,2,21,4.1878787878787875,13,23
"['0011011', '11110', '00', '1']",1,4,6,9,0,15,1.8134920634920635,25,13
"['101100', '001101', '00', '10010', '10', '0111101', '01011']",1,7,16,17,6,33,11.8993117993118,67,55
"['01', '111', '001000', '00', '101111']",1,5,9,10,4,19,3.8722222222222222,35,24
"['01', '0010', '010001', '100', '1101100', '100110', '111110']",1,7,17,17,3,34,11.386774336774337,69,55
"['0001111', '110001', '10', '0000']",1,4,11,8,0,19,2.8163947163947163,25,15
"['0010001', '0010011', '00', '111111', '0100100', '01110']",1,6,18,16,3,34,7.325674325674326,59,45
"['0011011', '000110', '0110100', '00101']",1,4,14,11,2,25,4.326173826173826,17,21
"['01', '10001', '1111110', '1110001', '001100', '1101', '1011']",1,7,14,21,4,35,11.715234765234765,72,63
"['110', '1100', '10010']",1,3,6,6,0,12,2.0238095238095237,5,9
"['0100111', '1', '1001000', '0010101', '00110', '1100011']",1,6,18,16,4,34,8.166666666666666,60,34
"['100000', '0010', '0110', '01011']",1,4,12,7,2,19,3.246969696969697,16,17
"['00110', '001', '1', '10000']",1,4,9,5,2,14,3.0166666666666666,18,14
"['01', '0110111', '00011', '00001', '110100', '00110', '010110', '11100']",1,8,21,20,6,41,15.502486402486403,86,84
"['0001011', '00', '11101']",1,3,7,7,0,14,1.2301587301587302,13,7
"['0010', '101101', '0110', '10000', '000101', '010111', '1100']",1,7,19,16,6,35,12.814141414141414,56,53
"['0101110', '001010', '0001000']",1,3,13,7,2,20,2.10989010989011,7,15
"['101', '1101', '011110']",1,3,4,9,0,13,1.9015873015873015,8,6
"['1011011', '1100', '1110100', '1']",1,4,7,12,2,19,2.8870129870129873,25,19
"['110010', '110', '00101', '111111']",1,4,7,13,2,20,3.202020202020202,20,19
"['11010', '0101', '001010', '10']",1,4,9,8,0,17,3.932034632034632,15,17
"['0', '0001', '0101101', '11']",1,4,7,7,0,14,1.7914141414141413,22,11
"['0011', '110', '1100']",1,3,5,6,2,11,1.9285714285714284,8,11
"['0', '011', '1110011', '10110', '1111']",1,5,6,14,0,20,4.843145743145743,33,29
"['0110000', '00', '10110']",1,3,9,5,0,14,1.6825396825396823,12,10
"['1110011', '001010', '1']",1,3,6,8,0,14,1.151098901098901,15,4
"['1', '0110100', '111011']",1,3,5,9,0,14,1.151098901098901,14,4
"['01010', '1', '000001', '01000']",1,4,12,5,2,17,2.6614718614718615,19,14
"['0', '001100', '101']",1,3,6,4,0,10,1.2301587301587302,11,4
"['1000100', '0001001', '01', '1001']",1,4,13,7,2,20,3.867243867243867,20,20
"['111', '101', '0011', '110001', '100101', '110', '111001']",1,7,12,19,6,31,13.825396825396824,53,88
"['001111', '101', '10000', '10', '101111']",1,5,9,13,2,22,5.293145743145743,33,34
"['0', '1110011', '10', '1011', '1111111']",1,5,5,16,2,21,4.455194805194806,39,32
"['1001', '000010', '010011', '110', '01110']",1,5,13,11,2,24,5.812337662337662,29,24
"['0', '010', '0010111', '01011']",1,4,8,8,0,16,3.2666666666666666,20,17
"['01', '100001', '100010', '10100', '00']",1,5,14,7,4,21,5.567099567099567,29,26
"['11001', '1010', '011111', '1101']",1,4,6,13,2,19,3.651010101010101,16,19
"['1001', '110', '000', '11']",1,4,6,6,2,12,2.9428571428571426,12,12
"['110011', '010', '0000001', '11']",1,4,10,8,0,18,2.4282051282051285,25,14
"['1111100', '11010', '01111', '0']",1,4,6,12,2,18,2.8499999999999996,23,17
"['110000', '00010', '1', '0111']",1,4,9,7,0,16,2.5907647907647906,23,13
"['101', '101100', '0001000']",1,3,10,6,0,16,1.682051282051282,11,8
"['1', '101000', '1001', '010101', '0100001']",1,5,14,10,2,24,5.553829503829504,35,29
"['00', '1000', '0001']",1,3,8,2,2,10,2.083333333333333,6,12
"['1100111', '010', '11011', '00']",1,4,7,10,0,17,3.2634920634920634,20,13
"['101000', '1010', '001']",1,3,8,5,0,13,1.8158730158730159,8,10
"['11', '0101101', '00', '1000', '1011']",1,5,9,10,4,19,4.661616161616162,31,23
"['010000', '1', '01001', '110', '111001']",1,5,11,10,2,21,4.97041847041847,33,25
"['110011', '1', '011000']",1,3,6,7,2,13,1.2380952380952381,13,4
"['011011', '0101010', '00', '1']",1,4,8,8,0,16,2.2493894993894994,24,11
"['001100', '0011', '11011', '111110']",1,4,8,13,2,21,3.4575757575757575,17,20
"['01', '100', '100011', '010111', '000', '11111', '0011100']",1,7,15,17,4,32,10.32942057942058,72,57
"['11011', '0100', '000011', '1111']",1,4,8,11,2,19,2.9287878787878787,17,20
"['10010', '111', '01110']",1,3,5,8,2,13,1.65,8,5
"['0001', '011', '001101', '10011']",1,4,9,9,0,18,3.982034632034632,14,16
"['110110', '0011', '1', '000']",1,4,7,7,0,14,2.3015873015873014,20,13
"['1', '101110', '000101']",1,3,6,7,2,13,1.0714285714285714,14,6
"['0', '0001000', '00011']",1,3,10,3,0,13,1.25,13,13
"['101', '00010', '11']",1,3,5,5,0,10,1.5857142857142859,8,4
"['00111', '101', '1100001', '10']",1,4,8,9,0,17,3.13015873015873,21,17
"['0100010', '0101', '1']",1,3,7,5,0,12,1.3772727272727274,12,6
"['0010001', '1001001', '1']",1,3,9,6,2,15,1.3571428571428572,14,10
"['001', '11', '0001', '000001', '10011', '1011011']",1,6,14,13,0,27,8.023132423132424,45,54
"['01', '010', '1110']",1,3,4,5,0,9,1.7047619047619047,6,8
"['000', '1111101', '111010', '1']",1,4,6,11,0,17,1.9493894993894993,26,12
"['110000', '101', '0100000', '01011']",1,4,13,8,0,21,3.2273115773115775,21,16
"['1', '00100', '1111000', '0011010', '0100']",1,5,14,10,2,24,5.117893217893218,36,32
"['00', '110001', '0000110', '11111']",1,4,10,10,0,20,2.4386169386169385,26,12
"['101100', '01', '000', '01010', '010011', '11100']",1,6,15,12,4,27,8.571789321789321,45,44
"['0010', '011', '1110']",1,3,5,6,2,11,1.6428571428571428,6,8
"['011', '1001', '01111', '1001111']",1,4,6,13,0,19,3.9264790764790765,16,25
"['1000100', '1', '01110']",1,3,7,6,0,13,0.9166666666666666,14,4
"['010011', '00', '01010']",1,3,8,5,0,13,1.7987012987012987,9,10
"['0001100', '11011', '100']",1,3,8,7,0,15,1.6,11,7
"['101011', '0110', '00101', '00011']",1,4,10,10,2,20,4.1878787878787875,14,13
"['11000', '011100', '11111']",1,3,6,10,2,16,1.6727272727272728,8,7
"['000110', '11', '0001', '1010', '1011111']",1,5,10,13,2,23,5.215073815073815,35,26
"['0010001', '001', '11', '110100', '10']",1,5,11,9,2,20,4.848717948717948,35,28
"['1100111', '100100', '001111', '100111']",1,4,10,15,3,25,4.3076923076923075,15,29
"['0100010', '10', '000']",1,3,9,3,0,12,1.4444444444444444,11,9
"['11000', '101', '010101', '100111', '011001', '0110110']",1,6,15,18,3,33,9.73869463869464,45,39
"['0110', '01011', '1']",1,3,4,6,0,10,1.4,9,5
"['110001', '1101011', '1101110', '1110101', '00', '010111', '10011', '110']",1,8,16,27,5,43,17.24001554001554,86,99
"['01', '1', '111001']",1,3,3,6,0,9,1.4523809523809523,10,9
"['11001', '100', '10']",1,3,5,5,0,10,2.1214285714285714,6,7
"['10', '0010101', '11']",1,3,5,6,2,11,1.3888888888888888,11,6
"['0101110', '111100', '1000110', '100', '01111', '110011', '111000', '01000']",1,8,21,24,7,45,17.617316017316018,88,84
"['11001', '0101', '011']",1,3,5,7,0,12,2.0238095238095237,6,9
"['1001100', '101', '10110', '1110100']",1,4,10,12,2,22,3.8785714285714286,18,18
"['1000100', '000011', '0110', '1001101', '1111', '10', '0100011', '1110']",1,8,20,21,6,41,15.310339660339661,94,78
"['01', '1110000', '100111', '000', '1101', '001001']",1,6,15,13,2,28,7.620912420912421,54,42
"['11010', '00', '1']",1,3,4,4,0,8,0.9047619047619047,9,4
"['0001', '01', '1000101', '0110']",1,4,10,7,2,17,3.3686868686868685,19,14
"['0', '010', '101010', '10111', '101111']",1,5,8,13,2,21,5.318903318903319,31,28
"['1000', '1', '10', '101001']",1,4,7,6,0,13,3.119047619047619,17,17
"['1000111', '1', '01110']",1,3,5,8,0,13,1.25,14,4
"['1011010', '110010', '1000111']",1,3,9,11,2,20,2.098901098901099,9,10
"['0001', '1100', '0001000', '110101']",1,4,13,8,2,21,3.4342657342657343,19,21
"['0010', '010', '10111', '10010', '1011011', '01011']",1,6,13,16,3,29,10.169264069264068,36,45
"['10100', '1000101', '1', '1111011']",1,4,8,12,2,20,2.4047619047619047,27,19
"['110110', '010', '1100']",1,3,6,7,0,13,1.8158730158730159,7,9
"['0101111', '001111', '011']",1,3,5,11,0,16,2.18974358974359,8,13
"['0', '0111000', '101011', '01111', '00010', '1010010', '110']",1,7,17,17,4,34,10.332789432789433,74,58
"['011', '00001', '1101010', '1001000', '100010', '0101100', '0100']",1,7,24,15,3,39,11.93937173937174,65,61
"['110111', '101001', '11111']",1,3,4,13,2,17,1.7575757575757573,7,18
"['0010', '001', '100001', '10010', '11111', '1100011']",1,6,15,15,2,30,8.973848373848373,43,43
"['01', '101', '100110', '00', '111110', '111101']",1,6,9,16,5,25,7.894444444444444,48,38
"['1001111', '1011', '1110100']",1,3,6,12,2,18,1.7012987012987013,12,13
"['111', '00011', '100', '1001101', '1110101', '1110001', '110', '001011', '01000']",1,9,21,25,8,46,21.07126207126207,117,116
"['11000', '10110', '10', '110100']",1,4,9,9,2,18,3.879220779220779,16,17
"['111011', '1', '0111100']",1,3,4,10,0,14,1.151098901098901,15,4
"['000100', '1100', '001111', '110101']",1,4,11,11,3,22,3.3,19,20
"['0101', '10111', '1000', '1010010', '01110']",1,5,12,13,4,25,5.976767676767676,27,24
"['011010', '110', '110111']",1,3,5,10,2,15,2.0,9,8
"['110011', '1101', '0100']",1,3,6,8,2,14,1.9,7,7
"['1010', '0010010', '1']",1,3,7,5,0,12,1.1954545454545453,12,6
"['100110', '1010', '0100']",1,3,8,6,2,14,2.15,7,8
"['0010', '001', '011', '10101', '0111']",1,5,9,10,4,19,6.607142857142857,17,24
"['00111', '0101011', '1111', '000010', '101111', '1110']",1,6,12,20,4,32,8.16025641025641,43,55
"['10100', '10010', '100111']",1,3,8,8,2,16,2.0727272727272728,7,11
"['100110', '000101', '011', '11']",1,4,8,9,2,17,3.8,18,14
"['010', '1001', '0100']",1,3,7,4,2,11,2.1785714285714284,6,6
"['1000001', '01', '00', '011110']",1,4,10,7,2,17,2.6965811965811968,25,12
"['0111000', '01', '100011', '0100']",1,4,11,8,0,19,3.5537684537684537,23,14
"['01101', '1111', '1111010', '0111111', '111101']",1,5,6,23,2,29,7.388411588411588,24,56
"['1100', '000011', '0000']",1,3,10,4,2,14,1.7000000000000002,8,16
"['011011', '0010001', '0100']",1,3,10,7,0,17,1.9426573426573426,9,8
"['00', '001', '001101']",1,3,7,4,0,11,1.9666666666666668,8,13
"['010000', '10010', '011', '1101110']",1,4,11,10,0,21,3.218104118104118,20,15
"['101001', '1101', '1110']",1,3,5,9,2,14,1.75,7,10
"['0011101', '10', '000', '11']",1,4,7,7,2,14,2.388888888888889,20,12
"['00111', '0110', '00', '10', '0111', '000100', '110']",1,7,14,12,4,26,11.78116883116883,53,67
"['010', '01111', '11']",1,3,3,7,0,10,1.4714285714285715,8,7
"['111', '0001', '1001', '110100', '00', '010111', '1010011']",1,7,15,17,4,32,11.61126096126096,63,61
"['0', '010', '0011110', '1110100', '1011', '0101', '01110']",1,7,14,17,4,31,11.848484848484848,69,57
"['0', '11000', '00100', '1101', '011110', '1010011', '0110010']",1,7,18,17,4,35,11.305516705516705,71,49
"['1100001', '100', '000000', '1001']",1,4,14,6,0,20,3.6442446442446443,19,16
"['110011', '010', '110', '00111']",1,4,7,10,2,17,3.505050505050505,17,17
"['01', '00101', '11', '001110', '000']",1,5,10,8,2,18,5.186796536796537,27,25
"['0', '1010', '1000111']",1,3,6,6,0,12,1.1954545454545453,13,5
"['011011', '00', '001011']",1,3,7,7,2,14,1.8333333333333335,9,11
"['101100', '010', '11', '101010', '1011111']",1,5,9,15,2,24,5.41965811965812,34,29
"['110010', '1110010', '111000', '0001', '1101', '0101']",1,6,15,16,5,31,9.847668997668997,38,51
"['10111', '11100', '1110']",1,3,4,10,2,14,2.1555555555555554,6,13
"['0110000', '1011', '010010']",1,3,10,7,0,17,1.9146853146853147,10,5
['1110001'],1,1,3,4,0,7,0,0,0
"['1', '10100', '001110', '100111', '01000']",1,5,12,11,4,23,4.871428571428571,35,20
"['0', '100110', '010111', '10']",1,4,7,8,2,15,2.9047619047619047,22,14
"['01', '01001', '0110', '10000']",1,4,10,6,2,16,3.234920634920635,17,16
"['0000', '110110', '1010101', '0100']",1,4,12,9,2,21,3.541958041958042,18,12
"['01', '11010', '10']",1,3,4,5,2,9,1.6428571428571428,8,7
"['1', '000', '01010']",1,3,6,3,0,9,1.0833333333333333,9,4
"['1000011', '101011', '01', '0']",1,4,8,8,0,16,2.916056166056166,23,13
"['1010110', '00011', '101010', '101', '0101100', '110', '1001111']",1,7,17,21,5,38,13.173781773781773,68,59
"['11001', '000011', '0111']",1,3,7,8,0,15,1.812121212121212,9,9
"['0', '0001010', '11000']",1,3,9,4,0,13,1.0833333333333333,14,10
"['01', '0100111', '1111101', '00110', '10']",1,5,9,14,4,23,5.015873015873016,39,23
"['01101', '1', '100111']",1,3,4,8,0,12,1.3463203463203464,12,8
"['1101', '0100011', '10']",1,3,6,7,0,13,1.4747474747474747,11,7
"['010001', '011', '101', '1100001', '10100', '000001', '0010010', '01011']",1,8,25,17,8,42,16.905810855810856,83,80
"['01101', '100010', '000', '00011']",1,4,12,7,2,19,3.789393939393939,17,16
"['0', '11010', '010', '00111', '0110011']",1,5,10,11,2,21,5.2,35,28
"['0001', '0000101', '00', '10', '11100']",1,5,13,7,2,20,5.036796536796537,34,31
"['01001', '0110', '1000111', '1111']",1,4,8,12,2,20,3.3686868686868685,18,15
"['0011', '00110', '101']",1,3,6,6,0,12,1.9603174603174602,6,7
"['101', '00010', '110', '100010']",1,4,10,7,2,17,3.686868686868687,15,17
"['11000', '0101011', '10000', '0101010', '1000', '1110']",1,6,18,14,6,32,9.212698412698412,39,49
"['010100', '100001', '1001', '1010', '001110', '011001', '1100']",1,7,20,16,7,36,13.916666666666666,57,55
"['1101001', '0111000', '101100', '0110', '00', '00110']",1,6,17,14,2,31,9.581440781440781,47,48
"['1000101', '11', '00000', '00100', '1000', '10']",1,6,17,8,4,25,7.725685425685425,46,41
"['110010', '000', '110100', '11']",1,4,9,8,2,17,2.9444444444444446,19,18
"['101', '00110', '1000', '0010010', '111001']",1,5,14,11,0,25,6.326207126207126,30,23
"['0011111', '010111', '1110000']",1,3,8,12,2,20,1.6593406593406594,13,13
"['11011', '111', '101', '10101', '00']",1,5,6,12,4,18,5.723809523809524,23,32
"['01', '001', '0110']",1,3,5,4,0,9,2.038095238095238,5,8
"['011', '101', '1100001', '000100', '0100']",1,5,14,9,2,23,5.659251859251859,33,23
"['0', '001', '01011']",1,3,5,4,0,9,1.3333333333333333,8,6
"['0111000', '010', '011', '00', '11101', '1101']",1,6,11,13,2,24,8.374025974025974,42,38
"['11001', '10000', '0011110', '001101']",1,4,12,11,2,23,3.2934731934731936,21,16
"['111100', '11', '10101', '0110000', '010101']",1,5,12,14,2,26,5.701187701187701,33,26
"['00', '10101', '111']",1,3,4,6,0,10,1.3214285714285714,8,4
"['1011', '00010', '1101011']",1,3,7,9,0,16,1.6717171717171717,10,8
"['0111001', '0001', '1001', '01111', '0010101', '000', '01100']",1,7,19,16,6,35,12.169264069264068,57,68
"['0000101', '001', '1', '10']",1,4,8,5,0,13,2.861111111111111,20,14
"['0', '11110', '011111']",1,3,3,9,0,12,1.3463203463203464,11,9
"['11', '1100001', '1111110', '110100', '100010', '0000', '111101']",1,7,17,21,5,38,10.652192252192252,76,63
"['10100', '0101', '11']",1,3,5,6,0,11,1.9047619047619047,7,6
"['00011', '01111', '1011100', '0101', '101001']",1,5,12,15,2,27,6.487412587412587,28,26
"['0010', '00', '110', '11']",1,4,6,5,2,11,2.7714285714285714,12,15
"['100', '10', '0111', '0000']",1,4,8,5,2,13,2.5738095238095235,15,15
"['0', '101000', '10001']",1,3,8,4,0,12,1.3463203463203464,11,5
"['0001', '1001', '000', '01010', '1101']",1,5,12,8,3,20,6.242063492063492,19,24
"['010', '0011101', '011', '1111', '100010', '10010', '000001', '011001']",1,8,21,19,5,40,16.065806415806417,86,74
"['101', '1', '00000']",1,3,6,3,0,9,0.75,11,4
"['0110001', '1010', '0101', '1100110']",1,4,11,11,4,22,3.866883116883117,19,15
"['0101', '0110', '000']",1,3,7,4,2,11,1.8928571428571428,6,9
"['1010001', '00', '0101', '1001']",1,4,10,7,2,17,3.55050505050505,17,15
"['1000010', '1010110', '0111']",1,3,9,9,2,18,1.4805194805194803,10,8
"['0', '1010', '1010100', '011110']",1,4,9,9,0,18,2.370679320679321,23,18
"['110001', '111010', '000', '011000']",1,4,12,9,3,21,3.944444444444444,17,15
"['101011', '00', '100']",1,3,6,5,0,11,1.9666666666666668,8,7
"['1011', '10100', '00', '1']",1,4,6,6,0,12,2.3047619047619046,17,14
"['11011', '10110', '00', '10', '11100', '1111111']",1,6,8,18,5,26,7.565079365079365,51,42
"['010100', '010', '11']",1,3,6,5,0,11,1.5666666666666667,9,6
"['10001', '01', '1001', '0001']",1,4,9,6,2,15,4.432539682539682,10,26
"['01', '01101', '10000', '11010']",1,4,9,8,3,17,3.2285714285714286,18,14
"['0110011', '101', '10110', '01000', '00', '101111', '1110']",1,7,14,18,2,32,11.730991230991231,65,54
"['1011', '00', '1']",1,3,3,4,0,7,0.7333333333333334,8,4
"['010', '011', '101', '100011', '111000']",1,5,10,11,5,21,5.777777777777778,31,24
['1000110'],1,1,4,3,0,7,0,0,0
"['110110', '1111', '010110', '0100101', '1101010']",1,5,12,18,4,30,6.9434232434232435,24,33
"['0111111', '01101', '0101011']",1,3,6,13,2,19,1.5952380952380951,7,11
"['010', '100001', '0110']",1,3,8,5,0,13,1.7015873015873015,9,6
"['0001010', '00', '01100']",1,3,10,4,0,14,1.349206349206349,11,17
"['101', '0010', '110']",1,3,5,5,2,10,1.8095238095238093,6,5
"['1101', '1100', '1', '100010']",1,4,7,8,2,15,3.0357142857142856,18,16
"['10110', '1010', '100011', '0111', '1101']",1,5,9,14,3,23,6.49949494949495,25,30
"['0101111', '0000000', '11100', '10011', '0101', '1100']",1,6,17,15,6,32,7.703896103896104,56,45
"['011111', '101', '100', '10']",1,4,5,9,2,14,3.1833333333333336,17,15
"['0110010', '1010010', '00101', '01100']",1,4,14,10,4,24,4.09047619047619,15,23
"['0', '011', '01000']",1,3,6,3,0,9,1.3333333333333333,9,9
"['0', '1001', '0111']",1,3,4,5,2,9,1.3,9,4
"['0101111', '1', '1111110', '1001']",1,4,5,14,2,19,2.1987012987012986,27,17
"['0011', '1100', '100010']",1,3,8,6,2,14,1.7,10,8
"['0111001', '010', '1', '110']",1,4,6,8,2,14,3.1166666666666667,19,12
"['00', '11011', '011001']",1,3,6,7,0,13,1.512987012987013,10,4
"['010100', '0010110', '0101101', '0011', '100010', '1100', '111001']",1,7,21,19,7,40,13.582084582084581,64,56
"['10101', '111', '1110']",1,3,3,9,0,12,2.0515873015873014,5,12
"['1010000', '000111', '00101', '0000000']",1,4,18,7,2,25,3.221778221778222,21,28
"['010', '1001', '001010', '0111', '0000', '110']",1,6,14,10,5,24,8.170634920634921,37,38
"['0111101', '011', '1111']",1,3,3,11,0,14,1.8987012987012988,9,10
"['1001100', '01', '001101', '11']",1,4,8,9,2,17,3.158119658119658,21,14
"['00', '1000', '1']",1,3,5,2,0,7,1.0666666666666667,7,6
"['00010', '110', '000']",1,3,8,3,2,11,1.5833333333333333,7,13
"['010', '001001', '11', '01000', '000100', '1110']",1,6,16,10,2,26,8.289466089466089,44,41
"['10100', '010', '001110', '110101']",1,4,10,10,2,20,3.6742424242424243,17,12
"['00', '10001', '1']",1,3,5,3,0,8,0.9047619047619047,9,4
"['1001001', '1', '000010']",1,3,9,5,0,14,1.151098901098901,14,4
"['100', '110', '111']",1,3,3,6,3,9,1.6666666666666665,4,8
"['010', '11', '1000', '000', '011000']",1,5,12,6,2,18,5.461904761904762,24,32
"['1000001', '001111', '1111111', '1110101', '0001100', '00', '01000']",1,7,20,21,4,41,9.909423909423909,87,63
"['011011', '110010', '1111']",1,3,5,11,2,16,2.0666666666666664,8,11
"['01', '101', '0001', '10111', '0101001']",1,5,10,11,0,21,6.2423520923520925,28,32
"['011', '01111', '10', '0111']",1,4,4,10,0,14,3.515079365079365,13,23
"['0011', '10', '011']",1,3,4,5,0,9,1.5904761904761904,6,8
"['1000100', '01', '001', '11', '00100', '111000']",1,6,15,10,2,25,7.984648684648684,48,44
"['1000001', '11110', '0100000', '000101', '1110101', '1101', '01011']",1,7,21,20,5,41,11.61005661005661,68,63
"['1011', '01', '00100']",1,3,6,5,0,11,1.6825396825396823,8,4
"['1001001', '10', '111']",1,3,5,7,0,12,1.4444444444444444,11,9
"['000110', '1111101', '100', '0110', '10110', '000', '01110']",1,7,16,17,4,33,12.943284493284493,58,71
"['01', '0001110', '0001', '0001100', '10011', '10']",1,6,16,11,4,27,8.732323232323232,48,43
"['01', '00', '0101011']",1,3,6,5,2,11,1.3888888888888888,11,7
"['01', '1', '1100100']",1,3,5,5,0,10,1.3611111111111112,12,6
"['0101101', '100', '1001010', '01010']",1,4,12,10,2,22,4.330952380952381,17,21
"['010', '1', '1101100', '110011', '1100110']",1,5,10,14,2,24,5.3257631257631255,37,30
"['0100000', '001', '001101', '1010101', '1101110', '11100', '110']",1,7,19,19,5,38,10.981535131535132,76,57
"['01101', '10', '000', '0111', '0000110']",1,5,12,9,0,21,5.235930735930736,32,29
"['10101', '001011', '000']",1,3,8,6,0,14,1.893939393939394,8,6
"['1101111', '01011', '110100']",1,3,6,12,0,18,1.8275058275058274,9,13
"['10101', '001', '000000']",1,3,10,4,0,14,1.308080808080808,10,7
"['0100111', '1', '000000']",1,3,9,5,0,14,0.5576923076923077,16,4
"['1111010', '00110', '11']",1,3,5,9,0,14,1.5158730158730158,12,7
"['001001', '100011', '110']",1,3,8,7,2,15,1.5555555555555554,11,7
"['1011', '1011001', '010001', '0110']",1,4,10,11,2,21,4.1737762237762235,16,16
"['000111', '10000', '1110']",1,3,8,7,0,15,1.5898989898989897,11,10
"['01001', '110100', '01100']",1,3,9,7,2,16,2.254545454545455,7,9
"['0', '0110', '0111']",1,3,4,5,2,9,1.55,7,10
"['1001', '0000110', '10', '111']",1,4,8,8,0,16,3.027994227994228,20,12
"['100', '100000', '0000100', '101111']",1,4,14,8,2,22,3.1213675213675214,22,22
"['00', '100001', '011', '111111']",1,4,7,10,2,17,2.1222222222222222,24,12
"['0', '00010', '0011101', '00101']",1,4,11,7,2,18,3.216666666666667,21,20
"['00111', '101010', '0011100']",1,3,9,9,0,18,1.8403263403263403,8,11
"['0', '11010', '11']",1,3,3,5,0,8,0.9047619047619047,9,6
"['001101', '101', '10100', '10', '111000']",1,5,11,11,2,22,6.005266955266955,30,29
"['1000', '010', '0000000']",1,3,12,2,0,14,1.516883116883117,11,12
"['1001', '00110', '11101', '0100001', '110']",1,5,12,12,2,24,6.132034632034632,30,25
"['011', '1010', '0000010', '0000', '110101']",1,5,15,9,2,24,5.358075258075258,32,27
"['00', '10000', '1101']",1,3,7,4,0,11,1.349206349206349,9,6
"['111', '00001', '00', '010101', '1011', '0111110']",1,6,12,15,0,27,7.039554889554889,49,32
"['1101', '100', '001111']",1,3,5,8,0,13,1.615873015873016,10,8
"['1100111', '0001', '110', '1']",1,4,6,9,0,15,2.581168831168831,22,17
"['0', '0011', '1000', '00101']",1,4,9,5,2,14,2.966666666666667,17,16
"['111', '10001', '100', '110', '1001111']",1,5,8,13,3,21,5.683333333333334,28,39
"['011', '101', '10000', '0111', '1110110']",1,5,9,13,2,22,5.312914862914862,32,27
"['0', '0101', '01110']",1,3,5,5,0,10,1.4,9,9
"['11000', '1001', '1', '10']",1,4,6,6,0,12,3.3047619047619046,15,15
"['101011', '1', '0100110', '1001010']",1,4,10,11,2,21,3.0274725274725274,24,12
"['11', '11110', '0100']",1,3,4,7,0,11,1.349206349206349,9,6
"['0', '011', '10001', '1101', '000111']",1,5,9,10,0,19,5.251082251082251,31,22
"['0', '10101', '010001']",1,3,7,5,0,12,1.3463203463203464,11,5
"['0010101', '1111010', '10', '1011', '01001']",1,5,11,14,2,25,5.637806637806637,34,24
"['001', '100', '000101', '010010', '1101', '101110']",1,6,15,13,5,28,8.965079365079365,44,37
"['001', '1001', '000010', '1100110', '000']",1,5,15,8,2,23,6.571228771228771,27,28
"['101010', '01001', '000001', '000']",1,4,14,6,2,20,3.621212121212121,17,18
"['10000', '0001', '1001', '111']",1,4,9,7,2,16,3.1904761904761902,14,20
"['101010', '001110', '1011111']",1,3,7,12,2,19,1.564102564102564,8,7
"['10000', '0000100', '1101010']",1,3,13,6,2,19,1.9047619047619047,10,10
"['01001', '01101', '10']",1,3,6,6,2,12,1.9428571428571428,7,8
"['0001', '110', '010111', '011100']",1,4,9,10,2,19,2.8634920634920635,20,15
"['01101', '001', '111', '111101']",1,4,5,12,2,17,3.4217171717171717,15,23
"['11000', '00', '1000101']",1,3,9,5,0,14,1.6825396825396823,11,6
"['111', '101000', '0110', '1111000', '0000010', '0011011', '01001', '1001011']",1,8,24,22,4,46,15.389199689199689,95,78
"['100', '10110', '10', '111110']",1,4,6,10,0,16,3.793145743145743,16,19
"['10111', '000100', '000010']",1,3,11,6,2,17,1.5606060606060606,10,7
"['00', '1100', '110', '1111001']",1,4,7,9,0,16,3.6955266955266954,17,16
"['111110', '01011', '111001']",1,3,5,12,2,17,1.393939393939394,9,10
"['101100', '01', '00101', '11', '00001']",1,5,11,9,4,20,5.009090909090909,30,26
"['000110', '11011', '00111', '01111', '01011']",1,5,10,16,4,26,6.745454545454545,20,32
"['0011', '1001', '110100', '1110']",1,4,8,10,3,18,3.35,17,16
"['11110', '10101', '1101', '11']",1,4,4,12,2,16,3.5428571428571427,14,25
"['11011', '0110', '100010', '1000', '01011', '0100']",1,6,15,13,5,28,9.224242424242425,37,41
"['1110011', '1010110', '11101', '10010']",1,4,9,15,4,24,3.838095238095238,16,20
"['01101', '001', '1101111', '11000', '0011110', '100111', '000111', '110']",1,8,17,25,8,42,17.205039405039404,89,87
"['0000111', '10110', '01010']",1,3,9,8,2,17,1.8,10,7
"['0110', '10000', '1111110', '100000', '1100']",1,5,14,12,2,26,5.502136752136752,33,32
"['0', '100', '1111', '011001', '01011']",1,5,8,11,0,19,4.161327561327561,31,21
"['100000', '110', '100001']",1,3,10,5,2,15,1.7222222222222223,9,10
"['10001', '1010', '00', '0000011']",1,4,12,6,0,18,3.379509379509379,20,13
"['011', '11111', '1100', '0110001', '0100']",1,5,10,13,2,23,5.614069264069264,30,29
"['0', '0001001', '110010', '1100']",1,4,11,7,0,18,2.8965534465534466,24,16
"['11000', '01', '1100']",1,3,6,5,0,11,1.507936507936508,8,10
"['110010', '011011', '11000', '1000110', '0011', '10', '1110']",1,7,16,18,4,34,12.346331446331446,62,64
"['0100000', '000', '011110']",1,3,11,5,0,16,1.505982905982906,12,17
"['0', '10111', '0001010', '110']",1,4,8,8,0,16,2.4833333333333334,23,12
"['01111', '10', '000000', '0100']",1,4,11,6,0,17,2.2286435786435788,22,17
"['111010', '101', '00', '0001010', '1110110']",1,5,12,13,2,25,5.765445665445665,35,29
"['111111', '1011011', '001101', '1100000']",1,4,10,16,4,26,3.0824175824175826,22,20
"['100', '10', '000']",1,3,6,2,2,8,1.8666666666666667,4,9
"['11', '100', '1110101', '000000', '1011011']",1,5,12,13,2,25,4.405860805860806,42,28
"['0111000', '11110', '0010111', '10', '0000', '01011', '0100']",1,7,18,16,6,34,11.144588744588745,69,68
"['00', '1001', '1001101']",1,3,7,6,0,13,1.8383838383838382,10,8
"['0', '10001', '0010011', '111111', '100101']",1,5,11,14,2,25,4.385364635364636,39,25
"['0', '101000', '110101']",1,3,7,6,2,13,1.2380952380952381,13,4
"['1000100', '010', '0001', '0111', '1110']",1,5,12,10,3,22,5.268831168831169,30,25
"['0', '01', '10110']",1,3,4,4,0,8,1.5714285714285714,8,6
"['0', '10001', '1111', '1001100', '000111', '110101']",1,6,13,16,2,29,7.2148240648240645,53,41
"['0', '10101', '10001', '011']",1,4,7,7,2,14,3.216666666666667,16,12
"['0010001', '1010', '0']",1,3,8,4,0,12,1.1954545454545453,13,6
"['0000101', '1100000', '101111']",1,3,11,9,2,20,1.4835164835164836,13,10
"['0', '000110', '001010', '01011']",1,4,11,7,2,18,3.1926406926406927,20,20
"['0', '0101', '100', '0011100']",1,4,9,6,0,15,2.866883116883117,21,17
"['1101', '010', '10']",1,3,4,5,0,9,2.038095238095238,5,5
"['01', '0101010', '0010010', '10100']",1,4,13,8,2,21,3.817460317460317,20,18
"['0001010', '0001', '1', '10']",1,4,9,5,0,14,2.8217171717171716,21,14
"['01', '00011', '1010101', '1110100', '01001', '110']",1,6,14,15,4,29,8.27936507936508,51,38
"['0111000', '000110', '010', '1101000', '00', '1011100', '1100']",1,7,21,15,3,36,13.097935397935398,70,84
"['111', '0001', '0000', '0001011', '0100101', '1110']",1,6,16,13,5,29,7.704545454545454,47,47
"['0110', '10', '0000']",1,3,7,3,2,10,1.5,7,9
"['01', '1110110', '11001', '0110011']",1,4,8,13,2,21,3.5317460317460316,21,17
"['0010110', '010', '111', '1000000', '1000', '0110001']",1,6,19,12,5,31,7.704761904761905,56,37
"['0', '0101', '111', '1101100']",1,4,6,9,0,15,2.366883116883117,22,12
"['0011011', '011', '10']",1,3,5,7,0,12,1.4444444444444444,11,8
"['001', '10', '111', '0011100']",1,4,7,8,2,15,2.7777777777777777,19,13
"['01', '011', '00001', '00011', '0111', '0000', '0100101']",1,7,18,12,4,30,12.86955266955267,52,68
"['101010', '10001', '11011']",1,3,7,9,2,16,2.0545454545454547,6,9
"['0', '00111', '1101000', '1001', '00010']",1,5,13,9,2,22,4.628787878787879,37,23
"['0010', '00011', '101', '10100', '001110']",1,5,13,10,2,23,5.89011544011544,26,28
"['1011', '101001', '001100']",1,3,8,8,2,16,2.0666666666666664,8,6
"['100', '01000', '0000']",1,3,10,2,0,12,1.9880952380952381,5,15
"['1001001', '00110', '10', '100010']",1,4,12,8,0,20,3.679043179043179,20,17
"['11000', '011', '00001']",1,3,8,5,2,13,1.6,10,9
"['01', '00110', '100', '0000']",1,4,10,4,0,14,3.0428571428571427,15,19
"['0101101', '001', '110', '111101']",1,4,7,12,2,19,3.213675213675214,20,18
"['01', '010', '11111']",1,3,3,7,0,10,1.3357142857142859,9,5
"['001111', '0011000', '110011', '10', '011001']",1,5,13,14,3,27,5.694444444444445,36,24
"['00', '0101', '1111000', '11']",1,4,7,8,2,15,2.5858585858585856,21,14
"['0011', '011', '10']",1,3,4,5,0,9,1.5904761904761904,6,8
"['0010', '10', '000', '11111']",1,4,7,7,0,14,2.4317460317460315,18,13
"['10001', '100111', '1000111']",1,3,8,10,0,18,2.483682983682984,5,24
"['11001', '100001', '0001', '1000000', '1010000']",1,5,20,9,2,29,6.704262404262404,26,42
"['1110111', '10000', '100101', '10', '1011', '110101']",1,6,12,18,2,30,9.078266178266178,44,57
"['11110', '1110010', '1000', '00', '111101']",1,5,10,14,0,24,5.563530913530913,31,29
"['10010', '100001', '000', '1111']",1,4,10,8,0,18,2.9883838383838386,18,12
"['110010', '11101', '011', '1101010']",1,4,8,13,0,21,3.8614607614607612,16,21
"['1011', '0010', '0000010']",1,3,10,5,2,15,1.5909090909090908,10,8
"['111000', '101', '100100', '111111', '0101']",1,5,10,15,3,25,5.3126984126984125,33,30
"['1000001', '11000', '10101', '1011101', '100110', '0111', '11111', '000000', '01011']",1,9,24,26,8,50,19.538017538017538,113,104
"['0001110', '00111', '100', '00', '111111', '011111', '0001010']",1,7,16,20,4,36,10.764119214119214,76,73
"['01', '01101', '0010011']",1,3,7,7,0,14,1.5158730158730158,11,8
"['0100001', '00', '01101']",1,3,9,5,0,14,1.6825396825396823,11,8
"['0010', '1', '110111', '000010', '0100']",1,5,12,9,4,21,4.654761904761905,35,22
"['0000111', '00', '010001', '100010']",1,4,14,7,2,21,3.6623931623931627,21,14
"['100110', '001', '010101', '1010001']",1,4,12,10,2,22,3.7623931623931623,20,17
"['0', '10100', '0001']",1,3,7,3,0,10,1.1777777777777778,10,7
"['00', '100', '1101111', '011100']",1,4,8,10,0,18,3.2042735042735044,23,16
"['01101', '10111', '1001000', '1000', '010110']",1,5,14,13,2,27,6.086091686091686,31,26
"['011100', '0100010', '1010101', '10000', '110']",1,5,16,12,2,28,5.957176157176157,31,22
"['1010110', '1001', '001111', '1111']",1,4,7,14,2,21,3.606293706293706,17,21
"['110', '101101', '111', '011001']",1,4,6,12,4,18,4.166666666666666,15,17
"['1010', '01', '110', '111']",1,4,4,8,2,12,3.276190476190476,10,15
"['01101', '110010', '001', '10']",1,4,8,8,0,16,3.365367965367965,17,14
"['0111000', '100', '1', '1111110']",1,4,7,11,2,18,2.571428571428571,26,11
"['01', '01101', '0110100', '00111', '0100', '110', '011000']",1,7,17,15,2,32,13.376251526251526,58,75
"['01', '0100110', '1111111', '0001000', '1111011']",1,5,12,18,4,30,4.412698412698412,44,25
"['0101010', '0100111', '110100', '001000']",1,4,15,11,4,26,4.1501831501831505,18,19
"['001', '010110', '11']",1,3,5,6,0,11,1.3444444444444446,9,4
"['0', '001010', '111']",1,3,5,5,0,10,0.7301587301587301,12,4
"['01000', '0110111', '0111']",1,3,7,9,0,16,1.6717171717171717,10,13
"['011', '100', '1101', '0101', '1100', '1110']",1,6,9,13,6,22,9.476190476190476,28,42
"['1110111', '01', '000011', '1100010', '0100100']",1,5,15,14,3,29,5.23992673992674,39,25
"['01', '10001', '10010']",1,3,7,5,2,12,1.9428571428571428,8,9
"['0001', '100', '10']",1,3,6,3,0,9,1.7047619047619047,6,8
"['11', '11000', '1111110', '0101010', '1100111', '0100001', '101110', '0001000', '0100']",1,9,26,26,5,52,19.705228105228105,131,104
"['11001', '1000', '10001']",1,3,8,6,2,14,2.3555555555555556,4,13
"['1000001', '0111101', '1101101', '000000']",1,4,15,12,3,27,2.956043956043956,22,15
"['011', '0011000', '00011', '0001', '1001', '10010', '01010', '0100001']",1,8,25,15,7,40,18.374819624819626,74,81
"['1101001', '110000', '110010', '0011101', '1', '0011010', '111110']",1,7,18,22,6,40,11.121794871794872,79,60
"['100110', '10101', '1', '1111101']",1,4,6,13,0,19,2.7117049617049616,24,21
"['1101', '100', '1', '000']",1,4,6,5,2,11,2.4238095238095236,14,12
"['1011', '1001', '001000']",1,3,8,6,2,14,1.75,8,5
"['01000', '00', '1101']",1,3,7,4,0,11,1.349206349206349,9,6
"['00', '01101', '111000']",1,3,7,6,0,13,1.6168831168831168,10,8
"['00', '01111', '0100']",1,3,6,5,0,11,1.3968253968253967,9,11
"['11110', '01101', '1010100', '01111', '001010', '010110', '0100']",1,7,18,20,5,38,13.424320124320124,52,68
"['01001', '010', '00']",1,3,7,3,0,10,2.1214285714285714,6,10
"['11010', '011', '100110', '1000', '100101', '000']",1,6,15,12,4,27,9.515584415584415,36,41
"['01101', '1111101', '011011', '0001', '100011', '000']",1,6,14,17,2,31,8.220623820623821,47,45
"['01', '100100', '011']",1,3,6,5,0,11,1.7444444444444445,9,7
"['010100', '0111101', '000', '1001101']",1,4,12,11,2,23,3.3894993894993894,22,16
"['1000', '10', '011', '11111']",1,4,5,9,0,14,2.3603174603174604,18,15
"['0', '10', '1000111']",1,3,5,5,0,10,1.3611111111111112,12,5
"['1111', '001', '000101', '00001']",1,4,10,8,0,18,3.051875901875902,17,20
"['01101', '0011000', '0001', '0110', '00']",1,5,14,8,2,22,6.121933621933621,28,39
"['0101111', '100100', '1010', '000010', '0100100']",1,5,18,12,4,30,6.344388944388944,29,34
"['01', '1111000', '011101', '00', '10']",1,5,9,10,3,19,4.726495726495727,35,24
"['110010', '1011001', '1', '001000', '10000', '11101', '1100110', '1110110', '01011']",1,9,23,26,8,49,20.130685980685982,120,98
"['1001', '110', '1111001']",1,3,5,9,0,14,1.8987012987012988,9,12
"['0001', '0000100', '0011000']",1,3,14,4,2,18,1.7012987012987013,10,19
"['00', '010011', '0100']",1,3,8,4,0,12,1.9666666666666668,8,13
"['1000110', '000111', '11111']",1,3,7,11,0,18,1.648018648018648,9,10
"['1000011', '01', '110', '111']",1,4,6,9,2,15,2.7111111111111112,19,19
"['00', '001', '001110', '1101']",1,4,8,7,0,15,3.4714285714285715,17,17
"['101', '00', '1110', '0100']",1,4,7,6,2,13,3.0428571428571427,13,12
"['11110', '001', '001000']",1,3,8,6,0,14,1.2803030303030303,11,9
"['101', '010001', '1']",1,3,5,5,0,10,1.4523809523809523,10,9
"['0011', '000101', '1110', '11']",1,4,7,9,2,16,3.533333333333333,17,18
"['1101001', '0010000', '11000', '000', '1011']",1,5,16,10,2,26,5.642496392496392,33,33
"['00101', '0011', '10001', '0111', '01100']",1,5,12,11,5,23,6.35,21,26
"['10101', '000111', '1']",1,3,5,7,0,12,1.1645021645021645,12,8
"['110000', '01', '100']",1,3,7,4,0,11,1.3166666666666667,10,7
"['00', '001111', '1011100']",1,3,7,8,0,15,1.5598290598290598,12,11
"['0010010', '0101', '10011']",1,3,9,7,0,16,2.0606060606060606,9,4
"['0000101', '1011', '0111']",1,3,7,8,2,15,1.8409090909090908,10,7
"['011100', '011', '110100']",1,3,7,8,2,15,1.7777777777777777,9,11
"['01', '0111010', '111', '0100010', '000', '0100']",1,6,15,11,4,26,7.113997113997113,48,46
"['001', '011011', '0011', '0001111', '1101', '110']",1,6,11,16,4,27,9.06172716172716,42,47
"['11011', '100', '1', '0000']",1,4,7,6,0,13,2.126984126984127,19,12
"['101001', '00100', '000', '11']",1,4,10,6,0,16,2.7074314574314573,18,12
"['001', '1101000', '0000', '1011', '00010', '0110001']",1,6,19,11,4,30,8.53896103896104,47,45
"['100110', '1101111', '1011010']",1,3,7,13,2,20,1.9560439560439562,8,8
"['0010', '1', '1001010', '0001', '1100']",1,5,12,8,3,20,5.0181818181818185,32,23
"['0', '1100010', '01', '101111']",1,4,7,9,0,16,2.6083638583638584,25,11
"['0110010', '1001000', '1']",1,3,9,6,2,15,1.2142857142857144,15,4
"['0', '0101010', '011']",1,3,6,5,0,11,1.35,12,9
"['01', '00', '011010', '110']",1,4,7,6,2,13,2.966666666666667,16,16
"['11110', '01101', '00101', '0111011', '0111101']",1,5,10,19,5,29,7.1571428571428575,25,35
"['0', '0001101', '10110', '1110']",1,4,8,9,0,17,3.084343434343434,21,14
"['11001', '01011', '010110']",1,3,7,9,2,16,1.8545454545454545,6,9
"['1111111', '11101', '000000']",1,3,7,11,0,18,0.8484848484848484,15,8
"['0011001', '100', '0001100', '00', '0101']",1,5,15,8,2,23,6.256854256854257,32,37
"['011', '001000', '1110011', '0000011', '1100']",1,5,15,12,2,27,5.401287601287601,36,37
"['01', '000011', '0011', '10001', '10111', '10010', '0100001', '110', '1001111', '1011111']",1,10,23,28,6,51,26.46981906981907,142,148
"['101', '0001', '1', '1110000']",1,4,8,7,0,15,2.666883116883117,22,17
"['110110', '1011100', '0100101', '1111']",1,4,9,15,2,24,3.704095904095904,19,14
"['011000', '110100', '0100']",1,3,10,6,2,16,2.4333333333333336,6,14
"['0', '001110', '010100', '000011']",1,4,12,7,3,19,2.357142857142857,25,21
"['000110', '010000', '1', '000101']",1,4,13,6,3,19,2.857142857142857,23,17
"['011', '11', '101', '100101', '1100']",1,5,7,11,2,18,6.5095238095238095,24,34
"['11110', '011', '000011', '00', '1110100', '0101']",1,6,13,14,0,27,7.648529248529249,51,44
"['010100', '01011', '11']",1,3,6,7,0,13,1.7987012987012987,9,9
"['010000', '1', '01110']",1,3,7,5,0,12,1.1645021645021645,12,5
"['01', '11', '1001', '1010', '00']",1,5,7,7,5,14,5.75,18,20
"['10111', '110', '10']",1,3,3,7,0,10,1.8714285714285714,7,9
"['11010', '000001', '11']",1,3,7,6,0,13,1.185064935064935,12,8
"['00100', '100100', '00110', '10', '1011111']",1,5,13,12,2,25,5.818537018537018,32,31
"['0010', '1110', '1111011']",1,3,5,10,2,15,1.5909090909090908,10,8
"['11010', '1', '001101', '0111011', '10010', '111101']",1,6,11,19,4,30,8.387162837162837,49,40
"['010100', '100', '00111']",1,3,8,6,0,14,1.712121212121212,10,10
"['101', '10001', '0001', '0011', '0011100', '0100']",1,6,16,11,3,27,9.336507936507937,40,44
"['011', '101', '100000', '0000', '0111101', '11100']",1,6,15,13,2,28,7.2326562326562325,52,43
"['111', '100', '10000', '1010', '001011']",1,5,11,10,2,21,5.281096681096681,27,29
"['100110', '1000', '010', '01011']",1,4,10,8,0,18,3.737590187590188,15,17
"['1100111', '0011', '100111', '111']",1,4,6,14,0,20,4.2884448884448885,15,39
"['1000110', '00', '100']",1,3,8,4,0,12,1.8444444444444446,10,10
"['0010001', '0010111', '00001', '1001', '1101110', '1010', '000001', '001001', '1110']",1,9,28,22,8,50,20.498751248751248,110,126
"['010100', '11', '1001', '0110000', '0100001', '00010']",1,6,20,11,2,31,9.0012099012099,46,36
"['11001', '0110111', '001000', '1000111', '0111', '1101', '01011']",1,7,16,22,6,38,13.031612831612831,61,69
"['011', '000011', '1000110', '1001', '0101001', '0100']",1,6,18,13,4,31,9.596686646686647,45,40
"['0000', '001', '1110', '0100']",1,4,10,5,3,15,2.6785714285714284,13,19
"['0001010', '00', '11101', '1011', '0011100']",1,5,13,12,2,25,5.146464646464646,37,25
"['0010', '1100', '00000']",1,3,10,3,2,13,1.6111111111111112,8,13
"['00100', '011', '1001010']",1,3,9,6,0,15,1.9333333333333333,9,6
"['1000001', '111100', '0000000', '0001010', '01001', '110', '1011111']",1,7,24,18,4,42,10.124941724941724,81,54
"['1011', '10', '01000']",1,3,6,5,0,11,1.6825396825396823,8,5
"['0001', '1001', '010']",1,3,7,4,2,11,1.8928571428571428,6,6
"['011010', '100', '1110011', '1010', '1101', '0111101', '0001000', '111001']",1,8,20,24,7,44,17.804545454545455,86,74
"['100', '001010', '1001101', '00000']",1,4,14,7,0,21,3.7631701631701633,19,17
"['0100111', '000011', '10', '011111', '01100']",1,5,12,14,2,26,5.158064158064158,36,29
"['1111101', '0111011', '11', '0100011', '0101']",1,5,9,18,3,27,5.428571428571429,37,38
"['01', '0001', '0010011']",1,3,8,5,0,13,1.6565656565656566,10,8
"['001', '101', '0011110', '00110', '111110', '000', '1010011', '00010', '111001']",1,9,22,23,9,45,20.6996336996337,114,107
"['100', '0101011', '000101']",1,3,9,7,0,16,1.6598290598290597,10,7
"['1010', '01', '11']",1,3,3,5,2,8,1.8333333333333333,5,6
"['0011', '01101', '10', '1111']",1,4,5,10,2,15,3.071428571428571,15,14
"['01', '100001', '11', '1101101', '1001101', '0101001', '101111']",1,7,15,22,7,37,11.963369963369964,70,86
"['1000101', '000011', '11', '01111', '01001']",1,5,12,13,2,25,5.895926295926296,31,29
"['1000100', '0010', '101100', '111', '101', '0001', '10011', '111001']",1,8,19,19,6,38,16.644744144744145,79,86
"['0', '00111', '10101', '01011', '0001000']",1,5,13,10,3,23,4.95,36,21
"['0', '01011', '10']",1,3,4,4,0,8,1.5714285714285714,8,6
"['1100011', '11110', '1000011', '111001']",1,4,10,15,2,25,3.8023643023643023,17,31
"['0', '00010', '11011']",1,3,6,5,2,11,1.0666666666666667,11,4
"['0', '11101', '10000', '11']",1,4,6,7,2,13,1.9238095238095236,20,12
"['110010', '001', '11', '101000', '100110', '010110', '01100', '1110']",1,8,19,19,4,38,17.155122655122653,77,74
"['00100', '00', '000110']",1,3,10,3,0,13,1.7987012987012987,9,20
"['100', '110', '1111000', '10']",1,4,7,8,2,15,3.911111111111111,16,16
"['010', '11', '10100', '000', '0111']",1,5,9,8,2,17,4.856349206349206,23,23
"['011', '100100', '1001', '10000', '0001100', '000', '0111', '1101']",1,8,21,15,5,36,15.177627927627928,78,84
"['1110111', '100', '11']",1,3,3,9,0,12,1.2444444444444445,12,12
"['101000', '1', '01010']",1,3,7,5,0,12,1.3463203463203464,11,4
"['100010', '10100', '0111111', '0100011', '11100']",1,5,14,16,4,30,5.396403596403596,33,28
"['1010010', '110', '10']",1,3,6,6,0,12,1.6444444444444444,10,10
"['0101101', '11000', '010001', '1']",1,4,10,9,0,19,2.8655511155511157,23,15
"['11110', '010010', '001000']",1,3,10,7,2,17,1.5606060606060606,9,9
"['0010100', '110111', '011100']",1,3,9,10,2,19,1.8974358974358974,10,7
"['1011101', '100100', '1001', '10101', '110111']",1,5,11,17,2,28,7.1886557886557885,24,45
"['0000010', '10011', '111001']",1,3,10,8,0,18,1.6888111888111887,11,5
"['1000100', '11100', '00000']",1,3,12,5,2,17,1.7333333333333334,8,12
"['0101010', '111', '0000']",1,3,8,6,0,14,1.3272727272727272,11,4
"['01', '001', '010111']",1,3,5,6,0,11,1.7444444444444445,8,8
"['01', '1010', '0001', '000011']",1,4,10,6,2,16,3.533333333333333,17,15
"['111', '00101', '0001', '110100', '00', '100111', '1011011']",1,7,15,18,2,33,11.08923298923299,66,64
"['0100011', '11100', '10', '01110']",1,4,9,10,2,19,3.3873015873015873,21,15
"['11001', '01101', '11101']",1,3,5,10,3,15,2.4000000000000004,4,14
"['0', '1111001', '0110', '10110']",1,4,7,10,0,17,3.084343434343434,21,13
"['1011', '01', '1111']",1,3,2,8,2,10,1.5,6,10
"['0', '0001000', '11']",1,3,7,3,0,10,0.4722222222222222,14,4
"['101', '111000', '1']",1,3,4,6,0,10,1.2301587301587302,11,8
"['00010', '1', '101110', '000011']",1,4,10,8,2,18,2.6774891774891776,23,13
"['0010001', '01', '010', '11']",1,4,8,6,2,14,3.188888888888889,18,12
"['1001', '10011', '000010', '11']",1,4,9,8,0,17,3.522438672438672,17,17
"['01', '1000', '0010100']",1,3,9,4,0,13,1.323232323232323,11,8
"['01', '000101', '000', '1100111', '111101']",1,5,11,13,2,24,4.864102564102565,37,29
"['1000000', '10100', '100101', '0000010', '01100']",1,5,21,9,4,30,5.812154512154512,30,32
"['0', '000100', '0011100']",1,3,10,4,0,14,1.304945054945055,13,17
"['11101', '1100', '10', '0100']",1,4,7,8,2,15,3.765873015873016,13,13
"['101000', '10111', '0110', '0001101', '001010', '0111', '01001', '101110']",1,8,21,22,7,43,18.324436674436676,71,78
"['00001', '101', '000001', '110101']",1,4,12,8,2,20,3.217171717171717,17,27
"['11001', '0101', '000010', '0']",1,4,10,6,0,16,2.831168831168831,20,11
"['11110', '00000', '101010', '100', '000001', '0101', '01011']",1,7,20,14,5,34,10.584559884559884,60,60
"['1110101', '10111', '1101', '10101']",1,4,6,15,2,21,4.193939393939394,12,38
"['0', '111110', '000101']",1,3,6,7,2,13,0.9047619047619047,15,6
"['101100', '0000001', '1111', '00', '0100']",1,5,14,9,2,23,3.9142579642579642,37,28
"['0', '1011', '0110000', '10010']",1,4,10,7,0,17,2.862121212121212,23,11
"['0011011', '01', '1']",1,3,4,6,0,10,1.3611111111111112,12,6
"['010001', '001', '10110']",1,3,8,6,0,14,1.712121212121212,10,8
"['001', '0010000', '101101', '00111', '10001', '0001', '000001', '101111', '0101001']",1,9,28,21,7,49,22.227061827061828,100,128
"['0', '0010', '011011', '1101', '0011100']",1,5,11,11,2,22,5.123826173826174,36,24
"['0', '1011', '111110', '101']",1,4,4,10,0,14,2.8873015873015873,18,13
"['0010110', '111', '100', '01111', '10']",1,5,8,12,2,20,4.563492063492063,31,25
"['010', '0110', '111']",1,3,4,6,2,10,1.7619047619047619,5,6
"['0', '101', '0011', '0010011', '1110101']",1,5,10,12,2,22,5.015584415584415,38,27
['0101100'],1,1,4,3,0,7,0,0,0
"['01101', '001', '10110', '011101', '1011']",1,5,9,14,2,23,6.425974025974026,23,30
"['000011', '101', '0011', '1010101', '00110', '1110110', '1001011']",1,7,18,21,3,39,13.04105894105894,63,66
"['11000', '110', '1011000']",1,3,8,7,0,15,2.1833333333333336,8,12
"['1000101', '111', '111100', '0001', '10011', '10']",1,6,12,15,0,27,7.935853035853036,49,49
"['1', '1101101', '00110', '0010010', '100101', '01001', '00010', '0110011']",1,8,23,20,6,43,16.53804528804529,91,65
"['101', '011010', '10000']",1,3,8,6,0,14,1.712121212121212,9,5
"['101000', '0010', '0010101', '0110011']",1,4,14,10,2,24,3.674925074925075,20,17
"['01', '010000', '100', '0000000', '1000', '0010010', '11100']",1,7,25,9,2,34,11.676606726606726,68,79
"['010000', '1110000', '111011', '111111', '011111', '1100']",1,6,13,22,4,35,8.368298368298369,48,68
"['010001', '1001', '11101', '01010', '000', '0100']",1,6,16,11,4,27,9.517099567099567,35,39
"['01', '0010', '1', '0001', '000010', '0000110']",1,6,17,7,2,24,9.007781107781108,44,47
"['1110011', '10', '11111']",1,3,3,11,0,14,1.5634920634920635,11,14
"['0000100', '00001', '101', '1000010', '0000']",1,5,20,6,2,26,6.652958152958153,28,39
"['0', '101000', '110111', '101110']",1,4,8,11,3,19,2.857142857142857,23,12
"['0010110', '1000100', '1']",1,3,9,6,2,15,1.2142857142857144,15,5
"['1100001', '10001', '111', '1110']",1,4,8,11,0,19,3.7803751803751804,17,28
"['111110', '010010', '010110', '0000']",1,4,12,10,3,22,3.2333333333333334,16,24
"['01101', '011', '1100100']",1,3,7,8,0,15,1.8166666666666667,11,9
"['100', '1', '0100100', '0001000']",1,4,13,5,2,18,3.057142857142857,24,16
"['11100', '00', '0110', '0100101']",1,4,10,8,0,18,3.5764790764790764,19,17
"['10111', '0001', '10100', '1011', '1101']",1,5,9,13,5,22,6.127777777777777,21,38
"['101', '0010', '110', '11']",1,4,5,7,2,12,3.742857142857143,11,13
"['0', '11110', '001001', '101110']",1,4,8,10,2,18,2.6774891774891776,23,15
"['00', '1001', '10', '00010']",1,4,9,4,2,13,3.642857142857143,13,14
"['011101', '00', '0000011']",1,3,9,6,0,15,1.4059829059829059,13,8
"['11011', '1000101', '111100', '011', '100', '111111', '000000']",1,7,16,20,5,36,9.887451437451437,77,68
"['0001', '1', '0110', '1001101']",1,4,8,8,2,16,2.8227272727272728,21,11
"['011011', '1011', '100']",1,3,5,8,0,13,1.8158730158730159,8,10
"['0100000', '0101111', '01110', '110', '0100101']",1,5,15,14,3,29,5.497619047619048,34,35
"['1010000', '01', '111011']",1,3,7,8,0,15,1.4059829059829059,13,6
"['0000111', '000', '101101']",1,3,9,7,0,16,1.6598290598290597,12,8
"['1001', '1110101', '00', '100111', '11111']",1,5,8,16,0,24,5.423154623154623,31,38
"['11010', '11', '1000011', '0001010', '0110010']",1,5,15,13,3,28,5.738095238095238,37,28
"['1101001', '111', '101', '1000', '1101', '01011']",1,6,10,16,4,26,9.238600288600288,36,58
"['1010', '10110', '11']",1,3,4,7,0,11,2.126984126984127,6,9
"['0101', '000111', '0100']",1,3,8,6,2,14,1.75,8,9
"['001101', '0111011', '101', '100', '1111010', '11101', '110']",1,7,12,22,5,34,13.67061827061827,59,61
"['10100', '100', '1110']",1,3,6,6,0,12,1.7658730158730158,6,9
"['110111', '1111110', '00001']",1,3,6,12,0,18,0.9918414918414918,12,9
"['01', '0001110', '00100', '1010', '00']",1,5,13,7,2,20,5.743867243867244,30,35
"['0011010', '00100', '1', '10']",1,4,9,6,0,15,3.0992063492063493,21,14
"['01', '10010', '1']",1,3,4,4,0,8,1.5714285714285714,8,6
"['010', '001', '111', '101011', '1000', '0111', '0000111', '000111']",1,8,17,19,7,36,16.023093573093572,79,93
"['0010', '001010', '011', '11']",1,4,8,7,0,15,3.6714285714285713,15,17
"['0101101', '11101', '000010', '11']",1,4,9,11,0,20,2.9243811743811743,22,15
"['101', '1100001', '10']",1,3,6,6,0,12,1.8444444444444446,10,10
"['0', '0010001', '1011110', '10110', '0011010', '01010']",1,6,17,15,5,32,8.097619047619048,55,50
"['001', '1', '000']",1,3,5,2,2,7,1.1666666666666665,6,6
"['1010110', '00110', '10', '1111']",1,4,7,11,0,18,2.9906204906204907,19,16
"['011', '00101', '0011', '100100', '00', '11101']",1,6,13,12,2,25,8.781457431457431,39,44
"['01101', '111', '000', '01010']",1,4,8,8,4,16,3.3,15,11
"['11100', '0010100', '1', '10']",1,4,8,7,0,15,2.9325396825396823,22,13
"['11', '101010', '0001', '100111', '1100']",1,5,10,12,4,22,5.366666666666666,31,29
"['10000', '111010', '1111']",1,3,6,9,0,15,1.5676767676767676,9,10
"['11010', '000010', '11']",1,3,7,6,0,13,1.3668831168831168,11,8
"['0001001', '01', '110', '110010']",1,4,10,8,0,18,3.0264957264957264,23,16
"['101011', '01', '100', '110']",1,4,6,8,2,14,3.0777777777777775,15,14
"['01', '00100', '01001', '0111']",1,4,9,7,2,16,3.7206349206349207,15,16
"['1000001', '01', '100000', '0001101']",1,4,15,7,2,22,3.248778998778999,23,22
"['01', '00101', '101110']",1,3,6,7,0,13,1.6168831168831168,10,7
"['101', '100', '1101', '00010', '0000110', '1001111']",1,6,15,14,4,29,8.535353535353535,49,38
"['1111010', '011010', '011']",1,3,6,10,0,16,1.835897435897436,10,13
"['101', '1100', '1']",1,3,3,5,0,8,1.4714285714285715,7,8
"['0', '11000', '1101']",1,3,5,5,0,10,1.4,9,6
"['11001', '00', '010000']",1,3,9,4,0,13,1.6168831168831168,10,6
"['0110100', '0011', '111111', '11101', '0111', '1010001', '01100', '0100']",1,8,18,24,7,42,16.540897990897992,84,85
"['01', '110', '10', '1111']",1,4,3,8,2,11,2.9380952380952383,13,15
"['0010', '010', '100100', '100101', '000', '011001']",1,6,18,10,5,28,10.525396825396825,35,43
"['11000', '1001001', '0001', '1111']",1,4,10,10,2,20,3.1186868686868685,19,20
"['0111000', '1110010', '001', '011011', '10', '1011000', '01100']",1,7,19,18,3,37,12.627394827394827,68,63
"['0011', '001', '011000']",1,3,8,5,0,13,1.9015873015873015,9,10
"['0001101', '100111', '0111100', '11']",1,4,9,13,2,22,3.344932844932845,23,13
"['0101', '0111111', '10011']",1,3,5,11,0,16,1.712121212121212,11,8
"['100', '111000', '10', '0011000']",1,4,11,7,0,18,3.7803418803418802,19,21
"['0011', '1000110', '01110', '0010011']",1,4,12,11,2,23,4.0021645021645025,18,19
"['001', '0010111', '0001', '0000011', '110', '0100']",1,6,17,11,6,28,7.872294372294372,48,47
"['010', '10', '101110']",1,3,5,6,0,11,1.9666666666666668,8,10
"['1100001', '01', '01001', '000']",1,4,11,6,0,17,3.1825396825396823,19,15
"['1000000', '01', '1']",1,3,7,3,0,10,1.1388888888888888,13,6
"['0111000', '01', '0100110', '111', '00', '011000']",1,6,15,12,4,27,7.232112332112332,54,49
"['0', '0101000', '011', '1101011', '000001']",1,5,14,10,2,24,4.270818070818071,41,24
"['0010', '11010', '00', '100011', '01010']",1,5,13,9,2,22,5.951948051948052,25,30
"['01', '110', '1001111']",1,3,4,8,0,12,1.2444444444444445,12,7
"['011111', '00', '001010']",1,3,7,7,2,14,1.25,12,10
"['10001', '0001', '1010101', '0101', '01000']",1,5,15,10,4,25,6.613131313131313,21,33
"['00', '010110', '01010']",1,3,8,5,0,13,1.9805194805194803,8,16
"['00', '1', '110111', '01010']",1,4,6,8,0,14,1.9859307359307359,22,8
"['0', '101', '1100100', '1000111', '0111111', '11101']",1,6,11,19,3,30,7.338095238095238,61,42
"['0', '1100010', '011110']",1,3,7,7,0,14,0.9972527472527473,15,9
"['0110000', '0001', '0111', '001000']",1,4,14,7,2,21,3.36013986013986,19,24
"['01101', '010', '111', '0110111', '00111', '100000', '1011000']",1,7,17,19,6,36,11.805111555111555,68,62
"['001', '0100111', '011100', '1101000', '01000']",1,5,16,12,2,28,5.973914973914974,35,37
"['0', '01', '1001101', '001100', '101110']",1,5,11,11,2,22,5.137667887667888,36,20
"['00', '10010', '1100110', '1']",1,4,8,7,0,15,2.4325396825396823,22,11
"['1110111', '00001', '010010', '0110000', '1000', '010111', '10', '01000']",1,8,24,18,6,42,16.12806082806083,88,88
"['11', '011', '0100', '00011']",1,4,7,7,0,14,3.4706349206349207,14,18
"['11', '1001', '1010', '1011', '1111011']",1,5,6,15,3,21,6.512626262626262,26,46
"['0', '11101', '101001', '00011']",1,4,8,9,2,17,2.625108225108225,22,12
"['110000', '0001', '110111']",1,3,8,8,2,16,1.5,10,11
"['0101', '1', '001111', '01100']",1,4,7,9,0,16,2.831168831168831,20,12
"['001000', '10101', '1001', '10000', '10100', '1110110', '111000']",1,7,21,17,5,38,13.698445998445997,51,66
"['0011', '11', '00000', '011001']",1,4,10,7,0,17,2.5747474747474746,20,14
"['101', '1010', '000', '0100']",1,4,9,5,4,14,3.6547619047619047,10,14
"['11110', '0101111', '1010', '1100110', '0101100']",1,5,12,18,3,30,6.134920634920634,28,33
"['1111100', '001', '10', '1100100']",1,4,9,10,2,19,2.8603174603174604,24,17
"['011101', '0101010', '110', '0100100']",1,4,12,11,2,23,3.5545787545787544,18,19
"['101011', '001', '110']",1,3,5,7,2,12,1.222222222222222,9,7
"['0', '1010110', '00011', '1001', '100000', '1011']",1,6,15,12,2,27,8.034432234432234,48,40
"['01', '011', '010110', '0100']",1,4,8,7,0,15,4.004761904761905,14,21
"['0010', '010', '0110111', '00', '0110010']",1,5,13,10,2,23,6.3997113997114,31,46
"['011', '1011111', '011101', '11111', '111001']",1,5,6,21,2,27,6.716938616938617,27,47
"['1111100', '00', '10', '0011011', '0101', '01011']",1,6,12,15,4,27,8.329004329004329,51,43
"['00100', '1', '1101010']",1,3,7,6,0,13,1.25,13,4
"['1010110', '010', '01000']",1,3,9,6,0,15,2.0166666666666666,9,11
"['00111', '00', '110', '0100110']",1,4,9,8,0,17,3.1825396825396823,20,19
"['01101', '1010011', '11']",1,3,5,9,0,14,1.5158730158730158,11,10
"['1100', '1', '011', '0100111']",1,4,6,9,0,15,2.866883116883117,22,16
"['111010', '0110', '1111000', '0000001', '011101', '01110']",1,6,17,18,4,35,9.096248196248196,47,49
"['1101', '0110', '0111', '0001111']",1,4,7,12,3,19,4.068181818181818,16,16
"['01111', '00', '1101011']",1,3,5,9,0,14,1.2301587301587302,12,6
"['1111100', '010001', '100000', '10011']",1,4,13,11,2,24,3.3624708624708624,21,16
"['101', '010010', '1001010', '00011']",1,4,12,9,0,21,3.92983682983683,18,13
"['010', '1001', '11111']",1,3,4,8,0,12,1.2658730158730158,10,4
"['10111', '10101', '1110']",1,3,4,10,2,14,1.911111111111111,5,12
"['101000', '010011', '00000']",1,3,12,5,2,17,1.5757575757575757,8,10
"['01', '0010', '1001011']",1,3,7,6,0,13,1.8383838383838382,10,4
"['0000', '00110', '1001', '11']",1,4,9,6,2,15,3.071428571428571,16,10
"['11', '010', '1100101', '1001']",1,4,7,9,0,16,3.40981240981241,19,15
"['1011', '101100', '101101']",1,3,6,10,2,16,2.4333333333333336,5,18
"['1000', '010', '100']",1,3,7,3,2,10,2.095238095238095,5,9
"['0001100', '1', '100110', '110100']",1,4,11,9,2,20,2.706043956043956,23,13
"['0110', '01011', '0111', '0100']",1,4,8,9,3,17,4.0,9,23
"['11001', '0110100', '000101', '10', '0100011', '110', '111101']",1,7,17,19,4,36,12.106610056610057,71,54
"['100', '0101011', '01100']",1,3,8,7,0,15,1.85,9,9
"['011100', '011011', '1001', '100101', '10', '010011']",1,6,14,16,4,30,8.933333333333334,46,40
"['001110', '100101', '0101001', '1111']",1,4,10,13,2,23,3.4890442890442888,20,11
"['010', '0101110', '111', '1010', '00010']",1,5,11,11,2,22,5.674025974025974,27,31
"['01', '00010', '0010000']",1,3,11,3,0,14,1.6825396825396823,11,11
"['1', '110', '000000']",1,3,7,3,0,10,0.7222222222222222,13,4
"['11111', '1001101', '0100']",1,3,6,10,0,16,1.2676767676767677,11,4
"['1101000', '100011', '1011100', '01100']",1,4,13,12,2,25,3.6938061938061937,20,17
"['1', '0110100', '111101']",1,3,5,9,0,14,1.151098901098901,14,4
"['0', '110110', '1001110', '001000', '1111', '00110', '11100', '101001']",1,8,19,21,5,40,14.656016206016206,91,73
"['100001', '100', '1100011', '1001111', '1110']",1,5,12,15,2,27,6.027905427905428,33,38
"['11', '11010', '0010', '111001']",1,4,7,10,0,17,3.398701298701299,19,17
"['1000100', '1', '00001']",1,3,9,4,0,13,1.25,13,7
"['0', '011011', '1001']",1,3,5,6,0,11,1.0857142857142859,11,4
"['001100', '0111101', '010101']",1,3,9,10,2,19,1.8974358974358974,8,9
"['1', '001011', '1110']",1,3,4,7,0,11,1.0857142857142859,12,7
"['11001', '01', '010', '011110', '11111']",1,5,7,14,2,21,5.446536796536797,30,23
"['1011', '10101', '1', '101101']",1,4,5,11,0,16,3.617027417027417,16,33
"['0010001', '0', '11110', '1100101', '110']",1,5,11,12,2,23,4.630952380952381,40,25
"['0', '00100', '011']",1,3,6,3,0,9,1.3333333333333333,9,8
"['01', '011', '100', '1110001', '1000011', '1001100']",1,6,15,14,5,29,8.40952380952381,57,46
"['011', '10111', '100110', '1000', '10010', '01010', '00010', '110']",1,8,19,17,6,36,17.514718614718614,63,85
"['0', '0100010', '111101']",1,3,7,7,0,14,0.8434065934065934,15,4
"['1011110', '1100001', '1101110']",1,3,8,13,3,21,1.857142857142857,11,11
"['011110', '11101', '01011', '01110']",1,4,7,14,3,21,4.181818181818182,13,19
"['000110', '101000', '110100', '0101010', '011110', '01001']",1,6,20,16,4,36,9.663170163170163,39,48
"['11110', '1110', '11']",1,3,2,9,0,11,2.126984126984127,6,15
"['110110', '10110', '10011', '000', '1001111']",1,5,11,15,2,26,6.3961926961926965,28,31
"['100', '00', '01001', '1001111', '01000']",1,5,13,9,2,22,6.453968253968254,30,28
"['0', '111000', '110']",1,3,5,5,0,10,1.4523809523809523,10,7
"['0001', '1010010', '10']",1,3,8,5,0,13,1.505050505050505,11,8
"['0010', '1111', '011110', '0110010', '101001', '1110']",1,6,13,18,5,31,9.156643356643357,41,42
"['0', '01', '0011101']",1,3,5,5,0,10,1.3611111111111112,12,7
"['011', '000000', '111']",1,3,7,5,2,12,0.8888888888888888,12,6
"['101100', '010101', '111', '1100100']",1,4,10,12,2,22,3.6085470085470086,18,16
"['0', '0011101', '111110', '1110', '011000']",1,5,10,14,2,24,5.079470529470529,36,28
"['0', '1010', '010', '00011']",1,4,8,5,0,13,3.034920634920635,16,16
"['0', '11110', '1100000', '010010', '1010', '110101']",1,6,15,14,2,29,7.2511877011877015,51,36
"['1000000', '11010', '100', '000']",1,4,13,5,2,18,3.6166666666666667,18,21
"['1010111', '1000', '110101']",1,3,7,10,0,17,1.9146853146853147,9,10
"['0110010', '01', '111', '000']",1,4,8,7,2,15,2.4444444444444446,20,11
"['01', '11101', '0010100']",1,3,7,7,0,14,1.5158730158730158,12,5
"['0011', '1010001', '011000', '111001']",1,4,12,11,2,23,3.9505827505827504,19,14
"['0', '1011010', '101001', '011110']",1,4,9,11,2,20,2.5393772893772892,24,13
"['11110', '010', '010000', '0000', '110']",1,5,13,8,2,21,5.270779220779221,28,39
"['11000', '11100', '011', '0100101']",1,4,10,10,2,20,3.5666666666666664,19,17
"['0101100', '010110', '0111110', '0100']",1,4,12,12,2,24,4.182617382617383,14,40
"['11111', '000', '00001']",1,3,7,6,2,13,0.95,11,8
"['111000', '10', '011000']",1,3,8,6,2,14,1.8333333333333335,9,10
"['1000100', '001', '1', '01110']",1,4,9,7,0,16,2.5166666666666666,23,11
"['00', '1001', '0110']",1,3,6,4,2,10,1.8333333333333333,7,4
"['0101', '001', '000']",1,3,7,3,2,10,1.8095238095238093,4,9
"['0010100', '001101', '00011']",1,3,11,7,0,18,2.163170163170163,7,12
"['0010', '100', '10011']",1,3,7,5,0,12,1.9880952380952381,6,7
"['1000011', '110', '10']",1,3,6,6,0,12,1.6444444444444444,11,9
"['01', '1010010', '100', '111']",1,4,7,8,2,15,2.7777777777777777,19,13
"['110110', '00101', '11', '1010', '000', '1011']",1,6,11,13,2,24,8.685137085137084,38,38
"['101', '00', '110']",1,3,4,4,2,8,1.4666666666666668,6,4
"['11111', '1101101', '00000']",1,3,7,10,2,17,1.1666666666666667,12,6
"['1000', '011', '10', '0101001']",1,4,9,7,0,16,2.942279942279942,19,14
"['100110', '0001', '000']",1,3,9,4,0,13,2.123809523809524,7,10
"['0001', '110', '011']",1,3,5,5,2,10,1.5238095238095237,7,7
"['1010000', '0001', '1001', '1111']",1,4,10,9,3,19,2.9545454545454546,19,19
"['10011', '010001', '10', '000']",1,4,10,6,0,16,3.365367965367965,17,11
"['010', '001', '0111']",1,3,5,5,2,10,1.8095238095238093,6,7
"['11', '1011101', '10010', '1010000', '1011', '0010010']",1,6,16,16,3,32,9.08008658008658,50,47
"['0011', '0011110', '11']",1,3,5,8,0,13,1.8383838383838382,10,9
"['0', '001100', '0001', '01101']",1,4,10,6,0,16,2.790764790764791,19,17
"['0', '10', '111010']",1,3,4,5,0,9,1.4523809523809523,10,7
"['100101', '1001', '0010100', '10']",1,4,11,8,0,19,3.7257964257964256,20,16
"['111', '101', '0001', '0101010', '000']",1,5,11,9,3,20,4.8779220779220775,27,21
"['01', '00000', '100', '10000', '001011']",1,5,15,6,2,21,4.874963924963925,31,35
"['00001', '101011', '001010', '11']",1,4,10,9,2,19,2.8614718614718613,19,13
"['0', '10', '111']",1,3,2,4,0,6,1.0666666666666667,6,4
"['0010110', '011101', '01101', '011']",1,4,9,12,0,21,4.207808857808858,16,21
"['00', '001', '010111']",1,3,6,5,0,11,1.7444444444444445,8,8
"['0', '1110100', '111']",1,3,4,7,0,11,0.85,13,8
"['0', '00110', '1110011', '0000100']",1,4,12,8,2,20,2.595238095238095,28,14
"['10010', '10110', '0000010', '11']",1,4,11,8,2,19,3.165079365079365,20,16
"['01', '001101', '001000', '100110', '1101']",1,5,13,11,3,24,6.133333333333333,30,26
"['0', '0010110', '101101']",1,3,7,7,0,14,1.304945054945055,14,4
"['011', '111', '101', '1010101', '010010', '110']",1,6,10,15,4,25,9.19145299145299,41,41
"['0', '0111010', '0001000']",1,3,10,5,2,15,1.0714285714285714,15,12
"['0010', '11010', '00101', '11', '0000']",1,5,12,8,4,20,5.492857142857143,25,29
"['011', '111', '1110011', '1010', '00', '0100']",1,6,10,13,4,23,7.885353535353535,42,40
"['1001110', '010100', '0010', '010001', '110001', '1111001', '11101', '0111', '01010', '11100']",1,10,26,29,10,55,28.616261516261517,126,131
"['001100', '1000', '111']",1,3,7,6,0,13,1.33015873015873,10,6
"['00101', '000011', '001000', '0001', '10001', '010110', '0100011', '101001']",1,8,28,17,6,45,19.501476301476302,68,83
"['1101001', '011', '10', '11']",1,4,5,9,2,14,2.988888888888889,18,19
"['001', '1110000', '00000', '1010', '10011']",1,5,15,9,2,24,5.4446608946608945,31,29
"['101', '1001', '111011', '1010111', '011110', '11111']",1,6,8,23,2,31,9.427616827616827,41,58
"['0010001', '1', '011']",1,3,6,5,0,11,1.35,12,6
"['10001', '1100', '110101']",1,3,7,8,0,15,2.193939393939394,6,11
"['1110111', '0100000', '1000', '110100']",1,4,13,11,2,24,3.2073926073926073,21,16
"['1', '1001', '1011100', '000', '1010010']",1,5,12,10,2,22,4.458441558441558,38,24
"['011011', '100', '00', '110', '0100']",1,5,10,8,2,18,6.173015873015872,23,30
"['0', '1010', '1001', '000001']",1,4,10,5,2,15,2.835714285714286,20,13
"['11000', '0011', '1', '101']",1,4,6,7,0,13,2.749206349206349,18,16
"['100', '10000', '11']",1,3,6,4,0,10,1.4357142857142857,8,9
"['0', '1010101', '01011']",1,3,6,7,0,13,1.4166666666666667,12,4
"['01', '00', '01000', '110101']",1,4,9,6,2,15,3.188311688311688,18,14
"['1100010', '00', '1', '011']",1,4,7,6,0,13,1.9944444444444445,22,11
"['0', '0111000', '1110001', '1011000', '0100']",1,5,15,11,3,26,5.7214285714285715,37,27
"['0011000', '101', '0110000', '1000', '10', '000010']",1,6,20,9,2,29,8.813886113886113,50,51
"['1001', '1100', '11']",1,3,4,6,2,10,2.083333333333333,6,10
"['101', '1001000', '000101', '00', '1000', '0100']",1,6,18,8,2,26,9.107231657231656,43,52
"['0001', '000100', '10000']",1,3,12,3,0,15,2.193939393939394,6,15
"['0', '0101111', '010110', '010011', '1010010', '1100']",1,6,15,16,4,31,8.244022644022644,53,44
"['1011001', '00001', '11101', '1011', '11100', '1111111']",1,6,11,22,5,33,8.008369408369408,46,65
"['011', '010010', '100010', '10', '1101']",1,5,11,10,2,21,5.582539682539682,29,26
"['0', '11010', '0101000', '011011', '10101']",1,5,12,12,2,24,5.405644355644355,35,20
"['0', '000001', '11']",1,3,6,3,0,9,0.5357142857142857,12,4
"['0', '0010', '11101', '00011']",1,4,8,7,2,15,2.5777777777777775,20,12
"['1101', '001011', '01110']",1,3,6,9,0,15,1.812121212121212,9,5
"['010001', '00101', '0101011', '010101', '1100', '0100']",1,6,18,14,4,32,10.580691530691531,32,56
"['01', '11101', '0001', '010010']",1,4,9,8,0,17,3.527994227994228,17,14
"['1', '1001101', '010111', '1011', '000111']",1,5,9,15,2,24,5.720496170496171,33,32
"['0', '1010', '1111111']",1,3,3,9,0,12,0.7636363636363637,15,4
"['01', '011010', '1110011', '00110', '001010', '1011011']",1,6,15,18,4,33,9.582029082029083,46,37
"['0111000', '010001', '0001110', '1010111', '1111010', '01011']",1,6,18,21,4,39,9.545954045954046,51,39
"['010000', '10101', '1001101', '0000101', '111110', '10', '0101100', '0111']",1,8,22,22,5,44,15.337162837162836,94,74
"['11110', '10001', '110001']",1,3,7,9,2,16,1.8545454545454545,8,13
"['1000', '110', '101111']",1,3,5,8,0,13,1.4158730158730157,10,8
"['1000110', '1010', '011110']",1,3,8,9,0,17,1.7426573426573428,9,11
"['001', '0011110', '1000', '001010', '01000']",1,5,16,9,0,25,6.368942168942169,29,42
"['0', '000110', '00101']",1,3,8,4,0,12,1.3463203463203464,12,9
"['0010001', '011', '110001', '0110', '0000101', '10011', '01010']",1,7,21,16,4,37,13.886346986346986,60,54
"['0111000', '110000', '00011', '101010', '11000', '100', '100011', '110', '01011']",1,9,25,21,8,46,22.737373737373737,104,119
"['010', '011010', '0000000', '0001111', '0101', '0111110']",1,6,19,15,3,34,8.453080253080254,55,58
"['1', '011', '00000']",1,3,6,3,0,9,0.75,11,4
"['010011', '110', '00001']",1,3,8,6,0,14,1.4217171717171717,10,7
"['1', '00101', '00001', '101', '000']",1,5,11,6,4,17,4.85,25,29
"['00100', '1', '000001']",1,3,9,3,0,12,1.1645021645021645,11,6
"['10101', '1000', '110']",1,3,6,6,0,12,1.7380952380952381,6,7
"['00', '10', '0111', '11']",1,4,4,6,3,10,2.333333333333333,12,12
"['010', '01101', '000011', '1101110', '1011000', '1110']",1,6,15,17,2,32,9.003235653235652,51,41
"['01', '00111', '101', '10011', '110', '111001']",1,6,9,15,4,24,9.165584415584416,41,47
"['1110001', '10', '1111110', '1111']",1,4,5,15,2,20,3.248196248196248,23,27
"['100', '10100', '010111', '11100', '0011100']",1,5,13,13,2,26,6.704584304584305,28,40
"['00100', '0001', '110011', '0001101', '0111', '0100']",1,6,17,13,3,30,8.945687645687645,42,45
"['11010', '11', '101', '100', '1010', '001110', '1010010']",1,7,14,16,2,30,13.196048396048395,55,63
"['1001110', '01', '0101111', '100']",1,4,8,11,2,19,3.003174603174603,24,15
"['1011', '111010', '000']",1,3,6,7,0,13,1.33015873015873,10,5
"['000110', '00101', '11', '00', '1011', '110101']",1,6,12,13,4,25,8.164069264069264,45,39
"['1000100', '11000', '10', '0110100']",1,4,13,8,2,21,3.6746031746031744,21,18
"['11010', '0011101', '101', '000', '0101', '001011', '01110']",1,7,16,17,4,33,13.365984015984015,55,55
"['11010', '01101', '0010000', '11', '00110', '000', '01100']",1,7,19,13,4,32,12.291269841269841,61,68
"['010101', '10', '11101']",1,3,5,8,0,13,1.6168831168831168,9,8
"['0', '0010110', '1000110']",1,3,9,6,2,15,1.3571428571428572,14,11
"['1101', '1000101', '1']",1,3,5,7,0,12,1.3772727272727274,12,14
"['1001110', '0', '1101', '001011', '111101']",1,5,9,15,2,24,5.205344655344655,38,24
"['0', '010', '111011', '1001011', '01010', '01100']",1,6,13,14,2,27,8.073631923631924,50,38
"['00001', '101011', '01111', '10', '1010011', '1101']",1,6,12,17,2,29,7.615717615717616,44,49
"['1101', '000100', '11111']",1,3,6,9,0,15,1.2484848484848485,11,6
"['0101', '011011', '0011', '10111', '1100100', '000', '11111', '0100011']",1,8,18,23,6,41,15.657875457875457,86,89
"['010100', '010', '0101', '001']",1,4,10,6,2,16,4.006349206349206,12,23
"['010100', '10111', '00', '110', '111101']",1,5,9,13,2,22,4.6377344877344875,32,22
"['00100', '0101', '101', '01100']",1,4,10,7,2,17,3.9904761904761905,12,16
"['101000', '1010011', '101110', '11']",1,4,9,12,2,21,3.6495726495726495,20,24
"['00111', '101', '01']",1,3,4,6,0,10,1.8714285714285714,7,7
"['10101', '100', '1', '00000']",1,4,9,5,2,14,2.4833333333333334,19,13
"['01', '001', '11']",1,3,3,4,2,7,1.7000000000000002,4,7
"['11011', '1000101', '011', '0110100', '0011', '10001', '010010', '0000', '1101']",1,9,24,21,7,45,21.62949272949273,99,97
"['100001', '011100', '1111']",1,3,7,9,2,16,1.5,11,4
"['00110', '00', '0001']",1,3,8,3,0,11,1.9047619047619047,7,13
"['0001', '010111', '000', '000010', '1011']",1,5,14,9,4,23,5.653968253968254,27,29
"['100000', '10010', '00001']",1,3,12,4,2,16,2.0545454545454547,7,11
"['11010', '011', '001000', '10110', '0111111', '1011', '11100', '1110']",1,8,15,24,5,39,16.70242535242535,78,85
"['01', '011010', '111010']",1,3,6,8,2,14,1.8333333333333335,9,11
"['00', '010000', '100011', '1101010']",1,4,13,8,2,21,3.341880341880342,22,13
"['1010', '01111', '000101', '11111']",1,4,7,13,2,20,3.197979797979798,17,18
"['101010', '0001', '1111', '010101', '000001', '011110']",1,6,16,16,6,32,7.283333333333333,46,37
"['1000011', '1', '01100']",1,3,7,6,0,13,1.0833333333333333,15,4
"['0', '1001010', '0100']",1,3,8,4,0,12,1.1954545454545453,12,8
"['011', '1100000', '0110', '010101', '011110']",1,5,13,13,2,26,6.325674325674326,34,34
"['010', '00101', '10', '1111']",1,4,6,8,0,14,3.1849206349206347,15,11
"['011', '001000', '101000', '1010100', '1011']",1,5,15,11,2,26,6.4450993450993455,27,35
"['0111111', '010101', '1', '1001111']",1,4,6,15,2,21,2.730769230769231,27,18
"['0', '01101', '01110']",1,3,5,6,2,11,1.4666666666666668,10,10
"['1010001', '1000', '00', '1']",1,4,9,5,0,14,2.4883838383838386,21,13
"['00100', '00', '10110', '111']",1,4,8,7,2,15,2.492857142857143,17,14
"['001', '0010111', '00', '110111', '010110']",1,5,11,13,2,24,5.688461538461539,32,29
"['1101001', '0010', '011100', '11', '10110', '1100', '01110']",1,7,15,18,4,33,12.778443778443778,59,57
"['011011', '00', '100101', '11010']",1,4,9,10,2,19,3.6926406926406927,18,11
"['0001', '110001', '10', '011100']",1,4,10,8,2,18,3.2,20,14
"['0010', '0101000', '11', '10', '0110001']",1,5,13,9,4,22,5.225829725829725,35,21
"['1000001', '010000', '11', '1101000', '1000', '000001', '011001']",1,7,25,13,5,38,12.402042402042403,66,69
"['1000', '11011', '111', '1110']",1,4,5,11,2,16,3.503968253968254,13,24
"['0100000', '010111', '101110', '00101']",1,4,13,11,2,24,3.5291375291375293,19,15
"['0101', '10', '0001000']",1,3,9,4,0,13,1.6565656565656566,11,6
"['0', '0111001', '010001', '1010100', '1010011', '1011']",1,6,16,16,3,32,8.332417582417582,55,40
"['0', '010111', '11']",1,3,3,6,0,9,0.7857142857142857,11,6
"['110010', '1000', '01100']",1,3,9,6,0,15,2.193939393939394,7,7
"['0', '001100', '00010', '0100100']",1,4,14,5,0,19,3.198884448884449,21,30
"['00101', '00011', '00', '0111', '000100', '11100']",1,6,16,11,3,27,8.547619047619047,44,58
"['11011', '0001110', '100', '1100011', '0101001', '1101010']",1,6,17,19,4,36,9.39047619047619,50,43
"['0', '1010001', '1001']",1,3,7,5,0,12,1.3772727272727274,12,7
"['001', '000011', '1001', '11101', '010110', '110', '01110']",1,7,15,17,6,32,12.625541125541126,59,53
"['11010', '10', '0011100', '011001']",1,4,10,10,0,20,3.679043179043179,22,13
"['0000101', '000101', '001101']",1,3,12,7,2,19,2.5256410256410255,4,19
"['100000', '001', '1100', '011110']",1,4,11,8,2,19,2.9936507936507937,22,15
"['1010110', '001101', '1111010', '00', '0111']",1,5,11,15,2,26,5.569175269175269,35,25
"['1', '001000', '00100', '10100', '1000']",1,5,15,6,2,21,5.922077922077922,25,39
"['00101', '011', '0011', '10101', '1101010']",1,5,11,13,2,24,7.358152958152958,22,29
"['01', '1001010', '11', '0001', '100110']",1,5,11,10,2,21,5.457420357420357,31,25
"['0001', '1001', '1011111', '0001100', '110101']",1,5,13,15,4,28,5.7911588411588415,33,30
"['001', '00001', '100', '1010', '10011', '000']",1,6,15,8,5,23,9.71111111111111,30,45
"['0100110', '111', '000011', '100101', '011001']",1,5,14,14,3,28,6.4854700854700855,31,22
"['10001', '000101', '111', '000010']",1,4,12,8,2,20,3.4545454545454546,18,13
"['1001110', '10111', '1000', '0100100', '1001001']",1,5,16,14,3,30,6.911976911976912,29,29
"['100', '1010101', '11']",1,3,5,7,0,12,1.4444444444444444,11,9
"['00010', '110', '1', '10000']",1,4,9,5,2,14,2.966666666666667,18,13
"['11000', '010', '11101', '110100']",1,4,9,10,2,19,3.903030303030303,14,15
"['010', '00111', '10000', '0011010', '110111', '10011', '0000', '0100']",1,8,22,17,5,39,16.134865134865134,81,87
"['0001101', '0101101', '010111', '0']",1,4,10,11,2,21,3.3351648351648353,21,20
"['0', '10111', '1111000', '0101', '0001000']",1,5,13,11,2,24,4.213852813852814,42,25
"['0001', '01001', '01111', '1110']",1,4,8,10,4,18,3.2944444444444443,15,17
"['1011', '10000', '111']",1,3,5,7,0,12,1.2658730158730158,8,11
"['101011', '000', '0111']",1,3,6,7,0,13,1.33015873015873,9,5
"['110000', '010', '011', '11101']",1,4,8,9,2,17,3.1010101010101008,19,14
"['1100011', '010', '1100', '000111']",1,4,10,10,0,20,3.3123765123765123,22,18
"['1011101', '00010', '110']",1,3,7,8,0,15,1.4333333333333333,11,5
"['0', '010001', '01000']",1,3,9,3,0,12,1.528138528138528,10,12
"['0', '011', '0101011', '0000111', '011010']",1,5,12,12,2,24,5.251282051282051,39,30
"['111', '10000', '1101100', '000', '1001001']",1,5,14,11,4,25,4.961904761904762,33,29
"['0', '110110', '0001']",1,3,6,5,0,11,1.0857142857142859,12,6
"['0101111', '1001', '0110', '11111']",1,4,6,14,2,20,2.9646464646464645,19,17
"['001', '0100010', '101011', '1111', '01010']",1,5,12,13,0,25,5.214230214230215,29,22
"['0', '101101', '1111', '1001101', '0101100', '0111110']",1,6,12,20,3,32,7.436913086913087,55,30
"['010000', '100', '0000000', '1010', '000001', '0101', '1110']",1,7,24,10,5,34,10.821484071484072,67,70
"['100100', '010', '11100']",1,3,8,6,0,14,1.712121212121212,8,8
"['101100', '11100', '01000']",1,3,9,7,2,16,2.2363636363636363,5,11
"['1011011', '110100', '0010101', '1001101']",1,4,12,15,3,27,4.274725274725275,17,19
"['0', '1100', '0111']",1,3,4,5,2,9,1.3,9,7
"['1100111', '100', '10010', '0011111']",1,4,9,13,2,22,3.630952380952381,24,18
"['00', '01111', '1', '0100']",1,4,6,6,0,12,2.13015873015873,18,13
"['00111', '00110', '1110010']",1,3,8,9,2,17,1.9666666666666668,10,12
"['010', '011100', '1010111', '00110', '0100011']",1,5,14,14,2,28,6.468481518481519,33,27
"['00', '10110', '100001', '0111']",1,4,9,8,0,17,3.016883116883117,19,11
"['101', '111000', '10']",1,3,5,6,0,11,1.7444444444444445,9,7
"['11', '10', '0001010', '1101', '011000']",1,5,11,10,2,21,5.3292152292152295,33,21
"['01', '1010', '1110', '00011']",1,4,7,8,2,15,2.96031746031746,16,14
"['01', '0111010', '10', '0000010', '000', '11100']",1,6,16,10,4,26,7.373015873015873,54,48
"['0001', '00', '01100']",1,3,8,3,0,11,1.6825396825396823,8,13
"['01', '100', '001']",1,3,5,3,2,8,1.8666666666666667,5,8
"['11000', '00110', '100', '01010']",1,4,11,7,3,18,4.0,15,18
"['111010', '11000', '100', '1111', '0001101', '10', '111101']",1,7,13,20,2,33,12.122760572760573,67,69
"['11011', '011', '10001', '1101000', '00110', '011001', '1100', '111101']",1,8,18,23,5,41,17.74058164058164,78,84
"['1100000', '1', '1110']",1,3,6,6,0,12,1.1954545454545453,13,7
"['01', '00', '10', '0110001']",1,4,8,5,3,13,2.833333333333333,19,14
"['11101', '0110', '0011010']",1,3,7,9,0,16,2.0606060606060606,8,5
"['010', '010000', '111', '0011', '0110', '010101', '1101']",1,7,15,15,7,30,12.622222222222222,52,56
"['1000100', '011', '10111', '00100', '0011']",1,5,13,11,2,24,6.119264069264069,28,32
"['101010', '110', '1001111', '00000']",1,4,11,10,0,21,2.5886169386169384,23,13
"['001100', '0110111', '101111']",1,3,7,12,2,19,1.8846153846153846,10,6
"['110010', '0100110', '1', '101', '1010', '000']",1,6,13,11,2,24,7.645637695637696,45,32
"['110011', '0001001', '1']",1,3,7,7,0,14,1.151098901098901,15,8
"['0010110', '1', '100010', '000', '1010000']",1,5,16,8,2,24,4.608424908424908,39,27
"['001', '100001', '1001101']",1,3,9,7,0,16,2.0358974358974358,9,14
"['1001110', '0', '010', '11', '1011111']",1,5,7,13,2,20,3.803174603174603,39,20
"['010000', '1101111', '1111', '1010000', '1011']",1,5,12,16,4,28,5.1229770229770235,36,39
"['100111', '010010', '11']",1,3,6,8,2,14,1.6666666666666665,11,6
"['1011011', '010', '001', '00101']",1,4,9,9,2,18,3.466666666666667,17,13
"['0', '01', '1110011', '111110', '11101']",1,5,6,15,0,21,4.977577977577978,36,28
"['01001', '1', '011']",1,3,4,5,0,9,1.5833333333333333,8,7
"['1011101', '1101', '100', '1111']",1,4,5,13,2,18,3.6616883116883114,16,24
"['0101110', '0110', '111111', '110', '101111']",1,5,7,19,2,26,5.970740370740371,29,32
"['111', '1110', '0010011']",1,3,5,9,0,14,1.6207792207792209,10,13
"['11000', '10100', '01101', '100001']",1,4,12,9,3,21,3.6363636363636362,15,15
"['101', '111010', '01010', '001000']",1,4,11,9,2,20,3.8156565656565657,16,13
"['111101', '001', '0111']",1,3,4,9,0,13,1.615873015873016,9,9
"['00100', '011101', '010111', '0011011', '0100']",1,5,14,14,2,28,6.415229215229215,27,35
"['101110', '01', '10001', '10']",1,4,7,8,2,15,3.188311688311688,19,17
"['0101111', '1000111', '10010', '111000', '1100', '01100', '0100']",1,7,19,19,6,38,13.273532023532024,68,65
"['01', '001111', '1101101', '1101100', '100011']",1,5,11,17,4,28,5.7203907203907205,36,34
"['01', '0010', '01111', '10', '0000011', '0100011']",1,6,15,12,4,27,7.638528138528138,53,41
"['0011', '100', '00', '011010', '1111011']",1,5,10,12,0,22,5.587823287823288,34,26
"['001000', '01110', '0110011']",1,3,10,8,0,18,1.6736596736596736,9,10
"['11010', '001', '1', '00101', '100011']",1,5,10,10,2,20,5.05995670995671,32,26
"['001001', '0011101', '000111', '111011']",1,4,11,14,3,25,3.9743589743589745,17,20
"['011', '010110', '0100', '00011']",1,4,10,8,0,18,3.9598124098124097,14,21
"['0', '0000100', '01100', '1110']",1,4,11,6,0,17,2.68030303030303,23,21
"['0110', '01100', '11']",1,3,5,6,0,11,2.126984126984127,6,7
"['00011', '011011', '0000001', '010101', '01011', '1001011']",1,6,19,17,6,36,9.624841824841825,35,54
"['111010', '011100', '111', '0110', '1110100', '1110']",1,6,11,19,4,30,10.91027306027306,35,59
"['1001', '11100', '11']",1,3,4,7,0,11,1.9047619047619047,8,10
"['01', '010001', '110']",1,3,6,5,0,11,1.3444444444444446,10,8
"['000110', '010', '000000']",1,3,12,3,2,15,1.7777777777777777,9,17
"['1010010', '10', '0100', '1111']",1,4,8,9,2,17,2.967171717171717,20,12
"['110110', '101100', '111100', '001101']",1,4,10,14,4,24,4.166666666666667,13,18
"['0101101', '101000', '1111']",1,3,7,10,0,17,1.5608391608391607,10,6
"['0001110', '001111', '1', '0101101', '1010']",1,5,11,14,2,25,4.929370629370629,38,20
"['010', '010101', '101111']",1,3,6,9,2,15,1.7777777777777777,10,6
"['0010', '100', '1010101', '0101100', '110']",1,5,13,11,4,24,5.814718614718615,30,24
"['001', '1', '1110000', '110']",1,4,7,7,2,14,2.5833333333333335,22,14
"['0', '01', '0111']",1,3,3,4,0,7,1.7333333333333334,6,7
"['11011', '1', '0010100']",1,3,6,7,0,13,1.0833333333333333,14,4
"['001', '0010111', '101', '11000', '1011', '110']",1,6,11,14,3,25,8.688383838383839,43,46
"['11001', '1000', '10010', '000', '1011']",1,5,12,9,4,21,6.359523809523809,20,27
"['0010111', '00000', '101010', '101', '0011', '111011', '01110']",1,7,17,19,4,36,11.575430125430126,64,54
"['0111000', '100', '10010']",1,3,9,6,0,15,2.0166666666666666,10,9
"['1', '00101', '00100', '1010101', '111101']",1,5,11,13,2,24,4.706343656343656,34,31
"['0', '1110001', '100101', '010110', '0110110', '1110']",1,6,14,17,4,31,8.105328005328005,56,39
"['101', '10001', '1001', '001111']",1,4,8,10,0,18,4.085930735930736,16,26
"['00100', '010101', '1001011']",1,3,10,8,0,18,2.163170163170163,8,4
"['10000', '0111', '11']",1,3,5,6,0,11,1.1746031746031744,10,8
"['1000001', '11010', '011', '100101', '000', '0101001']",1,6,18,13,4,31,8.516650016650017,48,36
"['00011', '001', '011110', '11']",1,4,7,9,0,16,3.211327561327561,18,13
"['110000', '01101', '1011100']",1,3,9,9,0,18,1.8275058275058274,10,7
"['011', '0111011', '0011001', '1001', '0101', '11100']",1,6,13,17,4,30,9.582756132756133,43,44
"['001', '0110111', '101101', '1110101', '001010', '01010', '1001100', '1111011']",1,8,20,28,6,48,17.74161394161394,87,74
"['01', '110101', '101110', '1011000']",1,4,9,12,2,21,3.3290598290598292,22,16
"['001', '10110', '110100', '1010', '1000', '1100101', '0100001', '101110', '1110']",1,9,23,23,7,46,22.024791874791873,97,103
"['00110', '1101110', '000', '1010011']",1,4,11,11,2,22,3.5976190476190477,21,15
"['0010111', '00101', '1100100', '1101', '101110']",1,5,13,16,2,29,6.387046287046287,31,32
"['00111', '10000', '01000']",1,3,10,5,3,15,1.6,10,10
"['110011', '1011', '01001', '0110']",1,4,8,11,2,19,4.210606060606061,14,14
"['0101000', '1110000', '100100', '100101', '0000', '101111']",1,6,21,15,5,36,9.112654012654012,48,50
"['1010', '111', '01000']",1,3,6,6,0,12,1.4880952380952381,8,4
"['1100', '1', '010000']",1,3,7,4,0,11,1.2857142857142856,11,5
"['10110', '010010', '1111', '00', '110', '001011']",1,6,12,14,2,26,7.547402597402598,45,39
"['0', '0010010', '010110', '1001010']",1,4,13,8,2,21,3.0384615384615383,24,22
"['110010', '1100001', '1000', '111111', '100011', '10', '110', '0110011']",1,8,18,23,5,41,16.373398823398823,89,96
"['0001', '1001', '0011101', '111']",1,4,8,10,2,18,3.298051948051948,17,19
"['010100', '101100', '0110111', '011', '0110110']",1,5,13,16,4,29,6.993040293040293,29,37
"['1010111', '00', '0111']",1,3,5,8,0,13,1.505050505050505,11,7
"['101', '10001', '1001', '101011', '10']",1,5,9,11,0,20,7.228066378066378,21,48
"['0001001', '011', '10', '1001100', '1100']",1,5,13,10,2,23,5.571139971139971,35,27
"['111', '10000', '10', '1000011', '11100']",1,5,11,11,2,22,5.32063492063492,31,36
"['0', '11101', '111011']",1,3,3,9,0,12,1.528138528138528,10,9
"['010', '011100', '0110', '1111', '10']",1,5,8,11,2,19,6.0095238095238095,24,27
"['01', '0011001', '100', '0011111', '1101']",1,5,10,13,2,23,5.332178932178932,35,29
"['0111001', '111', '0001', '0011111', '10', '101110']",1,6,11,18,2,29,7.824009324009324,54,39
"['010', '1', '00001', '1011101', '100']",1,5,10,9,2,19,4.783333333333333,34,21
"['011', '00111', '101', '01111', '000', '0101001']",1,6,12,14,5,26,8.15,42,39
"['11001', '110000', '0010', '101011', '10']",1,5,12,11,2,23,5.329004329004329,30,26
"['0', '0101110', '11', '0001', '0101011']",1,5,10,11,2,21,3.5637806637806637,39,23
"['0', '100', '001011']",1,3,6,4,0,10,1.2301587301587302,11,7
"['1', '110111', '001000']",1,3,6,7,2,13,0.9047619047619047,15,4
"['11011', '1001010', '1010', '010110', '000111']",1,5,13,15,2,28,6.584615384615384,27,26
"['00100', '11010', '111101']",1,3,7,9,2,16,1.690909090909091,9,5
"['00', '0100111', '100', '011']",1,4,8,7,2,15,3.1777777777777776,19,16
"['001', '010', '1']",1,3,4,3,2,7,1.6666666666666665,6,4
"['1001', '000', '11']",1,3,5,4,0,9,1.2380952380952381,7,4
"['1110010', '001000', '0001', '000', '1000011']",1,5,18,9,2,27,6.398734598734599,32,32
"['00111', '0011', '1000101', '10']",1,4,9,9,0,18,3.346320346320346,19,17
"['01', '1000', '010', '001011']",1,4,9,6,0,15,3.2714285714285714,17,14
"['0001', '0010', '0000']",1,3,10,2,3,12,2.25,4,15
"['0100111', '00101', '000011', '101', '1111011']",1,5,12,16,2,28,5.89058164058164,33,32
"['000110', '0100110', '101', '111011', '0000101', '01110', '0100']",1,7,20,18,4,38,12.383805083805084,64,59
"['11', '001', '01110', '1111011']",1,4,5,12,0,17,2.9825396825396826,21,14
"['0101', '00', '0111111', '000110']",1,4,9,10,0,19,2.9958818958818956,23,17
"['000110', '01101', '011', '0001', '1101']",1,5,11,11,2,22,6.52012987012987,23,29
"['11000', '10001', '1001', '0101', '110', '1101010']",1,6,14,14,4,28,10.164069264069264,36,45
"['101', '10110', '001100']",1,3,7,7,0,14,1.9217171717171717,8,6
"['0111000', '00001', '0100010', '0110', '010101', '111000', '0001000', '1011111']",1,8,28,21,6,49,16.79166389166389,90,95
"['1001100', '00', '111000']",1,3,9,6,0,15,1.7136752136752138,12,11
"['1000', '1', '110101']",1,3,5,6,0,11,1.2857142857142856,11,8
"['001', '11', '10111', '1010111', '000000', '110']",1,6,12,14,2,26,6.338716838716839,55,46
"['0', '011', '0011001', '011010', '101111']",1,5,10,13,2,23,5.306043956043956,37,21
"['0001', '010', '001000']",1,3,10,3,0,13,1.838095238095238,8,11
"['1000011', '1110011', '001011']",1,3,9,11,2,20,1.9450549450549453,7,17
"['010', '011100', '000101', '10', '1100']",1,5,12,9,2,21,6.071428571428571,28,29
"['101', '100', '1001011', '0101', '101001']",1,5,11,12,2,23,6.771228771228771,25,38
"['11110', '010', '1011001', '11', '100']",1,5,8,12,2,20,5.349206349206349,31,22
"['1001001', '01111', '10']",1,3,6,8,0,14,1.2301587301587302,13,7
"['01000', '01', '101100', '101001']",1,4,11,8,2,19,3.8593073593073592,17,15
"['1100', '100', '0110', '001010']",1,4,10,7,2,17,4.245238095238095,13,19
"['0010', '10', '011', '011000']",1,4,9,6,0,15,3.4047619047619047,16,18
"['111', '101', '0110000', '1011011', '1110', '0110011']",1,6,12,19,5,31,9.256277056277057,49,48
"['0010', '1', '00110', '110111', '011010']",1,5,10,12,2,22,5.333044733044733,32,22
"['0001', '1', '0011000']",1,3,8,4,0,12,1.1954545454545453,13,7
"['1000011', '1101', '0010']",1,3,8,7,2,15,1.5909090909090908,11,5
"['00001', '00111', '000010', '110', '1110']",1,5,13,10,2,23,5.395021645021645,29,34
"['01001', '0001110', '111']",1,3,7,8,0,15,1.7666666666666666,11,4
"['1011101', '0001', '010', '00']",1,4,9,7,0,16,3.2461760461760463,18,13
"['0', '101000', '001', '0100111']",1,4,10,7,0,17,2.6955433455433457,25,13
"['100101', '101', '1111101', '0']",1,4,6,11,0,17,2.9177655677655676,23,19
"['0', '01001', '0111111', '100000']",1,4,10,9,0,19,2.0683483183483182,28,13
"['1001', '111', '1110', '0100']",1,4,6,9,3,15,3.4642857142857144,13,14
"['111', '00100', '0001', '1001000', '1000011', '110', '1110']",1,7,18,15,6,33,10.568253968253968,68,61
"['00100', '00110', '10110', '10']",1,4,10,7,3,17,3.914285714285714,13,23
"['0010110', '1110010', '1']",1,3,7,8,2,15,1.0714285714285714,15,5
"['1001', '010111', '011']",1,3,5,8,0,13,1.838095238095238,8,8
"['1', '111010', '11101', '010110', '0010010']",1,5,11,14,2,25,5.188561438561439,36,24
"['101', '0011101', '001001', '000']",1,4,11,8,2,19,3.635897435897436,18,20
"['0001100', '10111', '100101', '011']",1,4,10,11,0,21,3.6775058275058274,18,12
"['001100', '10', '0111']",1,3,6,6,0,12,1.4333333333333333,10,6
"['0', '0110001', '10000', '0111']",1,4,10,7,0,17,2.5994949494949493,23,14
"['001101', '00001', '00000', '0110', '110011', '0111111', '10', '11111']",1,8,18,22,5,40,13.374469974469974,97,79
"['000100', '1110010', '011', '0011001', '10', '0000', '0101']",1,7,20,13,4,33,11.92054612054612,68,58
"['1001', '10110', '1']",1,3,4,6,0,10,1.4,9,9
"['000110', '01', '10010']",1,3,8,5,0,13,1.7987012987012987,9,7
"['0', '000100', '110111', '11']",1,4,7,8,2,15,1.6547619047619047,25,12
"['1101101', '101001', '0101000']",1,3,10,10,2,20,2.10989010989011,7,5
"['001', '1', '1101000', '010111', '000', '01100']",1,6,14,11,2,25,6.5982628482628485,52,41
"['0110101', '1', '00101']",1,3,6,7,0,13,1.4166666666666667,12,9
"['01101', '010', '1', '00100', '10011', '000010']",1,6,15,10,3,25,8.07056277056277,45,31
"['111110', '10', '0111']",1,3,3,9,0,12,1.4333333333333333,10,9
"['010', '011', '11', '00', '0101']",1,5,7,7,4,14,6.114285714285714,15,24
"['0', '1101001', '0110100', '00110', '0110110']",1,5,14,13,3,27,5.345238095238095,37,32
"['00111', '001', '10000', '000']",1,4,11,5,4,16,3.5666666666666664,15,24
"['0010001', '0001110', '100011', '1']",1,4,12,9,2,21,2.8956043956043955,27,11
"['10101', '1001', '110', '0000']",1,4,9,7,2,16,3.1904761904761902,13,12
"['0', '0100000', '1011110']",1,3,9,6,2,15,0.9285714285714286,17,8
"['0', '110010', '1001']",1,3,6,5,0,11,1.4857142857142858,10,4
"['0101', '001110', '00101', '0000']",1,4,12,7,2,19,3.9828282828282826,13,23
"['000111', '110', '10']",1,3,5,6,0,11,1.4944444444444445,10,8
"['1001001', '010011', '1']",1,3,7,7,0,14,1.304945054945055,14,8
"['001000', '11', '10', '000', '01000', '0111100']",1,6,16,9,2,25,7.403840603840604,48,55
"['0001001', '11110', '11011', '110011', '1000', '00']",1,6,14,15,2,29,7.72014652014652,51,44
"['1110110', '0010101', '11']",1,3,6,10,2,16,1.4603174603174602,14,8
"['0011001', '100', '11']",1,3,6,6,0,12,1.4444444444444444,11,7
"['100110', '1000', '10011']",1,3,8,7,0,15,2.375757575757576,5,14
"['0010', '0111001', '111', '00000', '0011110', '0101']",1,6,16,14,4,30,8.011327561327562,50,39
"['0', '1111010', '11110', '111000']",1,4,7,12,0,19,3.198884448884449,21,21
"['00001', '001', '10000', '0100']",1,4,13,4,2,17,3.7325396825396826,13,22
"['01', '101', '100010', '0111', '0000', '0011011']",1,6,14,12,2,26,8.206365856365856,47,34
"['0011101', '001000', '1010', '0000', '110', '1110']",1,6,16,12,3,28,8.042296592296593,42,48
"['11011', '011', '100111', '0100001', '0100']",1,5,12,13,0,25,6.202469752469752,30,29
"['11110', '1010', '001']",1,3,5,7,0,12,1.2658730158730158,8,7
"['0010001', '1001', '00110', '001011', '101111']",1,5,14,14,2,28,6.2489510489510485,28,29
"['01', '0110100', '101101', '1111', '0000', '000111']",1,6,14,15,4,29,7.271484071484071,52,39
"['001', '0110100', '11', '00100', '0000', '01000']",1,6,18,8,2,26,7.856493506493506,41,59
"['101', '0110010', '000', '11']",1,4,8,7,2,15,2.7777777777777777,19,8
"['0010001', '01', '100010', '10100', '1001111']",1,5,15,12,2,27,5.628482628482629,36,26
"['0010', '0001', '000101']",1,3,10,4,2,14,2.35,6,12
"['0101101', '110011', '00', '100000', '010111']",1,5,14,13,3,27,5.444444444444445,35,26
"['00', '01011', '011001']",1,3,7,6,0,13,1.6168831168831168,9,7
"['0100000', '001000', '100', '000101', '1111011']",1,5,18,11,4,29,5.063492063492063,38,30
"['01', '1001', '1111000', '00', '111111', '111000', '110']",1,7,12,18,4,30,10.166455766455766,71,66
"['000110', '00010', '000101', '000']",1,4,15,5,2,20,4.734848484848484,12,41
"['01', '00111', '0011', '100110', '111000']",1,5,11,12,2,23,6.016378066378066,33,29
"['0111', '000010', '00001']",1,3,10,5,0,15,1.7535353535353535,8,10
"['11010', '101', '1001', '000101', '00110']",1,5,12,11,2,23,6.579870129870129,25,25
"['011101', '100001', '011']",1,3,7,8,2,15,1.4444444444444444,11,9
"['1101101', '1', '111010', '1011100']",1,4,7,14,2,21,3.0384615384615383,26,15
"['110110', '11110', '11', '101', '1010101', '1000111', '000']",1,7,13,20,4,33,10.832450882450882,69,64
"['0', '10101', '0100', '1111']",1,4,6,8,2,14,2.3166666666666664,18,8
"['01', '110010', '11', '10000', '11100']",1,5,10,10,4,20,4.9831168831168835,30,26
"['01', '01001', '010001', '1101100']",1,4,11,9,0,20,3.707015207015207,21,21
"['010001', '1', '011', '00110', '01011']",1,5,10,10,2,20,5.691774891774892,30,24
"['1011', '11110', '1001', '11111']",1,4,4,14,4,18,3.3277777777777775,12,28
"['0010110', '01', '10', '0000', '111000', '1100']",1,6,15,10,4,25,7.593667443667443,50,45
"['1', '100', '010111', '011110', '0000']",1,5,10,10,2,20,3.9984126984126984,36,21
"['0', '01111', '1011100']",1,3,5,8,0,13,1.25,13,6
"['001', '1101111', '01000', '01010', '11111', '1011', '00010', '01110', '1110']",1,9,18,25,7,43,18.985425685425685,98,103
"['001', '0111010', '11', '1000', '11100', '01110']",1,6,12,14,2,26,8.415295815295815,44,38
"['1100001', '110001', '00', '010111', '10', '0110010']",1,6,16,14,6,30,8.107448107448107,54,37
"['010000', '101', '1010111', '000', '0101']",1,5,13,10,2,23,5.661827061827061,31,26
['0000100'],1,1,6,1,0,7,0,0,0
"['0110011', '101', '0001', '1100000', '01111', '10000', '0110', '1000', '0100']",1,9,25,18,8,43,20.64249639249639,109,106
"['0', '111100', '11000', '101', '100111']",1,5,9,12,2,21,4.788600288600288,36,24
"['001', '111', '000', '011111', '0100001']",1,5,11,11,3,22,4.394871794871794,35,27
"['11000', '10100', '1001000', '000']",1,4,14,6,2,20,4.316666666666666,14,28
"['010', '00100', '1111', '10100', '0001010', '01001', '110', '01011']",1,8,20,17,6,37,16.676334776334777,73,78
"['01010', '100011', '000011', '00000']",1,4,15,7,4,22,3.796969696969697,14,20
"['1101001', '001', '000011', '11', '1010100', '00110', '000']",1,7,19,14,4,33,11.001143301143301,69,62
"['010', '0010000', '000011', '0100010', '11111', '01100', '010110', '0000', '0101', '0110110']",1,10,32,22,9,54,26.89194139194139,134,177
"['1100', '010', '1', '001101']",1,4,7,7,0,14,3.0238095238095237,18,11
"['0101111', '1', '1010100', '00', '000001']",1,5,13,10,2,23,3.3614163614163615,45,23
"['11001', '11110', '0010', '01110']",1,4,8,11,3,19,3.7777777777777777,15,16
"['00111', '0000100', '1110']",1,3,9,7,0,16,1.5303030303030303,12,10
"['0101', '111000', '0110001', '01010']",1,4,12,10,0,22,3.9975135975135974,16,18
"['01101', '11', '001', '0000']",1,4,8,6,0,14,2.4873015873015873,16,13
"['00', '111110', '010']",1,3,5,6,0,11,1.4944444444444445,10,9
"['01101', '001101', '101', '00', '100101', '01011', '111001']",1,7,15,18,5,33,13.324675324675324,57,65
"['1000', '01011', '11']",1,3,5,6,0,11,1.349206349206349,9,8
"['0001', '010111', '000000', '0110011']",1,4,14,9,2,23,2.983682983682984,19,18
"['010100', '1', '000', '1010011', '0001011']",1,5,14,10,2,24,4.186202686202686,40,25
"['0010', '00000', '0100010', '11', '10001', '1011', '010011']",1,7,20,13,4,33,11.87096237096237,60,51
"['01', '010001', '10']",1,3,6,4,2,10,1.5,10,8
"['0', '0010', '1010110', '00101', '0111100']",1,5,13,11,2,24,4.602741702741703,37,32
"['0', '10001', '0100100']",1,3,9,4,0,13,1.25,13,4
"['111011', '11100', '11']",1,3,3,10,0,13,1.7987012987012987,9,18
"['0', '000011', '100111', '01010', '01001', '0110110']",1,6,16,14,4,30,8.077139527139527,51,36
"['0001001', '100', '1111']",1,3,7,7,0,14,1.2493506493506494,12,7
"['001', '001011', '10011', '0101100', '01011']",1,5,13,13,2,26,6.855594405594406,25,34
"['0', '01', '0110']",1,3,4,3,0,7,1.7333333333333334,6,9
"['0100010', '0001001', '011011']",1,3,12,8,2,20,1.9450549450549453,9,7
"['0100111', '101', '1011101', '000101', '0000000', '1010', '1100111', '0100011']",1,8,25,23,5,48,16.04229104229104,94,84
"['101011', '1000', '100']",1,3,7,6,0,13,2.123809523809524,7,11
"['0', '10100', '010', '01100']",1,4,9,5,2,14,3.466666666666667,16,21
"['101100', '00000', '10010', '110', '0101001']",1,5,16,10,2,26,5.094988344988345,30,24
"['1110011', '010', '010001']",1,3,8,8,0,16,1.682051282051282,11,6
"['011111', '1011011', '00101']",1,3,6,12,0,18,1.8146853146853146,8,7
"['1000100', '000110', '0010000', '1000110', '00110', '010101', '1100']",1,7,27,15,5,42,14.412287712287712,60,82
"['101', '110', '1110']",1,3,3,7,2,10,2.095238095238095,5,9
"['01111', '01', '10010', '11010']",1,4,7,10,3,17,3.314285714285714,17,16
"['010100', '110110', '001', '01111', '00', '10', '010011']",1,7,15,15,5,30,10.963347763347763,65,57
"['1100010', '0010011', '110111', '111000', '0111100']",1,5,15,18,5,33,6.06043956043956,35,32
"['010000', '11000', '10110', '00', '1000', '111110']",1,6,16,12,4,28,8.793867243867243,43,49
"['001011', '1', '01011']",1,3,5,7,0,12,1.528138528138528,10,10
"['01', '00110', '11100']",1,3,6,6,2,12,1.457142857142857,10,7
"['0', '101', '0001']",1,3,5,3,0,8,1.4714285714285715,7,5
"['0110', '0111', '11']",1,3,3,7,2,10,2.083333333333333,5,8
"['0', '100111', '011111', '111101']",1,4,5,14,3,19,2.857142857142857,23,17
"['0', '0100010', '1111', '00110', '111001']",1,5,11,12,0,23,4.304634254634254,39,21
"['11110', '0010111', '10', '01010']",1,4,8,11,2,19,3.153968253968254,20,17
"['01', '111', '100', '10010', '110']",1,5,7,9,3,16,5.188095238095238,20,25
"['1100001', '1101', '0000', '1100111', '001100', '0110010', '001001']",1,7,23,18,7,41,13.844372294372295,64,58
"['0011', '10101', '1001', '0111']",1,4,7,10,3,17,4.222222222222222,11,17
"['11001', '0100000', '01101', '011011', '111011', '100000']",1,6,18,17,5,35,8.992307692307692,44,48
"['1101001', '011100', '00100', '11101', '101111']",1,5,12,17,4,29,6.176223776223776,27,24
"['010100', '011', '111', '101', '00', '110']",1,6,9,11,4,20,7.922222222222222,35,34
"['100110', '10', '1011100']",1,3,7,8,0,15,1.4059829059829059,11,10
"['010', '00001', '0101101', '011011', '1001000']",1,5,16,12,2,28,5.3658341658341655,34,27
"['000100', '0100111', '000001']",1,3,13,6,2,19,1.8974358974358974,8,9
"['0110101', '0', '1110010', '010011', '1111', '110011', '011001', '01001', '011010']",1,9,21,27,6,48,21.606016206016207,102,114
"['00', '011', '0101001', '11']",1,4,7,7,2,14,2.688888888888889,19,13
"['111', '00000', '00111', '1111110', '00110', '1110100']",1,6,14,18,5,32,7.321428571428571,53,59
"['01', '10', '1101100', '1111']",1,4,5,10,2,15,2.782828282828283,21,14
"['010', '00111', '00', '1000', '1100011', '1100']",1,6,14,11,2,25,8.952164502164502,43,44
"['00011', '01110', '0000']",1,3,9,5,2,14,1.711111111111111,8,12
"['0100000', '00001', '101', '0110', '0100']",1,5,16,7,2,23,5.621139971139971,29,31
"['0001100', '00', '100', '111']",1,4,9,6,2,15,2.577777777777778,20,19
"['1100000', '001111', '11']",1,3,7,8,0,15,1.2521367521367521,15,12
"['1', '10110', '0010100', '0001100', '001110']",1,5,15,11,2,26,5.575258075258075,35,32
"['110001', '011', '0111011']",1,3,6,10,0,16,1.6598290598290597,11,12
"['110011', '100', '000011']",1,3,8,7,2,15,1.7777777777777777,9,11
"['01', '10011', '111011']",1,3,4,9,0,13,1.7987012987012987,9,11
"['00', '1101110', '01000', '011001']",1,4,11,9,0,20,3.3585303585303583,22,17
"['0', '101', '101001']",1,3,5,5,0,10,1.4523809523809523,10,7
"['1010', '10110', '111', '0000']",1,4,8,8,2,16,2.9047619047619047,14,13
"['010', '011', '111', '000101', '00', '1100101']",1,6,12,12,3,24,8.158119658119658,43,38
"['0', '11110', '1100', '0101', '11100']",1,5,8,11,4,19,5.211111111111111,26,27
"['101', '00010', '1', '10000']",1,4,9,5,2,14,2.966666666666667,18,13
"['11101', '100011', '111010', '1110']",1,4,7,14,2,21,3.8616161616161615,14,28
"['101', '1111000', '100011', '0111', '01010', '1110', '0100']",1,7,15,18,3,33,12.35997335997336,61,54
"['001', '100001', '0011', '1100000', '10010', '10', '0101']",1,7,19,12,2,31,12.334887334887334,61,56
"['01001', '0110', '1']",1,3,5,5,0,10,1.4,9,5
"['0', '110', '10110']",1,3,4,5,0,9,1.5833333333333333,8,8
"['01', '010000', '1111101', '111', '0011001']",1,5,11,14,2,25,4.705616605616606,40,27
"['01', '111110', '110']",1,3,3,8,0,11,1.3166666666666667,10,9
"['011', '010010', '11']",1,3,5,6,0,11,1.9666666666666668,8,7
"['1000001', '0010110', '010', '1110']",1,4,12,9,2,21,3.090909090909091,23,14
"['01101', '00101', '0011001', '101', '01001', '1100']",1,6,15,14,3,29,10.426479076479076,32,50
"['1001001', '00', '010']",1,3,8,4,0,12,1.8444444444444446,10,4
"['1101001', '000010', '01010']",1,3,11,7,0,18,1.6736596736596736,9,6
"['1000001', '001', '1', '00001']",1,4,11,5,0,16,3.2666666666666666,20,23
"['101100', '00000', '00100', '1001', '001100']",1,5,18,8,4,26,6.671717171717171,23,45
"['1000001', '101', '1010010']",1,3,10,7,2,17,1.7714285714285714,11,13
"['0', '1110110', '001010', '1101']",1,4,8,10,0,18,2.8783716283716285,23,12
"['1110101', '0101010', '10100', '0000111', '0011100']",1,5,17,16,4,33,6.357142857142857,35,26
"['1010111', '010', '0110100']",1,3,8,9,2,17,1.7714285714285714,12,5
"['11001', '111', '0011', '0110000', '000']",1,5,12,10,2,22,5.271645021645021,32,28
"['0', '100001', '011100', '101000', '1100', '101110']",1,6,16,13,4,29,8.176190476190476,50,37
"['11', '100', '0111', '00011']",1,4,6,8,0,14,3.09047619047619,15,18
"['01101', '101', '011001', '0000']",1,4,10,8,0,18,3.455916305916306,15,17
"['0', '01', '11100']",1,3,4,4,0,8,1.2857142857142856,9,6
"['0001100', '111', '01110']",1,3,7,8,0,15,1.8166666666666667,10,4
"['11001', '101010', '01110', '0']",1,4,8,9,2,17,2.643290043290043,21,11
"['110010', '001', '10', '010010']",1,4,10,7,2,17,3.5666666666666664,17,18
"['10000', '001', '0111110', '0000000']",1,4,15,7,2,22,2.585714285714286,26,23
"['0010001', '11110', '0011', '1010', '11111', '0010010']",1,6,15,17,6,32,7.813708513708513,48,49
"['01', '110010', '000010', '0100011', '110']",1,5,14,10,2,24,5.406837606837607,34,30
"['0010', '0000011', '11']",1,3,8,5,0,13,1.323232323232323,12,7
"['101010', '001011', '0111', '111001']",1,4,9,13,3,22,3.6333333333333333,16,16
"['00110', '0110100', '10', '1101']",1,4,9,9,0,18,3.743145743145743,19,12
"['010100', '01', '010', '1010011']",1,4,10,8,0,18,3.7803418803418802,20,14
"['11110', '0000100', '111', '0110', '1101']",1,5,10,13,2,23,5.704329004329004,31,25
"['1000011', '10100', '11001']",1,3,9,8,2,17,1.9666666666666668,8,10
"['111', '111011', '1010000', '0110110', '110101']",1,5,11,18,4,29,6.353479853479854,33,30
"['00', '11011', '1111101']",1,3,4,10,0,14,1.1746031746031744,13,6
"['0010', '0011101', '100010', '0111', '0111100']",1,5,14,14,4,28,6.036663336663337,32,32
"['0110000', '01', '0111010', '1010110']",1,4,12,11,3,23,3.1904761904761902,24,19
"['1000', '01101', '11']",1,3,5,6,0,11,1.349206349206349,9,6
"['110110', '010', '100001', '00000', '01001', '101110', '01100']",1,7,21,15,6,36,12.261616161616162,61,55
"['1110001', '00010', '000010']",1,3,12,6,0,18,2.191142191142191,9,10
"['0010110', '01', '110011', '001110', '000', '110']",1,6,14,13,4,27,8.427350427350428,49,45
"['101', '01', '111011']",1,3,3,8,0,11,1.9666666666666668,8,9
"['011011', '0101100', '000']",1,3,9,7,0,16,1.45982905982906,11,11
"['11011', '010', '101', '1000', '10011', '011111', '1110110']",1,7,12,21,4,33,12.107425907425908,60,59
"['1100001', '0001', '1110100']",1,3,10,8,2,18,1.8051948051948052,11,11
"['11', '101010', '1101101', '0110', '1000']",1,5,10,13,2,23,5.6864024864024865,31,22
"['101', '1110011', '1', '1001011']",1,4,6,12,2,18,2.914285714285714,25,28
"['0010001', '0111001', '11', '101011', '0110', '111011', '00110', '01010']",1,8,19,23,6,42,17.530636030636032,82,73
"['001', '1000101', '1110101', '0111', '0011011']",1,5,12,16,3,28,6.132467532467532,33,33
"['1100', '001011', '1']",1,3,5,6,0,11,1.0857142857142859,12,8
"['0101111', '1', '00000', '0111111', '0100']",1,5,11,13,2,24,3.4678210678210677,43,27
"['0', '111111', '0001']",1,3,4,7,0,11,0.6000000000000001,14,4
"['100', '10', '000', '01000']",1,4,10,3,2,13,3.9380952380952383,11,22
"['0', '11000', '1100101', '1001010']",1,4,11,9,2,20,3.1904761904761902,23,13
"['10110', '010101', '000001', '10011', '0110010']",1,5,16,13,4,29,5.725407925407925,29,22
"['1110010', '1101111', '10001', '001010', '1010011']",1,5,14,18,3,32,6.071095571095571,31,29
"['0001010', '010', '111000', '11']",1,4,10,8,0,18,2.8504273504273505,23,16
"['001100', '100', '0000']",1,3,10,3,0,13,2.038095238095238,7,17
"['11110', '1100', '111', '01000']",1,4,7,10,2,17,3.3047619047619046,15,18
"['00100', '0010010', '001101', '01000']",1,4,16,7,2,23,4.508624708624708,13,32
"['0011', '0001', '010101', '10']",1,4,9,7,2,16,2.9166666666666665,15,14
"['1011', '11110', '001000']",1,3,7,8,0,15,1.208080808080808,10,5
"['01', '0011101', '100001', '111010', '10']",1,5,11,12,4,23,5.119658119658119,39,25
"['0', '10101', '110101', '01011', '01000', '1011111']",1,6,12,17,3,29,7.999583749583749,50,37
"['111100', '0001110', '10', '11111']",1,4,7,13,0,20,3.0728160728160727,23,18
"['11101', '1', '100111']",1,3,3,9,0,12,1.1645021645021645,12,14
"['001', '0011', '00', '10', '11111']",1,5,7,9,2,16,4.537301587301587,26,26
"['0', '100110', '10001', '0011']",1,4,9,7,0,16,3.212987012987013,18,12
"['00100', '10101', '01111', '1101', '111011', '1110110', '111001']",1,7,13,25,5,38,13.311499611499611,51,75
"['0010', '110111', '010110']",1,3,7,9,2,16,1.6666666666666665,8,5
"['01', '1101', '01110', '0000']",1,4,8,7,2,15,2.9325396825396823,17,12
"['0010', '1010110', '1', '111010', '100', '01110']",1,6,12,14,0,26,7.928588078588079,46,38
"['0', '1111100', '00110']",1,3,6,7,0,13,1.0833333333333333,14,9
"['101', '01', '0111', '00001']",1,4,7,7,0,14,3.5539682539682538,14,16
"['10111', '10011', '1011000']",1,3,7,10,2,17,1.9666666666666668,8,14
"['0', '001001', '11', '000100', '01011']",1,5,12,8,2,20,4.332251082251082,35,22
"['101100', '1011010', '110', '010010', '0100001', '0101', '1100']",1,7,20,17,6,37,13.24960594960595,59,63
"['01', '100', '000001', '000', '0111']",1,5,12,6,2,18,4.715873015873016,28,29
"['1010', '010', '100011']",1,3,7,6,0,13,1.9015873015873015,8,7
"['11', '10000', '00', '10', '110101']",1,5,9,8,3,17,4.474025974025974,29,23
['0111110'],1,1,2,5,0,7,0,0,0
"['1110111', '01010', '0110011']",1,3,7,12,2,19,1.880952380952381,9,7
"['011101', '010000', '1', '000000']",1,4,13,6,3,19,2.071428571428571,24,17
"['1000101', '011011', '11000', '1111', '1101100', '10', '000000', '0100101', '1110']",1,9,24,24,7,48,19.026628926628927,121,101
"['101', '110', '1100101']",1,3,5,8,2,13,1.8666666666666667,10,12
"['0001', '00', '011']",1,3,6,3,0,9,1.638095238095238,6,8
"['0010', '010', '0001101', '1011', '1111111']",1,5,10,15,4,25,4.975324675324675,36,21
"['0', '1001', '10110']",1,3,5,5,0,10,1.4,9,5
"['0', '00010', '100111']",1,3,7,5,0,12,1.1645021645021645,12,4
"['0010', '0001', '1101101', '1111000', '1000', '010011', '0101']",1,7,19,17,6,36,12.63016983016983,66,59
"['100100', '1', '011']",1,3,5,5,0,10,1.2301587301587302,11,6
"['1000', '1', '0010']",1,3,6,3,2,9,1.3,8,5
"['1010', '00', '0000011', '0110110']",1,4,12,8,2,20,3.075036075036075,24,17
"['0011001', '010001', '11']",1,3,8,7,0,15,1.4059829059829059,11,8
"['10101', '000001', '10', '11111', '011000']",1,5,12,12,4,24,4.161688311688311,37,22
"['0', '0111', '11']",1,3,2,5,0,7,1.0666666666666667,7,6
"['010100', '00011', '0101101', '1011110', '00', '1010011', '110', '111001']",1,8,20,23,5,43,16.723998223998223,95,73
"['00101', '101', '0111111', '1011', '101111']",1,5,7,18,0,25,6.500616050616051,28,40
"['11101', '10', '10000', '1001101']",1,4,9,10,2,19,3.4873015873015873,19,21
"['101', '1101', '010', '0111']",1,4,5,9,4,14,3.988095238095238,11,14
"['01', '001', '11000', '1111000', '10']",1,5,10,9,2,19,4.957142857142857,33,28
"['0', '101', '1001', '1011', '1111111']",1,5,5,14,2,19,4.891558441558441,32,31
"['0', '11101', '01011']",1,3,4,7,2,11,1.2666666666666666,11,5
"['01101', '1', '000011', '00000', '0011111', '01110', '0100']",1,7,18,15,3,33,9.844028194028194,72,60
"['1101', '110', '011']",1,3,3,7,2,10,2.095238095238095,5,10
"['1000', '10110', '000']",1,3,8,4,0,12,2.0238095238095237,6,11
"['110110', '1010', '111010']",1,3,6,10,2,16,2.4333333333333336,6,12
"['010', '00000', '1001', '10100', '1011100']",1,5,15,9,2,24,5.644660894660895,29,28
"['100110', '000', '10', '011110']",1,4,9,8,2,17,3.1777777777777776,20,19
"['001101', '01001', '010101', '1011100']",1,4,12,12,2,24,4.018648018648019,15,19
"['0010000', '11', '10001', '10000', '001100', '0100']",1,6,20,9,2,29,8.933444333444333,45,47
"['011', '101010', '0001', '000101', '1000011', '000100', '110', '001011']",1,8,24,17,6,41,17.02202242202242,82,82
"['010', '1', '011100']",1,3,5,5,0,10,1.4523809523809523,10,5
"['001111', '10', '1']",1,3,3,6,0,9,1.2023809523809523,11,6
"['110011', '10', '0000011', '0111', '1001011', '0100']",1,6,15,15,4,30,7.8227106227106225,50,44
"['101', '00110', '0111111', '110']",1,4,6,12,2,18,3.216666666666667,21,13
"['01', '1011001', '10111', '0001', '1001', '0111']",1,6,11,15,3,26,9.781024531024531,37,55
"['11110', '00', '001', '110']",1,4,6,7,2,13,2.8190476190476192,16,17
"['00', '1000', '1101100']",1,3,8,5,0,13,1.6565656565656566,10,11
"['10111', '1010', '10101', '01011']",1,4,7,12,3,19,4.622222222222222,10,22
"['0110101', '11000', '1000000', '10', '111000', '01110']",1,6,18,14,4,32,8.927450327450327,51,43
"['0', '01', '111001', '010110', '110101']",1,5,9,12,3,21,5.190476190476191,37,21
"['1011', '0111', '11']",1,3,2,8,2,10,2.083333333333333,6,13
"['00110', '11101', '10', '00011']",1,4,8,9,3,17,3.2285714285714286,19,13
"['1001', '100', '0010100', '110001', '1111', '0101010', '1010000', '000111']",1,8,24,20,7,44,16.735719835719834,92,76
"['110010', '0111001', '111100', '10101', '111011', '0000101', '111110', '100011', '10010', '0001010']",1,10,28,33,10,61,27.61002331002331,133,133
"['0', '100110', '010']",1,3,6,4,0,10,1.2301587301587302,10,9
"['11000', '0010', '01001', '1']",1,4,9,6,2,15,2.7777777777777777,19,11
"['0', '11011', '101011', '10110', '1111', '10011']",1,6,8,18,3,26,8.408946608946609,37,55
"['00101', '00001', '0101101', '10011', '0101100', '000000', '0111110']",1,7,24,18,6,42,11.213286713286713,64,66
"['1', '011110', '101101']",1,3,4,9,2,13,1.2380952380952381,13,4
"['0', '011100', '1000', '0001010', '011010']",1,5,15,9,2,24,5.184831834831835,36,41
"['1000001', '0010', '1', '1011100', '01001', '1110']",1,6,15,13,4,28,7.006349206349206,57,33
"['1101000', '11101', '000', '0101001']",1,4,12,10,2,22,3.130952380952381,20,16
"['001101', '1001', '000', '111101']",1,4,9,10,2,19,3.3269841269841267,18,17
"['110001', '10010', '000']",1,3,9,5,0,14,2.143939393939394,8,4
"['1110001', '01001', '010001', '1011100']",1,4,13,12,2,25,4.341325341325342,17,23
"['1000', '001', '11']",1,3,5,4,0,9,1.3047619047619048,7,7
"['011100', '101000', '1001', '011101', '1101']",1,5,12,14,5,26,6.55,27,29
"['1010111', '00', '0111001', '01']",1,4,8,10,4,18,2.849206349206349,25,12
"['10111', '00', '100', '111100']",1,4,7,9,0,16,3.297835497835498,18,19
"['0', '1100100', '0111', '0111100']",1,4,9,10,2,19,2.744155844155844,26,20
"['011', '101', '1000110', '0001010', '000', '101111', '101001']",1,7,18,17,7,35,12.098168498168498,68,54
"['011', '1100', '0100101', '0000110', '111101']",1,5,13,14,2,27,5.6979908979908975,38,25
"['00100', '1', '111101']",1,3,5,7,0,12,0.9826839826839826,13,4
"['010000', '011', '1110001', '10', '01000']",1,5,14,9,0,23,5.451459651459651,33,27
"['010100', '001111', '0000010', '000', '110101', '0000110', '011000']",1,7,26,15,6,41,11.877655677655678,71,85
"['111100', '11', '00000', '001110', '1101']",1,5,11,12,2,23,4.664646464646465,36,26
"['010', '011', '100010', '10011', '0101']",1,5,11,10,2,21,6.736002886002886,23,28
"['0011011', '01', '11']",1,3,4,7,2,11,1.3888888888888888,11,8
"['0010', '00', '1', '1101']",1,4,6,5,2,11,2.3,16,10
"['100110', '111010', '01110', '001000']",1,4,12,11,3,23,3.833333333333333,16,18
"['0010', '11', '111110', '000000', '01011', '111101']",1,6,13,16,3,29,6.410822510822511,55,40
"['0110101', '0010', '1111101', '100111', '000']",1,5,12,15,2,27,5.44084804084804,34,22
"['0', '000110', '1100001', '1100110']",1,4,12,9,2,21,2.8846153846153846,26,17
"['11001', '0101', '1001010', '000']",1,4,11,8,0,19,3.732034632034632,17,11
"['011101', '111010', '111', '0111']",1,4,5,14,2,19,4.423809523809524,14,25
"['11101', '11100', '10', '11']",1,4,4,10,4,14,3.5857142857142854,14,21
"['010000', '10011', '11']",1,3,7,6,0,13,1.3668831168831168,11,6
"['1111100', '110010', '1100000', '11']",1,4,10,12,2,22,3.344932844932845,22,24
"['10001', '01111', '10', '1010011', '001100', '111000']",1,6,15,16,4,31,8.12932622932623,53,37
"['1101111', '011', '1010', '1100101', '1110110']",1,5,9,19,3,28,6.332467532467533,32,34
"['0', '101000', '1110001', '001']",1,4,10,7,0,17,2.8493894993894995,23,13
"['11100', '1', '0110', '100010']",1,4,8,8,0,16,2.831168831168831,20,11
"['011111', '1101', '001', '0010']",1,4,7,10,2,17,3.173015873015873,17,14
"['01011', '11011', '010101', '111']",1,4,6,13,2,19,4.3530303030303035,11,27
"['01', '1000', '110']",1,3,5,4,0,9,1.3047619047619048,7,6
"['010', '10010', '1', '00001']",1,4,9,5,2,14,3.0166666666666666,18,12
"['0001', '00110', '0111', '1001011', '011000']",1,5,14,12,2,26,6.1335664335664335,28,25
"['01', '11', '11000', '101000', '111110']",1,5,9,12,4,21,4.895021645021645,32,28
"['010001', '011100', '11', '0101101', '0110', '10100', '10010', '0000010', '0011011']",1,9,27,22,7,49,21.715540015540014,114,96
"['1000', '0100101', '1111']",1,3,7,8,2,15,1.5227272727272727,10,6
"['110', '110100', '0111', '111110']",1,4,6,13,2,19,3.6047619047619044,17,22
"['011', '10101', '0110', '0111', '000']",1,5,9,10,4,19,6.015873015873016,20,25
"['0', '110', '10110', '01010', '11100']",1,5,9,10,3,19,5.7,27,27
"['1110101', '11010', '1110010', '0010011']",1,4,11,15,3,26,4.166666666666667,17,22
"['01', '001101', '00100', '00', '1010', '110111']",1,6,13,12,4,25,8.3504329004329,45,38
"['110011', '0101', '0001110']",1,3,8,9,0,17,1.760839160839161,11,4
"['101001', '1000100', '01110', '111001']",1,4,12,12,2,24,3.6421911421911424,19,14
"['11110', '00', '10010']",1,3,6,6,2,12,1.2571428571428571,9,7
"['110000', '11010', '001', '110010', '1000101', '01111', '001100', '0100011', '110']",1,9,25,23,9,48,21.815922965922965,114,104
"['0', '1011', '11100', '011001']",1,4,7,9,0,16,2.790764790764791,20,11
"['0', '11010', '0111']",1,3,4,6,0,10,1.4,10,7
"['01', '111000', '111', '00000']",1,4,9,7,0,16,2.147835497835498,22,18
"['0001', '110001', '100', '1001101', '01011']",1,5,13,12,0,25,5.773681873681873,29,31
"['11010', '1', '0001', '0111111', '1010001']",1,5,10,14,2,24,4.363924963924964,42,26
"['11001', '0010', '000011', '00100', '101011', '1000111', '100011', '000001', '01010']",1,9,29,21,7,50,22.623387723387722,91,105
"['0100000', '1111101', '111', '00001', '1011']",1,5,12,14,2,26,4.26067821067821,40,31
"['00011', '00111', '101', '100', '1000111']",1,5,11,12,4,23,6.333333333333333,27,35
"['1000100', '001', '011', '10110', '011101', '1010', '0101']",1,7,16,16,4,32,13.251148851148852,55,56
"['0010001', '1110010', '011', '1100001', '10010', '10011', '110101']",1,7,20,20,5,40,13.891724941724942,63,72
"['011', '11', '10011', '0100100', '0000']",1,5,12,9,0,21,5.28997113997114,31,25
"['100000', '1100110', '11']",1,3,8,7,0,15,1.3098290598290598,13,8
"['00111', '01101', '0101110']",1,3,7,10,2,17,2.3,7,7
"['1000000', '01100', '1111011']",1,3,10,9,2,19,1.2857142857142856,13,5
"['1110111', '010', '1101000', '0110', '10000', '0100']",1,6,16,14,4,30,8.828643578643579,47,41
"['0111000', '010', '010001', '1101100', '0100']",1,5,16,11,2,27,7.077256077256077,30,40
"['01', '0001', '1101000', '10010', '110']",1,5,12,9,0,21,5.347041847041847,30,26
"['0', '000100', '1111000']",1,3,9,5,0,14,0.9972527472527473,15,11
"['000110', '101100', '0011100']",1,3,11,8,2,19,2.2051282051282053,7,15
"['0101110', '011', '00111', '0000001', '101001', '0100']",1,6,18,14,2,32,8.718720168720168,49,38
"['11101', '100111', '1001']",1,3,5,10,0,15,2.012121212121212,7,18
"['001', '11', '1001', '0000', '011000']",1,5,12,7,2,19,5.139682539682539,26,25
"['11010', '010', '00011', '0110', '1111', '110111', '1011']",1,7,11,20,5,31,12.609235209235209,49,67
"['01', '11010', '111', '100', '10110', '100011']",1,6,10,14,4,24,8.328210678210677,38,42
"['1000001', '1110110', '00101', '0']",1,4,11,9,2,20,2.261904761904762,28,11
"['000110', '1101111', '001001', '0000010', '0101', '0001000']",1,6,23,14,5,37,8.834898434898435,48,47
"['1101', '100', '1001', '11111']",1,4,5,11,2,16,3.5396825396825395,13,23
"['10100', '001', '110']",1,3,6,5,2,11,1.3333333333333333,8,7
"['010', '0100110', '011100', '0111101', '01010', '1011', '0101']",1,7,17,19,4,36,14.461383061383062,56,76
"['1100', '110', '01011', '0111']",1,4,6,10,2,16,3.5396825396825395,13,20
"['100', '010', '0110']",1,3,6,4,2,10,2.095238095238095,5,10
"['0101000', '1010100', '1100111', '00010', '001001']",1,5,19,13,3,32,6.381118881118881,33,25
"['000110', '00011', '11000', '100', '10100', '1000', '010111', '1010000']",1,8,25,16,5,41,17.46032856032856,80,104
"['1010', '10100', '1111001', '00000']",1,4,12,9,2,21,3.278787878787879,18,15
"['0101', '0011000', '110011', '100111', '110111', '001100', '0100011', '01011']",1,8,22,25,6,47,19.26008436008436,80,93
"['0100001', '011100', '1011111']",1,3,9,11,2,20,1.6593406593406594,11,5
"['01', '001', '1010010']",1,3,7,5,0,12,1.8444444444444446,10,7
"['01', '0001', '11001']",1,3,6,5,0,11,1.9047619047619047,7,10
"['11100', '000001', '11']",1,3,7,6,0,13,1.185064935064935,12,9
"['1101101', '010', '11100', '0']",1,4,7,9,0,16,2.65,22,11
"['0010', '1', '01010']",1,3,6,4,0,10,1.4,8,6
"['100', '1110000', '11']",1,3,6,6,0,12,1.4444444444444444,11,9
"['0', '111010', '00010', '1100', '1110']",1,5,10,10,2,20,5.203391053391053,29,32
"['100', '0110', '10']",1,3,5,4,0,9,2.038095238095238,5,8
"['11001', '101', '1111']",1,3,3,9,0,12,1.9880952380952381,6,15
"['1001110', '101', '1101000', '1111', '001110', '0000110']",1,6,16,18,3,34,8.538550338550339,51,42
"['11', '1110000', '0101001', '101101']",1,4,10,12,2,22,3.344932844932845,24,17
"['111', '101011', '1001', '10100', '01001']",1,5,10,13,2,23,6.625974025974026,22,36
"['1001100', '00', '110']",1,3,7,5,0,12,1.4444444444444444,11,8
"['11110', '0011', '1001', '000100', '01100']",1,5,13,11,4,24,5.863131313131313,28,25
"['010100', '11011', '1011', '0111101', '11100']",1,5,10,17,2,27,6.3002331002331005,28,28
"['11000', '1110010', '11']",1,3,6,8,0,14,1.8492063492063493,10,11
"['11001', '11110', '110111', '1011100']",1,4,7,16,2,23,4.141958041958042,16,21
"['0001', '00', '01111']",1,3,6,5,0,11,1.3968253968253967,9,8
"['111', '00011', '101', '0001', '0101011', '0011010', '1000000']",1,7,20,16,5,36,11.38152958152958,71,58
"['11', '1010111', '0100100', '1001011', '00010', '0110110']",1,6,17,18,4,35,8.84920634920635,53,33
"['1010110', '1111101', '01110']",1,3,6,13,2,19,1.7619047619047619,8,6
"['00101', '0011001', '101', '000001', '000010', '1011', '110']",1,7,20,14,4,34,11.92923187923188,62,61
"['01101', '1011100', '00000']",1,3,10,7,2,17,1.4,10,8
"['00001', '1', '100010']",1,3,8,4,0,12,1.3463203463203464,11,6
"['010', '001', '101', '0100', '111001']",1,5,10,9,3,19,6.377777777777777,23,23
"['101010', '0000110', '11100']",1,3,10,8,0,18,1.3531468531468531,10,8
"['010110', '111', '100010']",1,3,7,8,2,15,1.3888888888888888,10,5
"['0111000', '010', '11011', '1000111', '0111', '001100']",1,6,15,17,2,32,9.127472527472527,51,40
"['000110', '1', '001000', '0000', '01100', '111001']",1,6,18,10,3,28,7.116738816738817,51,46
"['0', '11110', '111', '101010', '1101']",1,5,6,13,0,19,4.923160173160173,27,26
"['0100000', '10101', '00', '1100110', '110101']",1,5,15,12,2,27,5.838272838272838,36,24
"['0010', '010', '111']",1,3,5,5,2,10,1.476190476190476,6,6
"['0', '1011011', '000101']",1,3,7,7,0,14,0.9972527472527473,14,4
"['110', '001011', '1110']",1,3,5,8,0,13,1.7015873015873015,9,11
"['0', '1011', '011010']",1,3,5,6,0,11,1.2857142857142856,11,4
"['1100011', '00100', '100']",1,3,9,6,0,15,1.85,11,7
"['1101', '001', '111']",1,3,3,7,2,10,1.7619047619047619,5,11
"['1101001', '010100', '11001', '001', '011111', '110']",1,6,13,17,4,30,8.801787101787102,46,46
"['101', '000', '11']",1,3,4,4,2,8,1.1333333333333333,6,4
"['010', '111010', '00000', '1110011', '1001111', '01100']",1,6,16,17,4,33,8.13981018981019,53,40
"['11001', '011', '111', '10100', '00', '10010', '010111']",1,7,13,16,5,29,11.900649350649351,57,55
"['100', '1010', '1000', '10011', '1010011']",1,5,12,11,2,23,7.2536796536796535,21,42
"['1100001', '100', '11100']",1,3,8,7,0,15,2.0166666666666666,9,9
"['0', '01', '111', '101101', '011001']",1,5,7,11,2,18,4.804761904761905,32,22
"['100001', '011', '11000', '0110', '1000000', '1101']",1,6,17,12,2,29,8.546792096792096,48,41
"['110110', '11000', '101']",1,3,6,8,0,14,1.893939393939394,8,8
"['001', '1', '011001']",1,3,5,5,0,10,1.4523809523809523,10,8
"['00', '1000111', '1101110']",1,3,7,9,2,16,1.6031746031746033,13,5
"['01', '0000000', '1101100', '110', '01011', '01000']",1,6,18,11,4,29,7.061904761904762,55,47
"['11001', '0001100', '0', '00001']",1,4,12,6,2,18,2.8499999999999996,23,15
"['011111', '100', '0000']",1,3,7,6,0,13,0.9936507936507937,12,8
"['010100', '001', '1000', '000', '0100']",1,5,15,5,4,20,6.276984126984127,19,46
"['11001', '110001', '100111', '011']",1,4,8,12,2,20,3.914141414141414,17,28
"['01', '0100110', '000']",1,3,8,4,0,12,1.4444444444444444,11,9
"['101', '1101011', '11']",1,3,3,9,0,12,1.8444444444444446,10,16
"['10', '0000100', '011100']",1,3,10,5,0,15,1.5598290598290598,12,11
"['110000', '011001', '11']",1,3,7,7,2,14,1.6666666666666665,11,8
"['110', '1', '1010011']",1,3,4,7,0,11,1.15,12,9
"['0', '10111', '1100001', '01001']",1,4,9,9,2,18,2.683333333333333,24,13
"['0', '101011', '0000111']",1,3,7,7,0,14,1.151098901098901,14,5
"['101', '010', '011000']",1,3,7,5,2,12,1.7777777777777777,9,5
"['0010', '001', '0001000']",1,3,11,3,0,14,2.1844155844155844,8,14
"['1001110', '01', '011101', '100000', '00010', '001001']",1,6,19,13,3,32,8.432539682539682,52,41
"['001', '11011', '111', '1100010', '1100']",1,5,9,13,2,22,5.986796536796537,28,40
"['1000', '10010', '011', '100010']",1,4,11,7,0,18,3.828138528138528,14,22
"['11000', '1111000', '10', '000000', '0000111', '0100']",1,6,20,11,2,31,7.514801864801865,58,63
"['0', '101', '111110']",1,3,3,7,0,10,1.2301587301587302,11,4
"['1000011', '10', '110101']",1,3,7,8,0,15,1.5598290598290598,12,10
"['110', '111', '110011', '010111', '1110100', '000', '1100']",1,7,13,19,5,32,11.604195804195804,62,81
"['001000', '000', '1110']",1,3,9,4,0,13,1.3523809523809525,10,14
"['1000', '010011', '1101']",1,3,7,7,2,14,1.5,8,7
"['01', '0000110', '111']",1,3,6,6,0,12,1.2444444444444445,12,4
"['110001', '10', '11']",1,3,4,6,2,10,1.5,9,10
"['1111', '000111', '1001']",1,3,5,9,2,14,1.7,8,12
"['1000', '010101', '111110']",1,3,7,9,2,16,1.3333333333333333,11,6
"['1000', '0000010', '0010']",1,3,12,3,2,15,1.7727272727272727,9,15
"['110000', '00000', '11', '00100', '000101', '100000', '1100', '1111011']",1,8,25,16,5,41,14.982645132645132,92,110
"['100001', '1', '100010']",1,3,8,5,2,13,1.4047619047619047,12,11
"['100100', '1010010', '110']",1,3,9,7,0,16,1.6136752136752137,10,8
"['0010', '0110', '10000', '1111', '1000']",1,5,12,9,4,21,5.222222222222222,24,26
"['0001', '100101', '1101010']",1,3,9,8,0,17,1.732867132867133,8,7
"['0011', '01001', '10011']",1,3,7,7,2,14,2.3555555555555556,5,9
"['001100', '1111010', '011', '0000']",1,4,11,9,0,20,3.1314019314019315,21,19
"['011', '0011', '101000', '01001', '000001', '00010', '110', '01000']",1,8,24,13,7,37,16.36038961038961,73,88
"['1001110', '001111', '0001', '1000', '10', '00010', '1001111']",1,7,18,17,4,35,12.641081141081141,65,70
"['0011', '001011', '011', '111']",1,4,6,10,2,16,4.006349206349206,12,26
"['0', '11', '0111', '0101', '01011']",1,5,6,10,2,16,5.343650793650793,22,28
"['01101', '11', '0011001', '00', '1110110', '0101']",1,6,12,15,4,27,8.487012987012987,49,37
"['00', '000010', '0111']",1,3,8,4,0,12,1.2333333333333334,11,10
"['001', '001000', '1110101', '10011', '001011']",1,5,14,13,2,27,5.8329836829836825,30,32
"['00111', '000', '1110']",1,3,6,6,0,12,1.4523809523809523,9,10
"['01', '110001', '000', '110', '0111100']",1,5,11,10,2,21,5.026495726495726,33,24
"['010', '001', '11111']",1,3,4,7,2,11,1.1666666666666665,10,4
"['11', '10111', '100', '100010', '00', '0001010']",1,6,14,11,2,25,7.527383727383727,49,39
"['11110', '1010100', '10', '11']",1,4,6,10,2,16,2.865079365079365,20,16
"['01', '0001', '0001110']",1,3,8,5,0,13,1.8383838383838382,10,10
"['111100', '11', '1100010', '0011010', '1000000', '1010', '0101100', '0101', '0001000']",1,9,30,21,7,51,21.037434787434787,126,106
"['11110', '001', '0001', '0111', '000', '01001', '01100']",1,7,16,13,7,29,11.843650793650793,49,67
"['0', '11011', '10110', '10']",1,4,5,8,2,13,3.276190476190476,17,12
"['100001', '11000', '0110', '00', '1101']",1,5,12,9,2,21,5.882034632034632,28,21
"['110000', '11', '00110', '0101', '101110']",1,5,11,12,2,23,5.677489177489178,33,23
"['11000', '001', '011', '0100']",1,4,9,6,2,15,3.4761904761904763,14,17
"['100', '101110', '101001', '1001']",1,4,9,10,2,19,4.257142857142857,15,25
"['0', '0001', '011', '0111']",1,4,6,6,2,12,3.2285714285714286,13,15
"['00', '10011', '110101']",1,3,6,7,0,13,1.7987012987012987,9,5
"['0011', '100000', '1101110']",1,3,9,8,0,17,1.406993006993007,12,8
"['10100', '1000', '000', '110011']",1,4,11,7,0,18,3.7955266955266955,14,18
"['110000', '101100', '0101001']",1,3,11,8,2,19,2.051282051282051,9,7
"['101000', '0110', '00011']",1,3,9,6,0,15,1.612121212121212,10,8
"['101100', '110', '01011', '1111']",1,4,6,12,0,18,3.3098124098124098,16,17
"['1010110', '0011001', '100100', '1100', '011110', '011010', '110']",1,7,19,20,5,39,13.655266955266955,59,62
"['0110101', '0001010', '1']",1,3,8,7,2,15,1.2142857142857144,15,4
"['11010', '00010', '10', '11']",1,4,7,7,4,14,3.0999999999999996,16,16
"['0001', '10', '000', '111']",1,4,7,5,2,12,2.276190476190476,14,14
"['0', '1010001', '010011', '0100111']",1,4,11,10,2,21,3.1923076923076925,23,16
"['01101', '001', '100', '0110', '1111']",1,5,8,11,4,19,5.436507936507937,22,23
"['010', '011', '1100011', '1011', '0100011', '1110']",1,6,12,16,6,28,9.15887445887446,43,56
"['0', '1011', '0100']",1,3,5,4,2,9,1.3,9,4
"['101', '100', '101001', '11']",1,4,6,8,2,14,3.7,14,23
"['11001', '10', '0']",1,3,4,4,0,8,1.5714285714285714,8,4
"['0011011', '1010', '1011100']",1,3,8,10,2,18,1.844155844155844,11,9
"['01', '1010100', '0011010', '00', '1000', '1100']",1,6,16,10,6,26,8.144660894660895,48,48
"['11011', '1011110', '101', '100', '11111', '1001011', '0100']",1,7,12,22,6,34,12.124242424242423,61,66
"['1111101', '0110', '000', '1101', '001011']",1,5,10,14,2,24,5.408075258075258,33,24
"['11001', '010', '0001', '10101', '1011111']",1,5,10,14,2,24,5.662842712842712,30,27
"['110000', '11110', '0110', '111000', '0110110', '1110']",1,6,14,18,4,32,10.015112665112666,36,61
"['0011', '010', '1', '0111']",1,4,5,7,2,12,3.192857142857143,13,12
"['01', '001', '1011001', '01100', '10101', '0011100']",1,6,15,14,4,29,9.346031746031747,46,44
"['10001', '0110', '1100100', '100111']",1,4,11,11,0,22,3.599222999222999,19,13
"['010', '11', '1001', '010110', '000', '0101']",1,6,12,10,4,22,8.954761904761904,35,35
"['01', '100', '1011001', '101101']",1,4,8,10,0,18,3.534188034188034,19,23
"['1', '0011111', '000', '110101']",1,4,7,10,0,17,1.8416971916971918,27,13
"['01', '100001', '011', '00', '001110']",1,5,11,8,4,19,5.311111111111111,31,22
"['01', '11011', '010', '0110000', '0000']",1,5,13,8,0,21,5.27012987012987,32,29
"['11010', '0111001', '00011', '10', '0000']",1,5,13,10,2,23,4.676334776334776,35,26
"['0011', '001', '10']",1,3,5,4,0,9,1.5904761904761904,6,8
"['0110111', '011', '1011101', '0111110', '1101100', '1010011', '000111', '11100', '001011', '0100']",1,10,24,35,7,59,27.831501831501832,144,139
"['00111', '100', '1100011', '11']",1,4,7,10,0,17,3.1825396825396823,21,23
"['0010', '110', '0011111', '11']",1,4,6,10,0,16,3.0946608946608944,20,18
"['0', '10010', '011', '111']",1,4,5,7,2,12,2.5,16,12
"['001', '10', '1110000', '0000']",1,4,11,5,0,16,2.8764790764790766,20,21
"['010101', '1', '011000']",1,3,7,6,2,13,1.2380952380952381,13,5
"['001', '100011', '100111']",1,3,7,8,2,15,2.1666666666666665,7,11
"['11010', '001', '001111', '10100', '000', '1001100', '101001']",1,7,19,16,6,35,12.331779331779332,61,65
"['1011', '001010', '10']",1,3,6,6,0,12,1.7666666666666666,9,6
"['0101110', '101', '100100', '1100']",1,4,10,10,0,20,3.5989343989343987,18,13
"['000110', '0010', '11', '1101101', '1111001', '100010', '0000', '0101']",1,8,21,19,7,40,16.053291153291152,91,71
"['11001', '10101', '010', '011001']",1,4,9,10,2,19,4.3530303030303035,14,17
"['011111', '1', '00001']",1,3,5,7,0,12,0.9826839826839826,13,6
"['1110000', '1001', '111110', '0010010', '000100', '01100', '0100']",1,7,23,16,6,39,12.715678765678765,65,69
"['0001', '10001', '010001', '00000']",1,4,15,5,2,20,4.41010101010101,10,24
"['010000', '0001', '100', '01111', '000000', '01011', '1110']",1,7,20,13,6,33,9.775180375180375,65,68
"['011', '01111', '1111', '001110', '111101']",1,5,6,18,2,24,6.842640692640693,24,39
"['0', '001', '0111']",1,3,4,4,0,8,1.4714285714285715,7,6
"['101', '0010111', '10']",1,3,5,7,0,12,1.8444444444444446,10,7
"['011', '00001', '100', '1010', '11101', '010101', '100111', '1000011']",1,8,19,20,6,39,16.14923964923965,80,85
"['1101', '1001', '01111']",1,3,4,9,2,13,1.8611111111111112,6,10
"['0', '101010', '11']",1,3,4,5,0,9,0.7857142857142857,11,4
"['0010', '010', '000101', '1111110', '01011']",1,5,12,13,0,25,5.872410922410922,31,30
"['000011', '0001', '011101', '111110', '10', '1101', '0100']",1,7,15,17,6,32,10.516666666666667,67,54
"['1111000', '101', '0010', '0011010']",1,4,11,10,2,21,3.2337662337662336,22,16
"['000110', '0010', '010', '111010', '0000001', '000001', '00010', '01100']",1,8,29,13,5,42,17.15986235986236,80,123
"['1000100', '1', '011', '00101', '00000', '01001']",1,6,17,9,3,26,7.333333333333333,49,35
"['1000110', '001', '101001', '100010']",1,4,13,9,2,22,4.138461538461538,16,21
"['0', '011', '010110', '0010011']",1,4,9,8,0,17,3.0716117216117214,23,17
"['11001', '1111101', '0000101', '00', '10011', '01010', '01001', '01011', '1111011']",1,9,21,27,8,48,21.326984126984126,114,108
"['0001', '110', '11100', '1']",1,4,6,7,0,13,2.7134920634920636,18,14
"['011', '111', '100111']",1,3,3,9,2,12,2.0,7,15
"['01101', '1', '111100']",1,3,4,8,0,12,1.1645021645021645,12,6
"['0100000', '1', '011', '00000', '0010010']",1,5,17,6,2,23,4.630952380952381,39,32
"['11', '011010', '0111', '1101010']",1,4,7,12,0,19,3.7257964257964256,19,20
"['11000', '0111001', '1100', '11']",1,4,8,10,0,18,3.965367965367965,17,20
"['0011', '10101', '10001', '1111', '1110']",1,5,8,14,5,22,5.883333333333333,21,35
"['0111', '1011011', '1001', '011110']",1,4,7,14,2,21,3.923776223776224,18,15
"['1010001', '1011', '1011111', '11']",1,4,6,14,2,20,3.5815295815295816,21,36
"['11001', '111', '1001', '111110', '0100']",1,5,8,14,2,22,5.924819624819625,26,30
"['00100', '100', '0100100']",1,3,11,4,0,15,2.1833333333333336,8,18
"['010', '100010', '1001011', '0000']",1,4,13,7,0,20,3.9527805527805526,17,14
"['001', '0100010', '000', '011111', '0101', '0111110']",1,6,15,15,4,30,8.304961704961705,49,51
"['1010000', '1000', '1100000']",1,3,13,5,2,18,2.311688311688312,8,14
"['11000', '1001', '10000', '1001101', '1000000', '10100', '1110100', '110', '01110', '111001']",1,10,29,25,7,54,27.78843378843379,129,142
"['0', '0101011', '11']",1,3,4,6,0,10,0.6944444444444444,13,6
"['010', '001', '10', '0011111']",1,4,7,8,2,15,3.088888888888889,20,15
"['01', '000001', '1100110', '0100']",1,4,12,7,0,19,3.018104118104118,22,15
"['0011', '00', '1000', '1001']",1,4,9,5,3,14,4.0,12,17
"['0', '0010110', '001110', '000010']",1,4,13,7,2,20,3.0265567765567765,21,32
"['00100', '0110', '100111', '010110', '1010011', '101001']",1,6,17,17,3,34,10.34032634032634,39,36
"['0', '1001101', '011000']",1,3,8,6,0,14,1.151098901098901,15,4
"['1010', '1110', '111011']",1,3,4,10,2,14,1.9,6,11
"['01101', '1', '00100', '1010', '1000']",1,5,11,8,4,19,5.261111111111111,27,21
"['01', '00111', '1110011', '1000', '1100']",1,5,10,12,2,22,5.260822510822511,34,29
"['101100', '110010', '1', '010010']",1,4,10,9,3,19,3.0238095238095237,22,14
"['11110', '00000', '0011', '11101', '011110', '110']",1,6,12,16,3,28,8.121428571428572,44,45
"['00111', '10', '0']",1,3,4,4,0,8,1.2857142857142856,9,6
"['0001', '1', '0000001']",1,3,9,3,0,12,1.3772727272727274,12,11
"['0', '11010', '00111', '101', '011000', '100110', '1011111']",1,7,14,19,4,33,11.004917304917305,74,48
"['0010', '001111', '10']",1,3,6,6,0,12,1.5166666666666666,10,9
"['110110', '011', '10000']",1,3,7,7,0,14,1.462121212121212,10,7
"['1011110', '001', '10000']",1,3,8,7,0,15,1.4,12,8
"['0010', '001', '101101', '100', '011101']",1,5,11,11,4,22,6.128571428571428,26,28
"['0', '11011', '0100']",1,3,5,5,0,10,1.1777777777777778,10,4
"['01', '001', '010001']",1,3,7,4,0,11,1.9666666666666668,8,11
"['0', '101', '1000110', '100000']",1,4,11,6,0,17,2.8493894993894995,23,15
"['0', '0111', '110011']",1,3,4,7,0,11,1.2857142857142856,11,6
"['0', '111000', '00101', '1111110']",1,4,8,11,0,19,2.1814019314019313,27,15
"['1110100', '01', '10', '1111']",1,4,5,10,2,15,2.782828282828283,21,16
"['100', '10', '111']",1,3,3,5,2,8,1.5333333333333334,5,7
"['11010', '001', '11110', '00100', '1011']",1,5,10,12,3,22,5.226984126984127,25,25
"['010100', '0010', '010']",1,3,9,4,0,13,2.123809523809524,6,17
"['101010', '00110', '110']",1,3,7,7,0,14,1.558080808080808,7,10
"['010011', '0001', '1001010', '1101']",1,4,11,10,2,21,3.741958041958042,16,14
"['1001', '000', '101001']",1,3,8,5,0,13,1.8158730158730159,7,8
"['010', '0101111', '101', '10110', '111000', '0000110']",1,6,15,16,4,31,8.81066711066711,53,41
"['111000', '011010', '1']",1,3,6,7,2,13,1.2380952380952381,12,4
"['1111100', '100', '1101100', '0111', '110']",1,5,9,15,4,24,5.871861471861472,31,35
"['001', '011', '00000', '11', '100', '1000011', '01011']",1,7,16,12,5,28,10.815873015873017,62,60
"['1101', '0000001', '00001']",1,3,11,5,0,16,1.6414141414141414,10,15
"['0011111', '00010', '1', '10']",1,4,7,8,0,15,2.5436507936507935,24,12
"['01', '011', '1100010', '1001', '1101']",1,5,9,11,2,20,6.325180375180375,26,30
"['0000001', '000000', '00011']",1,3,15,3,0,18,2.1351981351981353,7,22
"['10001', '0111101', '11']",1,3,5,9,0,14,1.5158730158730158,12,9
"['101100', '0110111', '011']",1,3,6,10,0,16,1.882051282051282,11,9
"['1111100', '001', '10000', '10', '0111', '0001011', '01000']",1,7,18,15,4,33,10.346464646464646,77,61
"['101000', '100', '000001', '10', '1001100', '000100', '0111110']",1,7,23,14,5,37,10.736813186813187,76,72
"['0', '1000110', '100']",1,3,7,4,0,11,1.35,12,8
"['00100', '01111', '111100']",1,3,7,9,2,16,1.6727272727272728,9,12
"['10111', '00', '10']",1,3,4,5,2,9,1.3571428571428572,8,5
"['11001', '01101', '00001', '0001', '1101110', '110011', '00110', '01010', '0111110']",1,9,23,26,7,49,21.722832722832724,104,106
"['101', '11101', '011']",1,3,3,8,2,11,1.9166666666666665,7,11
"['1111100', '101', '11101', '011101']",1,4,6,15,0,21,4.0078088578088575,17,24
"['11111', '0001', '0011010', '0100']",1,4,10,10,2,20,2.5353535353535355,20,13
"['110010', '11011', '100101', '101110']",1,4,9,14,3,23,4.015151515151516,15,19
"['010', '00101', '010110', '0000', '1011', '0110001']",1,6,17,12,2,29,9.076423576423576,42,38
"['01', '001', '110010', '0000101', '1110001']",1,5,14,11,2,25,6.011599511599512,36,29
"['0', '1010', '1000', '10010', '0111']",1,5,10,8,3,18,5.2555555555555555,26,26
"['1000001', '000100', '0000000']",1,3,17,3,2,20,2.098901098901099,7,10
"['0', '10100', '01011']",1,3,6,5,2,11,1.2666666666666666,11,6
"['1011010', '01', '110', '000']",1,4,8,7,2,15,2.7777777777777777,19,13
"['01', '010010', '100101', '0111', '011111', '01000']",1,6,14,15,3,29,9.015873015873016,45,45
"['11001', '01101', '10111', '100', '0111111', '01001', '011010']",1,7,14,22,4,36,13.442657342657343,57,61
"['1101', '000100', '110', '000']",1,4,10,6,2,16,2.9873015873015873,17,18
"['0111000', '1', '100001', '1100010', '10100', '01100']",1,6,18,13,4,31,8.275524475524476,54,33
"['01', '011', '110011', '10100', '0111']",1,5,8,12,0,20,6.3336219336219335,26,30
"['01111', '0101111', '010101', '1']",1,4,6,13,0,19,3.198884448884449,21,21
"['0011111', '01010', '11']",1,3,5,9,0,14,1.5158730158730158,12,6
"['110000', '0111001', '111', '0001', '1101', '01011', '0111100']",1,7,16,20,4,36,11.913597513597514,63,63
"['011', '00111', '101', '1101101', '000100', '0100']",1,6,14,14,2,28,8.611971361971362,46,39
"['0110101', '1001110', '010', '001111', '0001010', '1011101', '000', '1011']",1,8,21,23,6,44,17.166944166944166,90,72
"['01', '001', '1111', '1010', '000', '1101']",1,6,9,11,5,20,7.819047619047619,32,35
"['1', '100000', '01000']",1,3,9,3,0,12,1.3463203463203464,11,6
"['0101', '10', '001011', '01000']",1,4,10,7,0,17,3.75021645021645,16,15
"['0', '00011', '1001111', '1111011']",1,4,7,13,2,20,2.571428571428571,26,18
"['1100', '011110', '1111']",1,3,4,10,2,14,1.9,7,6
"['010', '011', '11', '00', '001010']",1,5,9,7,4,16,5.4,23,27
"['110010', '011', '000010']",1,3,9,6,2,15,1.5555555555555554,10,10
"['100001', '11', '101', '11000', '011010']",1,5,11,11,2,22,6.159307359307359,29,24
"['1101101', '10', '1111']",1,3,3,10,0,13,1.505050505050505,11,10
"['00011', '100', '1111000', '0000000', '100010']",1,5,19,9,2,28,5.553280053280053,38,37
"['0001', '110001', '10', '1111']",1,4,7,9,2,16,2.8166666666666664,18,19
"['11110', '11010', '10001', '001100']",1,4,10,11,3,21,3.418181818181818,18,12
"['101', '00100', '10', '0111101']",1,4,8,9,0,17,3.4158730158730157,20,13
"['01', '1', '001000', '0011', '000']",1,5,11,5,0,16,4.757142857142857,28,29
"['011011', '101', '0001', '100011', '0111']",1,5,10,13,4,23,6.076190476190476,25,30
"['00110', '010011', '0110']",1,3,8,7,0,15,2.216161616161616,7,12
"['10101', '1', '0000100', '1101']",1,4,9,8,0,17,2.5136363636363637,23,14
"['0', '110111', '1111']",1,3,2,9,0,11,0.8857142857142857,11,10
"['101100', '01', '001', '0001', '0110', '1101110']",1,6,13,13,2,26,8.91093351093351,45,40
"['101011', '11', '1001010', '1110']",1,4,7,12,0,19,2.9901320901320902,19,21
"['0011011', '0011', '1', '1011111']",1,4,6,13,2,19,2.744155844155844,24,21
"['101', '01101', '1000111']",1,3,6,9,0,15,2.0166666666666666,10,11
"['00', '0001000', '1001101']",1,3,11,5,2,16,1.4603174603174602,13,8
"['0011101', '100', '010111', '11111', '1010001', '0000110']",1,6,16,19,3,35,7.997041847041847,55,37
"['11000', '100', '00101']",1,3,8,5,2,13,1.65,9,9
"['0000111', '11011', '110']",1,3,6,9,0,15,1.65,11,12
"['1000', '110', '10010', '000001']",1,4,12,6,0,18,3.327994227994228,16,17
"['01', '10111', '1000', '000', '101001']",1,5,11,9,0,20,5.128066378066378,27,27
"['11', '1100010', '1110011', '00', '011110', '1110']",1,6,11,17,4,28,7.641713841713842,53,46
"['011111', '1011', '00101']",1,3,5,10,0,15,1.812121212121212,8,7
"['01', '0111010', '0111111', '000', '111101']",1,5,9,16,2,25,5.063858363858364,37,27
"['0000101', '1011', '0111', '0110011']",1,4,10,12,4,22,3.8279220779220777,19,18
"['111', '1010010', '1000', '0000', '0101']",1,5,13,9,3,22,5.025324675324676,28,23
"['0', '1001001', '0001', '011']",1,4,9,6,0,15,2.866883116883117,20,12
"['1', '0110', '01010', '0000']",1,4,9,5,2,14,2.7888888888888888,16,14
"['001', '111', '1101', '01011', '1001011']",1,5,8,14,2,22,5.989177489177489,24,39
"['0', '101010', '1001', '00110', '001110', '01011']",1,6,14,13,4,27,8.232034632034631,44,38
"['010000', '000101', '1']",1,3,9,4,2,13,1.0714285714285714,13,6
"['00110', '0101', '0010', '1011111']",1,4,9,11,2,20,3.7146464646464645,19,13
"['0000', '01', '1', '00011']",1,4,8,4,0,12,2.571428571428571,17,14
"['0111', '000011', '1010011']",1,3,8,9,0,17,1.9146853146853147,8,11
"['0010010', '100111', '1']",1,3,7,7,0,14,1.151098901098901,15,4
"['00', '100', '1100', '1001111']",1,4,8,8,0,16,3.9137085137085137,18,19
"['10110', '1', '000001', '00101']",1,4,10,7,2,17,2.4614718614718614,22,14
"['1000', '100', '10000', '11']",1,4,9,5,0,14,3.515079365079365,13,23
"['0', '010001', '00001', '11', '10010', '1101']",1,6,13,10,2,23,6.9418470418470415,46,35
"['0', '010000', '10110']",1,3,8,4,0,12,1.1645021645021645,12,8
"['1000', '101110', '111011']",1,3,6,10,2,16,1.6666666666666665,10,7
"['11110', '1', '10110', '0111011']",1,4,5,13,2,18,3.05,22,15
"['01', '100', '01110', '00001']",1,4,9,6,2,15,2.942857142857143,18,15
"['01', '1010', '10100']",1,3,6,5,0,11,2.126984126984127,6,9
"['101101', '011101', '011111', '0101', '110']",1,5,8,17,3,25,6.682539682539683,25,33
"['01111', '100001', '001011']",1,3,8,9,2,17,1.4090909090909092,9,7
"['11001', '0010', '101', '0011110', '0111111', '0111', '1100', '101001']",1,8,16,24,5,40,16.654173604173604,87,76
"['11000', '01101', '10010', '1']",1,4,8,8,3,16,3.0,20,12
"['010001', '110', '01110']",1,3,7,7,0,14,1.7398989898989898,9,9
"['110', '011011', '100', '011101', '0000', '1100']",1,6,13,13,6,26,8.793650793650793,40,42
"['010011', '10010', '10000']",1,3,10,6,2,16,2.0727272727272728,6,8
"['1101001', '00111', '0']",1,3,6,7,0,13,1.0833333333333333,14,5
"['1', '0010100', '0011010', '0010000']",1,4,15,7,3,22,3.1785714285714284,23,24
"['0', '101', '0010001']",1,3,7,4,0,11,1.35,12,5
"['00', '000101', '10']",1,3,7,3,2,10,1.5,9,8
"['00000', '11', '0011', '100000', '0111110']",1,5,14,10,0,24,4.301126651126651,39,31
"['0', '00110', '01010']",1,3,7,4,2,11,1.4666666666666668,10,13
"['001', '111100', '100', '110100', '01100']",1,5,12,11,4,23,6.26010101010101,27,38
"['11100', '011', '000']",1,3,6,5,2,11,1.3333333333333333,8,9
"['010100', '00100', '10100', '111010']",1,4,13,9,4,22,4.557575757575758,11,26
"['010000', '0011', '1111', '1110100', '1010010']",1,5,14,14,4,28,5.380719280719281,35,28
"['01', '001010', '000', '1010000', '000100']",1,5,18,6,2,24,5.8418803418803416,33,44
"['0101111', '1', '100', '1010001', '110']",1,5,9,12,4,21,4.538095238095238,39,24
"['1110101', '110', '00011']",1,3,6,9,0,15,1.4333333333333333,12,9
"['1110000', '100', '10000', '010111', '011001', '1010001', '01001']",1,7,22,17,6,39,13.632389832389832,60,65
"['11011', '000', '01000', '1111011']",1,4,9,11,2,20,2.7666666666666666,22,19
"['1010110', '01101', '00', '001001', '110']",1,5,12,11,0,23,5.71964146964147,33,25
"['101', '0010011', '011110', '0100']",1,4,10,10,0,20,3.4046842046842047,20,12
"['101', '0001010', '000011', '1110']",1,4,11,9,0,20,3.1487401487401487,21,14
"['0', '1111100', '11011', '0011', '0001']",1,5,9,12,2,21,4.471717171717172,36,27
"['1110000', '00', '100011', '10', '1010011', '110']",1,6,14,13,4,27,8.032112332112332,52,42
"['10101', '1001', '1111000', '10010', '110']",1,5,11,13,2,24,6.461327561327561,26,30
"['1100', '001111', '1001']",1,3,6,8,2,14,1.75,10,8
"['000110', '010111', '11']",1,3,6,8,2,14,1.6666666666666665,10,6
"['0101', '0101110', '10', '0111101', '110101']",1,5,10,16,2,26,6.2551559551559555,31,31
"['0001101', '01', '10', '0100010']",1,4,11,7,4,18,2.992063492063492,25,15
"['11001', '11', '1001101']",1,3,5,9,0,14,1.6825396825396823,11,15
"['0', '01', '111100']",1,3,4,5,0,9,1.2023809523809523,11,6
"['01', '0001110', '10', '000011']",1,4,10,7,2,17,2.908119658119658,23,15
"['1000', '1', '1110', '00000']",1,4,9,5,2,14,2.188888888888889,19,14
"['0', '10111', '0001', '0011']",1,4,7,7,2,14,2.9944444444444445,16,12
"['01', '0010', '0111001', '1101111', '10', '011110']",1,6,11,17,4,28,8.372949272949272,55,37
"['011', '11', '001000', '10', '0000']",1,5,11,6,2,17,4.113492063492063,29,26
"['01111', '0110', '000', '110100']",1,4,9,9,0,18,2.896176046176046,18,19
"['010100', '01', '111', '1101011', '0111']",1,5,8,14,0,22,5.6735375735375735,31,31
"['11110', '010011', '1001']",1,3,6,9,0,15,1.6080808080808082,9,7
"['1000010', '1', '01110']",1,3,7,6,0,13,0.9166666666666666,14,5
"['001', '0011001', '101', '1100010', '011101', '110']",1,6,14,15,5,29,8.943345543345544,49,43
"['101100', '01', '010', '1101011', '1111']",1,5,8,14,0,22,5.15059385059385,33,23
"['01', '00110', '1010', '00010', '111101']",1,5,11,11,2,22,5.951948051948052,27,24
"['1010100', '110', '100111', '000101']",1,4,11,11,2,22,3.0324786324786324,20,15
"['001111', '1', '1101100']",1,3,5,9,0,14,0.9972527472527473,15,8
"['011', '11', '001010', '10010', '0101', '1100']",1,6,12,12,2,24,9.56060606060606,36,37
"['10100', '010', '00101', '111011']",1,4,9,10,2,19,3.635353535353535,16,11
"['00011', '00111', '1101011', '0101', '1011111']",1,5,10,18,4,28,6.477489177489177,28,34
"['1110111', '010', '011', '101011', '100101', '011000']",1,6,13,18,5,31,9.512820512820513,47,37
"['1101001', '010001', '1', '0001', '0111111', '0101', '011000']",1,7,17,18,6,35,11.21954711954712,73,61
"['1', '11000', '0110', '000101', '0100011', '1110']",1,6,14,13,2,27,7.642823842823843,53,36
"['01', '00', '111110', '00010', '01100']",1,5,11,9,4,20,4.594805194805195,33,33
"['1', '011', '0001000']",1,3,7,4,0,11,1.15,13,4
"['0111000', '01', '01110']",1,3,7,7,0,14,1.8492063492063493,10,14
"['1010110', '11', '101', '111110', '1010010']",1,5,9,16,2,25,5.767399267399267,33,35
"['001', '0001', '1000111', '1000', '000000']",1,5,17,7,2,24,6.339099789099789,29,37
"['1010001', '1001', '110']",1,3,7,7,0,14,1.6987012987012986,9,11
"['010', '1111101', '1001111', '1011111']",1,4,6,18,3,24,3.342857142857143,21,23
"['00001', '11', '10100', '10011', '0101100', '0100101']",1,6,17,14,5,31,8.322222222222223,47,38
"['00', '0101', '001', '11']",1,4,6,5,2,11,3.104761904761905,10,13
"['010100', '1011110', '1010111', '0111', '11100', '0110001']",1,6,15,21,3,36,9.866233766233766,46,43
"['0001', '11011', '10010', '000']",1,4,10,7,2,17,3.568253968253968,14,14
"['0100000', '001', '0001111', '100110', '000', '010011', '110']",1,7,21,14,7,35,11.766178266178265,71,66
"['1', '10', '0100100', '11100', '01000']",1,5,12,8,2,20,5.103968253968254,33,25
"['00111', '1010', '10011', '011110', '1011']",1,5,9,15,4,24,6.489393939393939,23,27
"['001000', '11', '0001', '0000001', '1010']",1,5,16,7,2,23,4.724669774669775,35,29
"['101100', '110', '0110', '0001011', '010011', '11100']",1,6,15,16,2,31,9.56953601953602,46,45
"['101010', '1101', '010', '10010']",1,4,9,9,0,18,3.982034632034632,12,17
"['1', '011', '00', '0000010', '1010011']",1,5,12,8,2,20,3.8603174603174604,40,20
"['1011110', '00', '1110100', '110111', '01010', '110']",1,6,12,18,2,30,8.311815961815961,51,41
"['11001', '0', '1000110', '10110', '000111']",1,5,12,12,2,24,4.995854145854146,36,23
"['0', '0101', '1100110']",1,3,6,6,0,12,1.1954545454545453,13,6
"['11001', '1010', '10010', '1001111']",1,4,9,12,2,21,4.234343434343434,17,22
"['1110111', '01', '1110000', '10', '101110']",1,5,9,15,4,24,5.011599511599512,41,27
"['1101101', '1', '0111']",1,3,3,9,0,12,1.3772727272727274,12,9
"['001', '111', '0011000', '101010', '1001000', '100101', '00010']",1,7,22,15,6,37,12.843545343545344,63,61
"['0', '10101', '00101', '110010']",1,4,9,8,2,17,3.206926406926407,20,13
"['1011100', '000', '11']",1,3,6,6,0,12,0.8444444444444444,12,6
"['11001', '00111', '011']",1,3,5,8,2,13,1.85,9,9
"['010001', '1', '0011000', '100', '111110', '0101001']",1,6,16,14,4,30,6.952136752136752,59,34
"['11001', '1010', '11100']",1,3,6,8,2,14,2.1333333333333333,7,7
"['0', '1001110', '000011', '00001', '1010011']",1,5,15,11,2,26,5.293706293706293,37,26
"['1000', '0100111', '1']",1,3,6,6,0,12,1.1954545454545453,13,6
"['1111', '100001', '01100', '00011']",1,4,10,10,2,20,3.1616161616161618,20,13
"['1010001', '10110', '111010']",1,3,8,10,0,18,2.0093240093240095,8,9
"['11110', '100', '00', '001110', '1101010']",1,5,11,12,0,23,5.2634143634143635,32,33
"['11010', '0111010', '101', '00', '111101', '0100']",1,6,12,15,0,27,8.862592962592963,43,36
"['111100', '101000', '1010111', '111110', '10011', '000', '01001']",1,7,17,21,5,38,11.496037296037295,65,62
"['100001', '0011010', '1111']",1,3,8,9,0,17,1.406993006993007,12,4
"['100', '1000111', '11']",1,3,5,7,0,12,1.4444444444444444,11,12
"['11001', '001000', '1111', '1111010', '10', '000']",1,6,13,14,0,27,7.083472083472083,52,42
"['0', '00110', '011001']",1,3,7,5,0,12,1.3463203463203464,12,8
"['101', '10100', '111']",1,3,4,7,2,11,1.9166666666666665,6,10
"['0', '101100', '11011', '010']",1,4,7,8,0,15,2.790764790764791,20,10
"['1011001', '010001', '10010', '0111100']",1,4,13,12,2,25,3.811022311022311,19,14
"['001101', '00101', '1100001', '0001', '111110']",1,5,14,14,2,28,5.38974358974359,31,34
"['0111010', '1', '101', '110011', '0000110']",1,5,11,13,2,24,4.6007326007326,41,17
"['0100001', '0110010', '10', '000']",1,4,13,6,2,19,2.9174603174603173,23,16
"['1110111', '1111001', '10100', '10', '0100101']",1,5,11,17,3,28,5.595238095238095,38,28
"['1011001', '100101', '10', '000', '1101', '0100']",1,6,14,12,2,26,8.38969918969919,41,35
"['001', '1100', '101111']",1,3,5,8,0,13,1.4158730158730157,11,8
"['0110', '001101', '11']",1,3,5,7,0,12,1.9666666666666668,8,4
"['01', '00', '1001']",1,3,5,3,2,8,1.8333333333333333,5,5
"['001', '111000', '1', '110101']",1,4,7,9,2,16,2.626984126984127,22,17
"['010001', '10011', '01010']",1,3,9,7,2,16,2.0545454545454547,7,6
"['0001110', '0001', '110100', '00', '001100']",1,5,16,9,2,25,5.735819735819736,34,48
"['11000', '1', '101000']",1,3,7,5,0,12,1.528138528138528,10,9
"['1110111', '0111001', '00101', '101010', '1100010', '0110', '1000010', '001010']",1,8,25,24,6,49,17.505860805860806,81,84
"['1000001', '00', '1100', '1110', '0100']",1,5,13,8,3,21,5.565656565656566,29,25
"['1001110', '10', '0']",1,3,5,5,0,10,1.3611111111111112,12,8
"['01101', '0001', '1010100', '100', '0001111', '001010', '110', '01110']",1,8,21,19,6,40,15.74911754911755,82,80
"['1001110', '11', '0001', '0000001', '00110', '10011', '110']",1,7,18,15,4,33,11.77987012987013,69,62
"['0001001', '101100', '11']",1,3,8,7,0,15,1.5598290598290598,12,7
"['010100', '001111', '1']",1,3,6,7,2,13,1.0714285714285714,14,5
"['0', '001', '00101']",1,3,6,3,0,9,1.5833333333333333,8,9
"['1101111', '011', '111', '00001', '01110']",1,5,8,15,4,23,5.516666666666667,32,30
"['1111100', '0111000', '10']",1,3,7,9,2,16,1.6031746031746033,12,7
"['0', '0110010', '010']",1,3,7,4,0,11,1.35,12,15
"['101100', '010', '100001', '0011', '1010', '110']",1,6,14,12,6,26,8.838095238095239,38,38
"['00', '1100', '1000111']",1,3,7,6,0,13,1.6565656565656566,11,7
"['101010', '10000', '000001']",1,3,12,5,2,17,1.7878787878787878,8,10
"['101', '0110', '111010']",1,3,5,8,0,13,1.838095238095238,9,5
"['000110', '101011', '1111', '1100101', '1101']",1,5,10,17,4,27,6.255827505827506,29,36
"['0', '1011010', '10101', '1111', '1010010']",1,5,10,14,2,24,4.662337662337662,34,27
"['01', '1100', '101001']",1,3,6,6,0,12,1.6333333333333333,9,7
"['1', '00011', '1001', '01111', '1010']",1,5,8,11,4,19,4.816666666666666,29,24
"['0110', '00', '111111', '001110', '1000011', '0000111']",1,6,15,17,4,32,7.857453657453657,57,40
"['11001', '100', '001']",1,3,6,5,2,11,2.1666666666666665,6,9
"['111', '1001', '1010111', '10100', '000', '000010']",1,6,15,13,2,28,7.699345099345099,47,42
"['1100011', '001100', '1']",1,3,7,7,0,14,1.151098901098901,16,4
"['0111000', '0011', '1101']",1,3,7,8,2,15,1.5909090909090908,11,6
"['00000', '101', '0001', '10110', '1111000', '00010']",1,6,18,11,3,29,8.283549783549784,45,51
"['010', '1', '0011', '1100100', '100101', '011000']",1,6,15,12,2,27,8.376773226773226,52,31
"['0', '1010110', '0111001', '1110']",1,4,8,11,2,19,2.925974025974026,25,14
"['1110000', '11', '1001', '10100', '100000', '000', '1101']",1,7,18,13,2,31,11.378610278610278,61,67
"['111010', '111', '11000', '01111', '10']",1,5,7,14,2,21,5.528354978354979,30,35
"['1001010', '10111', '10110', '000001', '00010']",1,5,16,12,3,28,5.349417249417249,26,29
"['111010', '0110', '00', '1001100', '000111']",1,5,13,12,2,25,5.922999222999223,35,30
"['0', '11110', '10111', '00110', '111001']",1,5,8,14,3,22,4.903896103896104,32,24
"['10001', '100111', '11010', '00001']",1,4,11,10,3,21,3.618181818181818,16,20
"['01', '001', '00000', '1101000', '0100001']",1,5,17,7,2,24,5.355555555555555,35,32
"['010100', '0', '10111', '00110', '0111110']",1,5,11,13,2,24,5.023826173826174,35,28
"['0011000', '101', '001110', '000', '11111']",1,5,12,12,2,24,4.592463092463093,36,28
"['001110', '1001010', '110101']",1,3,9,10,2,19,2.0384615384615383,8,5
"['011011', '0001110', '0001', '1']",1,4,9,9,0,18,2.6783716283716283,24,13
"['0001111', '1010', '11']",1,3,5,8,0,13,1.4747474747474747,12,8
"['001', '00101', '10001', '1111', '1010000']",1,5,13,11,2,24,5.204906204906205,32,31
"['0', '100', '101001']",1,3,6,4,0,10,1.4523809523809523,10,5
"['10110', '1010', '10011', '000', '110', '101001']",1,6,13,13,4,26,9.225180375180376,33,43
"['11000', '100100', '1111000', '0001100', '10011']",1,5,17,13,4,30,6.3695637695637695,30,39
"['101011', '10', '0100']",1,3,6,6,0,12,1.7666666666666666,9,5
"['1011110', '00010', '000111', '1110']",1,4,10,12,0,22,3.4477078477078478,19,22
"['0110101', '11', '0111111', '0101', '101110']",1,5,8,18,2,26,6.027183927183927,34,29
"['0111001', '1100101', '111', '1100110']",1,4,9,15,3,24,4.085714285714285,21,23
"['1', '0011', '1011101', '10000', '01011']",1,5,10,12,2,22,4.762121212121212,36,26
"['0', '1011', '01010', '0101001']",1,4,9,8,0,17,3.2106060606060605,20,14
"['1011', '101110', '0111', '101101']",1,4,6,14,4,20,4.783333333333333,12,24
"['11000', '00', '11']",1,3,5,4,2,9,1.1428571428571428,8,8
"['010', '101', '1100001', '10001', '10110', '001100', '1011', '1110', '111001']",1,9,20,23,8,43,22.82018537018537,99,106
"['11011', '00110', '11101', '101101']",1,4,7,14,3,21,4.363636363636363,14,17
"['0', '0010', '0111101']",1,3,6,6,0,12,1.1954545454545453,13,8
"['1011010', '1001', '01111', '1111010', '00', '0101']",1,6,12,17,4,29,8.923160173160174,46,38
"['10010', '10011', '0110011']",1,3,8,9,2,17,2.3,6,13
"['0', '0101010', '10100', '001100', '001001']",1,5,16,9,2,25,5.8144355644355645,34,33
"['0', '111', '1001101']",1,3,4,7,0,11,0.85,13,4
"['1011010', '101', '10101', '1101110', '000']",1,5,11,14,4,25,5.973809523809524,31,27
"['001001', '001010', '111101']",1,3,9,9,3,18,1.6666666666666667,9,8
"['001', '100', '110100', '10', '0101100']",1,5,12,9,2,21,5.5376068376068375,31,30
"['0110111', '111', '011011', '00', '0101100', '0101', '111101']",1,7,13,22,4,35,11.918342768342768,67,68
"['0111010', '1', '0011111', '000']",1,4,8,10,2,18,2.2142857142857144,27,12
"['001', '000101', '011', '1']",1,4,7,6,2,13,3.2857142857142856,16,14
"['1100', '0110', '11101', '000011']",1,4,9,10,2,19,3.446969696969697,18,14
"['0', '01', '11010']",1,3,4,4,0,8,1.5714285714285714,8,6
"['0', '01000', '0011', '01110']",1,4,9,6,2,15,2.7777777777777777,18,20
"['0111000', '0000001', '00', '0101100', '001100', '001001']",1,6,24,11,5,35,8.584249084249084,49,76
"['101', '0100011', '000111']",1,3,8,8,0,16,1.8136752136752137,10,7
"['0110101', '11', '0001', '1001', '0101']",1,5,10,11,3,21,5.565656565656566,25,32
"['0001', '100', '0111']",1,3,6,5,2,11,1.3571428571428572,7,7
"['11010', '111', '111011', '100101', '1110']",1,5,7,17,2,24,6.928354978354978,22,46
"['0', '10100', '100']",1,3,6,3,0,9,1.5833333333333333,8,9
"['010', '10111', '10110', '00', '1011', '111000']",1,6,11,14,2,25,9.006854256854258,40,42
"['100', '1001', '01111', '1111111']",1,4,5,14,0,19,2.781890331890332,22,22
"['001', '0101111', '00101', '011100', '000', '1100011', '0100']",1,7,19,16,4,35,12.255155955155955,64,65
"['11110', '10', '0011000', '0000']",1,4,11,7,0,18,2.6168831168831166,22,21
"['01', '010', '00011', '110100', '00110', '000000']",1,6,18,9,4,27,8.187301587301587,46,50
"['0010', '00', '100011', '1101']",1,4,9,7,2,16,3.1999999999999997,18,11
"['111101', '001010', '000']",1,3,8,7,2,15,1.3888888888888888,12,6
"['111111', '101101', '00001']",1,3,6,11,2,17,1.0454545454545454,10,9
"['0', '11010', '1100000', '10011']",1,4,10,8,2,18,2.4833333333333334,23,14
"['11001', '0111010', '111', '0100010', '1010']",1,5,12,14,2,26,6.0227272727272725,30,26
"['0', '11110', '11011', '11101']",1,4,4,12,3,16,3.2,18,16
"['00100', '00110', '111']",1,3,7,6,2,13,1.55,8,7
"['0', '0100010', '011', '001011']",1,4,10,7,0,17,2.9177655677655676,23,17
"['0', '1100101', '011']",1,3,5,6,0,11,1.15,12,5
"['110000', '00', '010010', '001000']",1,4,15,5,3,20,3.6666666666666665,19,27
"['0', '0110000', '0111111', '11100', '1111011']",1,5,10,17,3,27,4.6309523809523805,42,30
"['00101', '00001', '10111', '100', '10000', '0100011', '110']",1,7,19,14,6,33,11.9,59,58
"['101', '10', '101111']",1,3,3,8,0,11,1.9666666666666668,8,12
"['0001110', '10000', '00', '111110', '01010']",1,5,14,11,2,25,5.113292263292263,36,37
"['1000100', '01', '10101', '111110', '11100', '101110']",1,6,13,18,4,31,8.12011877011877,46,42
"['101100', '01', '0111010', '1101100', '000111']",1,5,13,15,4,28,5.718559218559219,37,29
"['101100', '1011100', '101111']",1,3,7,12,2,19,2.358974358974359,5,19
"['1', '0011100', '001010', '0000', '0001000']",1,5,18,7,2,25,5.293006993006993,35,47
"['000100', '010000', '1011001', '0110111']",1,4,15,11,4,26,3.5347985347985347,19,14
"['010100', '01100', '1110']",1,3,8,7,0,15,1.9757575757575756,6,11
"['101010', '1010100', '111', '0101001']",1,4,11,12,2,23,4.416117216117216,17,17
"['111', '111010', '100', '10100', '001010', '0111', '001100']",1,7,16,17,5,33,12.874675324675325,56,67
"['0010', '010', '011110', '1001']",1,4,9,8,2,17,3.845238095238095,16,17
"['1000100', '1', '0000000', '100011', '1110']",1,5,16,9,2,25,3.8262237762237765,43,25
"['00110', '110', '111']",1,3,4,7,2,11,1.9166666666666665,6,8
"['11001', '0100111', '0100110', '00100', '1010', '01010', '000111']",1,7,21,18,5,39,14.065612165612166,57,64
"['0000110', '0001', '010000', '010111']",1,4,15,8,2,23,3.4580419580419584,18,23
"['111', '10111', '100', '1001101', '1000', '000', '110101']",1,7,14,17,3,31,11.692152292152292,57,71
"['00010', '010001', '001111', '0111']",1,4,11,10,2,21,3.617171717171717,18,16
"['00100', '01110', '00000']",1,3,11,4,3,15,1.8,6,16
"['0011011', '1', '0100', '001100']",1,4,10,8,0,18,2.8685814185814187,22,19
"['0101', '01101', '10110']",1,3,6,8,2,14,2.3555555555555556,6,9
"['1011011', '0111111', '0101110', '1']",1,4,6,16,3,22,2.75,26,12
"['1001010', '101', '1101000', '101011', '000101', '110011']",1,6,17,18,5,35,10.08095238095238,44,51
"['00111', '110', '1110', '11']",1,4,4,10,0,14,4.061904761904762,13,24
"['0001101', '1', '10']",1,3,5,5,0,10,1.3611111111111112,12,6
"['100100', '1100', '1010010']",1,3,10,7,0,17,2.0965034965034963,8,9
"['00', '01101', '0001', '111101']",1,4,8,9,0,17,3.0598124098124098,18,17
"['11', '00', '1011', '000100', '011000']",1,5,12,8,4,20,4.25,35,27
"['0110100', '00111', '100', '10', '0000010']",1,5,15,9,2,24,5.212698412698413,40,31
"['101', '00100', '000111', '000']",1,4,11,6,2,17,3.2398989898989896,17,20
"['11', '11101', '0101100', '0000', '101001']",1,5,12,12,0,24,4.329237429237429,34,21
"['100', '1110', '0101001']",1,3,7,7,0,14,1.535064935064935,10,6
"['111010', '001', '10', '010010']",1,4,9,8,2,17,3.011111111111111,19,16
"['011', '00', '10', '1011', '0110110']",1,5,8,10,2,18,5.373304473304473,28,24
"['110011', '11000', '10110', '00001']",1,4,11,10,3,21,3.418181818181818,18,18
"['01', '00010', '10000']",1,3,9,3,2,12,1.657142857142857,9,8
"['0111000', '0011', '1', '00001']",1,4,10,7,0,17,2.6954545454545453,23,14
"['0110001', '1', '0111']",1,3,5,7,0,12,1.3772727272727274,12,8
"['00101', '00001', '00', '11100', '01011', '011000']",1,6,17,11,4,28,8.14935064935065,43,50
"['001', '0110100', '00', '11111', '0100011', '110']",1,6,13,14,4,27,6.576984126984127,57,39
"['111', '1000', '10', '000111', '1100']",1,5,9,10,2,19,5.257142857142857,29,32
"['0010', '11110', '10111', '0001', '00110', '110']",1,6,12,14,5,26,8.518253968253967,36,45
"['0010001', '010', '110', '111']",1,4,8,8,3,16,3.0666666666666664,18,13
"['0110010', '0101', '100011']",1,3,9,8,0,17,1.606993006993007,9,5
"['00111', '010', '100', '0010011']",1,4,10,8,2,18,3.533333333333333,19,17
"['1101', '000101', '1000111']",1,3,8,9,0,17,1.9146853146853147,9,11
"['00111', '01001', '010111']",1,3,7,9,2,16,2.2363636363636363,6,11
"['1010001', '110', '101']",1,3,6,7,2,13,1.6666666666666665,10,11
"['110000', '1010', '1', '01000']",1,4,10,6,0,16,3.012987012987013,19,12
"['011110', '00', '01110']",1,3,6,7,0,13,1.9805194805194803,8,18
"['1000111', '0100111', '10', '000']",1,4,10,9,2,19,3.146031746031746,22,15
"['010', '000101', '01110']",1,3,8,6,0,14,1.962121212121212,8,10
"['101100', '0110100', '00001', '11000', '1101100', '10', '0111', '110']",1,8,20,19,4,39,15.843245643245643,89,86
"['11110', '1010110', '1010100', '1001', '00', '11101', '1000']",1,7,16,18,6,34,11.912914862914862,60,60
"['0', '00100', '1001000', '11']",1,4,10,5,0,15,2.1468253968253967,23,12
"['01001', '010', '11']",1,3,5,5,0,10,1.7214285714285715,7,6
"['100', '000101', '00010', '1001111', '01100', '0111100']",1,6,18,15,4,33,8.37120102120102,49,51
"['100', '1001', '0111', '0110110', '011000']",1,5,12,12,2,24,6.151481851481852,29,28
"['0110111', '100', '000101', '1101', '111001']",1,5,11,15,2,26,5.940581640581641,32,31
"['1110001', '0001110', '11']",1,3,7,9,2,16,1.4603174603174602,16,6
"['11011', '1110110', '110', '111100']",1,4,6,15,0,21,4.164685314685315,16,25
"['00110', '10001', '000010', '11']",1,4,11,7,2,18,3.4474025974025975,18,10
"['100', '110', '10', '1100000']",1,4,9,6,2,15,3.911111111111111,16,17
"['1001', '011101', '000', '000100', '1100']",1,5,14,9,4,23,5.903968253968253,28,30
"['00', '111010', '1110']",1,3,5,7,0,12,1.6333333333333333,9,10
"['01', '11011', '0001', '001110', '0010010']",1,5,13,11,0,24,5.587123987123987,33,24
"['001', '1', '0011000']",1,3,7,4,0,11,1.35,12,7
"['1011101', '00', '000100', '1010000']",1,4,14,8,2,22,3.037240537240537,24,21
"['01', '11', '1100010', '00110', '001011']",1,5,11,11,2,22,5.374403374403374,34,26
"['011011', '101011', '010']",1,3,6,9,2,15,2.1666666666666665,8,8
"['01', '01101', '1001101']",1,3,6,8,0,14,1.8492063492063493,10,13
"['0101000', '011', '0001', '1100100', '1001001']",1,5,17,11,3,28,6.093506493506493,34,26
"['1000100', '11', '1100100', '1010', '1101']",1,5,12,12,4,24,6.556637806637807,30,33
"['10100', '100', '00001']",1,3,9,4,2,13,1.65,8,11
"['10000', '1000', '10']",1,3,8,3,0,11,2.126984126984127,6,13
"['101', '100', '1111', '011110', '1001011']",1,5,8,15,2,23,5.237873237873238,31,26
"['010000', '110', '01010', '001000']",1,4,14,6,2,20,3.676767676767677,16,24
"['0', '10101', '1000']",1,3,6,4,0,10,1.4,9,5
"['001', '1', '01100', '001000']",1,4,10,5,0,15,3.012987012987013,19,16
"['01', '100', '10110', '1001101']",1,4,8,9,0,17,3.5992063492063493,18,17
"['11001', '11110', '0001110', '000011', '10', '1010011']",1,6,15,17,4,32,8.376917526917527,54,44
"['0011', '1000', '0100011']",1,3,9,6,2,15,1.9545454545454546,9,10
"['1100000', '000010', '000000']",1,3,16,3,2,19,2.371794871794872,6,25
"['01101', '101', '1010100', '1111', '1000', '11101', '00', '0101', '1100']",1,9,17,21,6,38,21.05180375180375,88,107
"['001101', '1100', '110001', '110', '001011', '0001000']",1,6,18,14,3,32,9.05986235986236,49,49
"['1010', '001001', '011', '110101']",1,4,9,10,2,19,3.9714285714285715,16,14
"['11110', '01101', '110', '0111']",1,4,5,12,2,17,4.226984126984127,12,20
"['1010', '001', '1', '0000011']",1,4,9,6,0,15,2.685064935064935,22,13
"['1101001', '01', '00100', '0001', '00110', '1011', '101001']",1,7,18,15,4,33,13.582095682095682,54,59
"['01101', '11', '110011', '0000011', '110']",1,5,10,13,0,23,5.793378843378843,34,38
"['1011', '011', '111010', '11']",1,4,4,11,0,15,3.8682539682539683,15,24
"['11011', '111', '1011111']",1,3,2,13,0,15,2.0166666666666666,9,22
"['1001', '1001000', '1110000', '11111']",1,4,11,12,2,23,3.2647907647907646,22,23
"['0101', '101000', '01111', '1011', '000111', '1111111']",1,6,11,21,4,32,8.237412587412587,50,53
"['1000', '1100', '111', '1001010']",1,4,9,9,2,18,3.47987012987013,16,17
"['110000', '1', '00101']",1,3,7,5,0,12,0.9826839826839826,13,7
"['11001', '0110001', '000', '011000']",1,4,13,8,0,21,4.2503496503496505,15,21
"['0101101', '101', '0110', '00', '1001100', '0100001']",1,6,17,13,3,30,8.914285714285715,53,39
"['11000', '011', '0100']",1,3,7,5,0,12,1.7380952380952381,8,9
"['0', '001', '00101', '01011']",1,4,8,6,2,14,3.216666666666667,16,15
"['01', '010', '0000100', '01111', '0100']",1,5,13,8,0,21,5.944733044733044,30,37
"['1', '00000', '0001', '0110', '000101', '110101']",1,6,16,10,4,26,7.14011544011544,48,42
"['111', '0110100', '100', '10', '000', '011001']",1,6,13,11,3,24,7.691452991452992,43,38
"['0', '111110', '111011']",1,3,3,10,2,13,1.2380952380952381,12,7
"['0111000', '10000', '011000']",1,3,12,6,0,18,2.317016317016317,6,18
"['1', '001011', '0100']",1,3,6,5,0,11,1.2857142857142856,11,5
"['0101111', '001', '111', '1001011']",1,4,7,13,4,20,3.0476190476190474,21,21
"['0101110', '00', '110', '11']",1,4,6,8,2,14,2.688888888888889,19,14
"['00', '001010', '0010']",1,3,9,3,0,12,1.9666666666666668,8,21
"['11101', '1', '1010010']",1,3,5,8,0,13,1.0833333333333333,13,8
"['011011', '110', '10011']",1,3,5,9,0,14,1.712121212121212,8,10
"['0101', '111000', '01011', '01010']",1,4,10,10,2,20,3.886868686868687,14,22
"['0', '01001', '10100', '10000']",1,4,11,5,3,16,3.0,18,14
"['010', '1011011', '100111', '11101']",1,4,7,14,0,21,3.6924630924630923,18,17
"['1010111', '1011101', '00', '110']",1,4,7,12,2,19,3.003174603174603,22,13
"['011', '1101011', '0111', '000', '110']",1,5,8,12,3,20,5.193073593073593,28,31
"['0', '1101001', '101100', '100111']",1,4,9,11,2,20,2.718864468864469,25,12
"['010', '0110111', '1000010', '00', '000111']",1,5,14,11,2,25,5.646520146520147,37,30
"['111100', '111', '101', '0011110', '1111010']",1,5,8,18,4,26,6.384371184371185,32,32
"['0001', '110', '10110', '00001']",1,4,10,7,2,17,3.019047619047619,17,19
"['1011', '1110', '0000']",1,3,6,6,3,12,1.0,8,5
"['1000001', '111', '00000', '00011', '010110', '1011100', '10', '1001001', '01000']",1,9,28,19,6,47,19.197741147741148,121,94
"['0010001', '111', '011011', '00111', '101', '10', '1010001']",1,7,15,18,4,33,12.106454656454657,66,68
"['101', '010', '110', '0000000']",1,4,11,5,3,16,2.8,22,11
"['01', '11010', '1111', '10011', '1100', '0111100']",1,6,10,17,4,27,8.441847041847042,43,42
"['01', '0111010', '1001', '100010', '1110100', '1011', '1101']",1,7,15,19,5,34,13.027500277500277,62,55
"['001100', '1010110', '001001']",1,3,11,8,2,19,2.217948717948718,8,9
"['01101', '0010111', '0011', '000000', '011010', '110', '1001011']",1,7,20,18,4,38,11.928066378066378,67,58
"['011', '11', '00110', '01001', '0100']",1,5,10,9,2,19,6.280952380952381,22,26
"['1', '100001', '100', '1010010', '0111101']",1,5,12,12,2,24,4.457875457875458,41,27
"['001', '101', '100', '001110', '0000']",1,5,12,7,3,19,5.584126984126984,25,30
"['0110101', '1000', '000', '111011']",1,4,10,10,0,20,3.394050394050394,20,14
"['100', '100111', '001001']",1,3,8,7,2,15,2.0,9,9
"['01', '01001', '1001', '00000']",1,4,11,5,2,16,3.257142857142857,15,16
"['000101', '10110', '000010']",1,3,11,6,2,17,1.7424242424242424,8,9
"['0011', '1001', '01010']",1,3,7,6,2,13,2.083333333333333,7,4
"['101', '1101', '0101110', '110101']",1,4,7,13,0,20,4.084648684648685,17,21
"['010', '1', '011', '00001', '100101', '0000011', '01100']",1,7,18,12,4,30,11.142007992007992,66,50
"['10111', '00', '10001', '1101']",1,4,7,9,2,16,3.123809523809524,16,15
"['00010', '01011', '11']",1,3,6,6,2,12,1.457142857142857,9,6
"['000110', '1010', '01110']",1,3,8,7,0,15,1.7717171717171718,7,12
"['011101', '1010000', '1']",1,3,7,7,0,14,0.9972527472527473,15,6
"['0', '0011', '0100010', '01110']",1,4,10,7,0,17,2.862121212121212,22,20
"['01', '00', '10', '111']",1,4,4,5,3,9,2.3,11,10
"['110011', '10001', '00001', '0']",1,4,10,7,2,17,3.025108225108225,19,13
"['11010', '1000', '111010']",1,3,7,8,0,15,2.175757575757576,6,11
"['100001', '1001', '0101010', '10010', '101111']",1,5,14,14,2,28,6.51965811965812,26,34
"['11', '00', '1110100', '0100']",1,4,8,7,2,15,2.616161616161616,20,19
"['11010', '11011', '000010']",1,3,8,8,2,16,1.709090909090909,8,10
"['100011', '0000000', '1', '001010']",1,4,14,6,2,20,2.315018315018315,27,10
"['001', '1101011', '1100100', '1111', '1110110', '11100', '111101']",1,7,13,26,3,39,13.133621933621933,62,92
"['001100', '0101', '00011']",1,3,9,6,0,15,1.993939393939394,8,8
"['100001', '011011', '101010', '10101', '0110', '00', '10100']",1,7,18,16,5,34,13.017604617604617,57,58
"['100', '0010100', '0111']",1,3,8,6,0,14,1.431168831168831,11,9
"['1000010', '001100', '1011001', '011001']",1,4,15,11,4,26,4.173992673992674,16,16
"['000110', '10100', '0110']",1,3,9,6,0,15,1.6080808080808082,7,12
"['001', '000011', '001000', '1010', '110', '1111111']",1,6,14,15,4,29,6.623587523587523,58,41
"['111110', '110', '11111']",1,3,2,12,0,14,2.0757575757575757,7,19
"['000100', '1000', '110111', '10', '0000', '1000011', '0101']",1,7,20,13,5,33,11.625213675213676,67,58
"['11', '101', '1001001', '01011', '110101']",1,5,9,14,0,23,6.495709845709846,29,42
"['0', '101100', '100010', '000111', '0001000']",1,5,17,9,3,26,4.773809523809524,40,31
"['10101', '11011', '00']",1,3,5,7,2,12,1.657142857142857,9,4
"['0101000', '1000101', '1001010']",1,3,13,8,3,21,2.142857142857143,9,6
"['1111100', '0', '1001101']",1,3,6,9,2,15,1.0714285714285714,15,4
"['010001', '111', '001000', '1111001', '0101', '0100']",1,6,16,14,4,30,8.874975024975026,45,43
"['01100', '11100', '10', '0111']",1,4,7,9,2,16,3.6095238095238096,15,19
"['101', '1110', '0000']",1,3,6,5,2,11,1.1071428571428572,8,4
"['011', '101000', '0111111', '1011', '0100']",1,5,10,14,2,24,5.58979908979909,33,29
"['1', '1101110', '0000']",1,3,6,6,0,12,0.6136363636363636,15,4
"['011011', '100', '111011']",1,3,5,10,2,15,1.7222222222222223,9,11
"['0011', '10000', '1010', '1100101', '1101']",1,5,12,12,3,24,5.972222222222222,27,30
"['001100', '0111010', '1011100', '11']",1,4,10,12,2,22,3.7844932844932844,20,14
"['010001', '00101', '00000', '10010', '000010', '1011', '001011', '01110']",1,8,26,16,7,42,17.58888888888889,70,83
"['000101', '10', '0110001']",1,3,9,6,0,15,1.5598290598290598,12,7
"['1000011', '100', '0']",1,3,7,4,0,11,1.35,12,6
"['01', '00101', '11', '10111', '000101']",1,5,9,11,4,20,5.84025974025974,27,31
"['0010110', '01', '11011', '0101000', '1001', '001001']",1,6,17,14,2,31,9.14942834942835,48,37
"['011', '101', '100110', '000', '110', '1110']",1,6,10,12,4,22,8.752380952380951,34,38
"['0100000', '100', '0111', '1100111', '01000']",1,5,15,11,2,26,5.532972582972583,34,32
"['0010001', '110010', '100011', '1011', '01000']",1,5,16,12,2,28,6.529059829059829,28,24
"['1010', '10011', '1101100']",1,3,7,9,0,16,1.893939393939394,8,8
"['110', '0010111', '1111101', '101', '10101', '0000110', '1100']",1,7,15,21,5,36,11.595021645021644,72,63
"['0', '100110', '010', '0011110']",1,4,9,8,0,17,2.8493894993894995,23,22
"['0', '0010010', '0110', '0100']",1,4,11,5,2,16,3.254545454545455,19,27
"['010', '00011', '11111', '0110', '1000', '0111', '000']",1,7,14,14,7,28,11.114285714285714,54,64
"['01101', '011100', '0000010', '1010011', '1010000']",1,5,19,13,3,32,5.622877122877123,32,29
"['0100010', '01', '001011', '011']",1,4,10,8,0,18,3.6264957264957265,20,17
"['0', '10100', '1110011', '11010']",1,4,8,10,2,18,3.05,22,12
"['0', '1011111', '11']",1,3,2,8,0,10,0.6944444444444444,13,6
"['100101', '10011', '1101110']",1,3,7,11,0,18,2.191142191142191,7,12
"['1000100', '0100110', '0011', '100011', '10011']",1,5,16,13,2,29,7.48059718059718,24,36
"['1000100', '00100', '100010', '1011100', '10011']",1,5,18,12,4,30,6.701065601065601,25,40
"['0101101', '1001', '00', '10', '110111']",1,5,9,12,2,21,5.205089355089355,32,20
"['11010', '10000', '0001111', '10', '1100', '1001111', '01000']",1,7,18,17,5,35,12.036075036075037,72,65
"['010', '011', '101', '1000', '0100']",1,5,10,7,5,17,6.178571428571428,19,24
"['001', '110', '011', '0000110', '01011']",1,5,11,10,3,21,5.883333333333333,28,28
"['0110000', '01', '11110', '0010011']",1,4,11,10,2,21,2.4365079365079363,26,15
"['0', '10001', '011']",1,3,5,4,0,9,1.3333333333333333,9,4
"['11110', '1101', '010110', '11']",1,4,5,12,0,17,3.732034632034632,16,17
"['0110', '011', '0001111']",1,3,6,8,0,14,2.0025974025974023,9,9
"['01', '100', '0000', '1100', '1111111']",1,5,9,11,2,20,3.781096681096681,37,26
"['01', '0011', '00']",1,3,5,3,2,8,1.8333333333333333,5,8
"['101010', '00', '001']",1,3,7,4,0,11,1.7444444444444445,8,8
"['1001001', '010', '001', '10011']",1,4,10,8,2,18,3.95,17,15
"['11001', '101000', '01011', '0']",1,4,9,8,2,17,2.625108225108225,20,11
"['0010', '00000', '110001', '1111', '00110', '10', '1101', '01100']",1,8,19,16,6,35,15.157864357864357,78,70
"['101000', '1', '10']",1,3,5,4,0,9,1.4523809523809523,10,7
"['01', '0001110', '100001']",1,3,9,6,0,15,1.5598290598290598,13,5
"['11001', '111', '0001111', '110111', '011111', '1100', '110101']",1,7,11,26,3,37,13.501925851925852,58,108
"['011', '1010', '1', '0000100']",1,4,9,6,0,15,2.666883116883117,22,10
"['01', '0010', '1110010', '0100']",1,4,10,7,2,17,3.80050505050505,18,19
"['0011', '00101', '1111']",1,3,5,8,2,13,1.8333333333333333,6,10
"['01', '100010', '00000', '11111']",1,4,10,8,2,18,2.1623376623376624,23,10
"['010', '1', '00000']",1,3,7,2,0,9,1.0,10,4
"['11001', '1011', '00010', '0100']",1,4,10,8,4,18,3.322222222222222,15,10
"['0110101', '100', '110', '010000']",1,4,11,8,2,19,3.439316239316239,19,14
"['10111', '11010', '0000001', '1011100']",1,4,12,12,4,24,3.052380952380952,23,18
"['01', '001', '0000', '1011', '1011111']",1,5,9,11,2,20,4.946392496392496,32,25
"['1', '0011000', '1011110', '0011', '010111']",1,5,11,14,2,25,5.2144855144855145,39,23
"['011', '00100', '0000', '0101', '1101010']",1,5,14,9,2,23,6.237806637806638,26,28
"['111010', '10110', '100011', '000001', '111101']",1,5,13,16,4,29,5.363636363636363,31,29
"['01', '101011', '10001', '1001', '0010100', '00110', '10100', '000', '1011']",1,9,23,18,5,41,22.52065157065157,93,105
"['001', '0101101', '101', '0101100', '110101']",1,5,12,14,4,26,5.865689865689865,29,33
"['010', '010000', '011', '101', '10001', '10000', '1101', '101111']",1,8,18,17,7,35,16.123232323232322,77,78
"['001011', '011', '0101001']",1,3,8,8,0,16,2.0358974358974358,9,9
"['0', '11110', '01100']",1,3,5,6,2,11,1.2666666666666666,10,8
"['1100101', '10', '111']",1,3,4,8,0,12,1.4444444444444444,11,10
"['00110', '1101000', '000']",1,3,10,5,0,15,1.85,10,15
"['11000', '0010', '110', '11']",1,4,7,7,0,14,3.4706349206349207,14,18
"['011011', '1011', '10']",1,3,4,8,0,12,1.9666666666666668,8,10
"['0111101', '011110', '11']",1,3,4,11,0,15,1.8675213675213675,10,9
"['010', '10110', '110100', '0100']",1,4,10,8,0,18,4.467748917748918,12,20
"['01101', '11', '00', '00110', '01010', '011001', '1010010']",1,7,17,15,5,32,12.683660783660784,62,54
"['00111', '0111011', '0000']",1,3,8,8,0,16,1.4747474747474747,11,9
"['010', '001101', '101', '101000', '1110101', '111111', '010111', '0000111', '0100011']",1,9,22,29,9,51,21.095604395604397,121,114
"['1110011', '100', '1110', '11111']",1,4,5,14,0,19,3.648701298701299,17,28
"['00001', '0110100', '11']",1,3,8,6,0,14,1.0634920634920635,13,5
"['0100110', '011', '1', '001000', '10000']",1,5,14,8,0,22,4.8266622266622266,37,22
"['101010', '110', '010111', '0000']",1,4,10,9,2,19,2.841269841269841,20,14
"['111011', '111', '0', '00001']",1,4,6,9,0,15,1.8993506493506493,23,16
"['100001', '00111', '111110', '10', '01110', '01100']",1,6,13,16,5,29,8.234632034632034,49,39
"['01', '1010', '1010010']",1,3,7,6,0,13,1.8383838383838382,10,11
"['00111', '11000', '010000', '00001']",1,4,14,7,3,21,3.418181818181818,18,23
"['1000000', '1010', '1']",1,3,8,4,0,12,1.1954545454545453,13,7
"['1111100', '1010', '100', '1011111']",1,4,7,14,2,21,3.662337662337662,21,22
"['0011011', '101', '011011', '000']",1,4,9,10,2,19,3.5675213675213673,18,17
"['010000', '001', '11', '101101', '10111', '1101000', '00110', '000100', '11100', '1111011']",1,10,25,27,8,52,24.332140082140082,148,135
"['0110', '1', '111100']",1,3,4,7,0,11,1.2857142857142856,11,4
"['11000', '0100000', '10']",1,3,10,4,0,14,1.6825396825396823,11,8
"['1001', '110', '10']",1,3,4,5,0,9,2.038095238095238,5,8
"['101100', '110010', '100011', '011111', '110']",1,5,11,16,4,27,5.722222222222222,35,29
"['0111001', '0101000', '01111', '0001101', '01000']",1,5,17,14,5,31,6.4,29,40
"['11011', '00111', '101010', '00', '010111', '1101', '111000']",1,7,14,20,5,34,12.257142857142856,63,65
"['0001', '010111', '10000', '10']",1,4,10,7,0,17,2.835064935064935,19,15
"['010011', '1100000', '100111', '11']",1,4,10,11,2,21,3.200854700854701,23,23
"['10111', '10010', '11']",1,3,4,8,2,12,1.7428571428571429,8,11
"['10101', '000101', '110101']",1,3,8,9,2,17,2.3030303030303028,5,18
"['0010', '110010', '1110011', '00', '000111']",1,5,13,12,2,25,5.941181041181041,34,32
"['0100000', '0010', '1111', '001110', '0111', '0000']",1,6,17,12,4,29,7.57972027972028,46,54
"['011011', '11101', '10']",1,3,4,9,0,13,1.7987012987012987,9,7
"['0', '11000', '110010']",1,3,7,5,0,12,1.528138528138528,10,9
"['0111', '1000100', '000']",1,3,9,5,0,14,1.2493506493506494,12,8
"['0011000', '10011', '01110', '011111', '101001']",1,5,13,16,4,29,5.901864801864802,32,21
"['1111', '0011', '00', '001000']",1,4,9,7,2,16,2.466666666666667,20,21
"['0', '000111', '0100']",1,3,7,4,0,11,1.0857142857142859,12,9
"['000100', '11000', '010', '0110']",1,4,12,6,0,18,3.8359307359307357,16,23
"['1111100', '01', '100001', '010111', '10', '0100100', '0000', '10011']",1,8,21,18,6,39,14.457908757908758,101,71
"['0', '100001', '0101101', '1111', '110111', '01110']",1,6,11,18,2,29,7.009074259074259,53,34
"['01', '110001', '010000']",1,3,9,5,2,14,1.6666666666666665,10,6
"['00', '01101', '10', '11']",1,4,5,6,3,11,2.7142857142857144,13,10
"['0', '101011', '0011', '001']",1,4,7,7,0,14,3.287301587301587,16,14
"['101010', '0011', '1000000', '00', '01100']",1,5,16,8,0,24,5.4736818736818735,35,32
"['010', '011', '01001', '1110', '011000']",1,5,11,10,2,21,6.414574314574314,23,32
"['11110', '0011001', '1101', '1111', '1010', '0110010', '111000']",1,7,15,22,5,37,13.587212787212787,56,62
"['00010', '111110', '00011']",1,3,8,8,2,16,1.5272727272727273,9,11
"['0001011', '11010', '1100', '110010']",1,4,11,11,0,22,4.077000777000777,17,25
"['11111', '0001', '1010011']",1,3,6,10,0,16,1.2828282828282829,10,10
"['1001001', '01', '1100', '10011']",1,4,9,9,0,18,3.3946608946608947,19,19
"['1', '010010', '1110']",1,3,5,6,0,11,1.0857142857142859,11,5
"['11010', '11', '11000', '10100', '00']",1,5,10,9,5,19,5.828571428571428,25,29
"['0', '0011001', '101', '0011010', '1111', '1100011', '001001']",1,7,17,18,3,35,10.899683649683649,79,55
"['0', '0011111', '10']",1,3,4,6,0,10,1.1388888888888888,13,6
"['1011', '11000', '00', '1']",1,4,6,6,0,12,2.0825396825396822,18,13
"['00111', '110', '101101']",1,3,5,9,0,14,1.893939393939394,8,7
"['001100', '0001', '0101', '100']",1,4,11,6,2,17,3.5095238095238095,14,19
"['1101000', '100', '1110', '0000']",1,4,11,7,2,18,3.0837662337662337,17,20
"['01', '101', '00100', '1100', '001011', '0110001']",1,6,15,12,0,27,8.47005217005217,45,41
"['10101', '010', '010111', '0111110']",1,4,8,13,0,21,3.6926573426573426,17,15
"['0000', '0001', '1101010']",1,3,10,5,2,15,1.6590909090909092,9,10
"['000110', '001', '1', '0110']",1,4,8,6,0,14,3.223809523809524,17,14
"['110000', '011', '11000', '1111001', '0101']",1,5,12,13,0,25,5.782628482628483,33,33
"['11011', '101000', '10111', '1001', '110']",1,5,9,14,2,23,6.09011544011544,25,36
"['1000001', '001', '0001111', '1011', '0101']",1,5,13,12,4,25,5.846103896103896,33,29
"['0100010', '100', '111', '00011']",1,4,10,8,2,18,3.0,20,13
"['110', '1', '00000']",1,3,6,3,0,9,0.75,11,4
"['0', '0001100', '11011', '1010001']",1,4,11,9,2,20,2.571428571428571,27,8
"['110110', '1', '01010']",1,3,5,7,0,12,1.3463203463203464,11,5
"['01', '100001', '1001', '1111110', '0000001', '11101', '011110', '0000', '0100']",1,9,24,21,7,45,18.036313686313687,128,101
"['0', '0101111', '0101110', '10101', '011110', '001100']",1,6,14,18,4,32,8.094072594072594,50,44
"['00101', '0011', '1110011', '0001100', '1000', '0101']",1,6,17,14,5,31,9.735569985569985,47,46
"['010', '0111', '11']",1,3,3,6,0,9,1.638095238095238,6,7
"['0', '111', '110101']",1,3,3,7,0,10,0.9523809523809523,11,6
"['011', '10001', '100', '1111010', '011001', '01001']",1,6,14,15,4,29,9.468414918414918,43,44
"['11010', '00000', '0110000', '0101100', '1010011']",1,5,19,12,5,31,5.59047619047619,32,31
"['0001', '1111000', '10', '1101', '001001']",1,5,12,11,2,23,5.196891996891996,34,29
"['0001100', '010', '001111']",1,3,9,7,0,16,1.6598290598290597,11,10
"['1000', '001', '1101', '00001']",1,4,10,6,2,16,3.503968253968254,13,20
"['1101000', '010', '1101010']",1,3,9,8,2,17,2.057142857142857,9,12
"['01111', '1000', '0110', '111']",1,4,6,10,2,16,2.996031746031746,16,16
"['110011', '111110', '11101', '1011000']",1,4,8,16,2,24,3.851981351981352,17,20
"['0', '10100', '0011101', '0111001']",1,4,10,10,2,20,2.857142857142857,25,14
"['1011', '00', '01111', '00001']",1,4,8,8,2,16,2.7015873015873013,18,13
"['0', '101010', '1000', '0111', '1001111']",1,5,10,12,2,22,4.873826173826174,36,24
"['00', '10', '011110', '11111', '1111011']",1,5,6,16,2,22,4.782217782217782,36,25
"['01011', '1001', '0010100']",1,3,9,7,0,16,1.6565656565656566,9,4
"['11011', '10110', '1000111', '0000011', '01010']",1,5,14,15,5,29,6.247619047619048,31,26
"['0010', '010101', '011']",1,3,7,6,0,13,1.838095238095238,7,7
"['0001011', '00', '11']",1,3,6,5,2,11,0.8888888888888888,12,8
"['11110', '00000', '10001', '1001', '0001', '111000']",1,6,17,12,5,29,8.705555555555556,40,49
"['1110111', '01', '10', '1111']",1,4,3,12,2,15,2.782828282828283,21,22
"['1010', '110', '1']",1,3,3,5,0,8,1.4714285714285715,6,7
"['1010111', '1100101', '10', '0101', '11100', '110101']",1,6,12,19,2,31,9.626506826506827,45,54
"['011011', '00', '0101', '10']",1,4,7,7,2,14,3.6333333333333333,15,13
"['1001110', '101', '10101', '0011']",1,4,8,11,0,19,3.982034632034632,16,20
"['0000110', '110', '011', '1101010']",1,4,10,10,4,20,3.4952380952380953,22,20
"['1011101', '1100101', '101101']",1,3,7,13,2,20,1.9670329670329672,6,22
"['00111', '10101', '0111001']",1,3,7,10,2,17,1.9333333333333331,8,7
"['1010010', '001', '011']",1,3,7,6,2,13,1.8666666666666667,9,6
"['10100', '1101', '1110010', '11111']",1,4,7,14,2,21,3.793939393939394,16,21
"['111', '1101000', '00', '10', '1100111', '1001011']",1,6,12,16,5,28,7.166666666666666,57,49
"['0', '011', '0010101']",1,3,6,5,0,11,1.35,12,6
"['1', '100', '10100', '01010', '0001011', '1010000', '1110110']",1,7,19,16,5,35,11.53095238095238,77,56
"['0', '00011', '0111011', '0100']",1,4,9,8,0,17,2.473232323232323,23,18
"['01', '00', '1001000']",1,3,8,3,2,11,1.3888888888888888,11,8
"['00', '110', '1100101']",1,3,6,6,0,12,1.4444444444444444,11,6
"['0101', '100', '0110011']",1,3,7,7,0,14,1.8987012987012988,9,7
"['0100000', '100010', '1010', '00', '100111', '010110', '0011100']",1,7,23,15,5,38,12.597380397380398,70,64
"['0001001', '00', '1010101', '001010']",1,4,14,8,2,22,3.6416361416361416,22,16
"['011111', '0101', '010']",1,3,5,8,0,13,1.9015873015873015,8,10
"['0', '1000111', '01110']",1,3,6,7,0,13,1.25,14,4
"['0', '0010', '010101', '10110']",1,4,9,7,0,16,3.012987012987013,19,15
"['0010', '010', '10111', '101', '000']",1,5,10,8,3,18,5.896825396825396,21,22
"['000110', '01', '111110', '000010']",1,4,11,9,3,20,2.9166666666666665,21,20
"['0100001', '1110110', '11111']",1,3,7,12,2,19,1.5952380952380953,12,10
"['11011', '011', '0011', '0101011', '1111', '0000', '1001111']",1,7,13,21,5,34,12.11089466089466,60,82
"['0010', '01', '111', '011', '10001', '000000', '001011']",1,7,17,12,4,29,10.702813852813852,63,53
"['01', '1010', '000', '011001', '1010010']",1,5,13,9,0,22,5.723487623487624,32,27
"['0000101', '10111', '0100100', '01000']",1,4,15,9,4,24,3.447619047619048,19,17
"['1011110', '00', '1001']",1,3,6,7,0,13,1.6565656565656566,11,5
"['0', '101010', '0011', '100010', '0001101']",1,5,14,10,2,24,5.046137196137196,36,24
"['01', '0010', '0100', '1011', '011000']",1,5,12,8,3,20,6.25,26,26
"['11110', '0100110', '1', '0110', '1000', '010011', '111001']",1,7,15,18,4,33,11.383122433122432,69,56
"['1110101', '00', '110010']",1,3,7,8,0,15,1.7136752136752138,11,5
"['010', '1', '0001', '100', '0110110']",1,5,10,8,2,18,5.023160173160173,31,21
"['1101', '001', '010101', '0000']",1,4,10,7,2,17,3.037301587301587,15,16
"['1010', '010', '0110']",1,3,6,5,2,11,2.2142857142857144,4,13
"['00', '0110', '101111', '11']",1,4,5,9,2,14,2.683333333333333,18,10
"['01001', '1011011', '11111']",1,3,5,12,2,17,1.7333333333333334,8,10
"['11001', '101100', '0111100', '00000', '1000110', '10110', '10000', '1101', '011000']",1,9,28,22,8,50,22.513697413697415,99,110
"['00110', '1110001', '010']",1,3,8,7,0,15,1.65,12,5
"['0100110', '111', '000']",1,3,7,6,2,13,1.0,11,4
"['1100011', '1000', '000010', '11']",1,4,11,8,0,19,2.9704351204351203,22,16
"['01', '1011110', '00', '10010', '0111']",1,5,9,11,2,20,5.37012987012987,31,23
"['110110', '1', '00000', '100110', '01010', '1110']",1,6,14,13,4,27,7.168398268398269,47,39
"['100010', '0000011', '001000']",1,3,14,5,2,19,1.7435897435897436,9,9
"['10100', '000', '0111']",1,3,7,5,0,12,1.2301587301587302,8,8
"['0', '1010', '10010', '111001']",1,4,8,8,0,16,3.235209235209235,19,13
"['1001110', '0111011', '11', '0011', '10110', '0110']",1,6,11,18,4,29,10.04076479076479,44,44
"['11110', '011100', '00001', '00111', '1010100', '100', '100010', '100101', '000', '111001']",1,10,28,24,9,52,25.78772338772339,134,131
"['1001', '111', '0111']",1,3,3,8,2,11,1.9285714285714284,6,12
"['110010', '01', '1001010', '1000111', '00']",1,5,13,11,4,24,5.376678876678877,37,23
"['10100', '110', '1']",1,3,4,5,0,9,1.3333333333333333,8,6
"['110000', '011', '00001', '0100010', '0001', '1111', '101111']",1,7,18,17,4,35,11.494333444333444,68,64
"['010', '011', '001000', '100110', '00110']",1,5,14,9,4,23,6.9141414141414135,24,36
"['1', '1001111', '10']",1,3,3,7,0,10,1.3611111111111112,12,9
"['010', '11011', '10', '00001']",1,4,8,7,2,15,3.057142857142857,17,11
"['0100110', '100', '10110', '1111010', '1100011', '101111']",1,6,14,21,3,35,9.448823398823398,48,45
"['010000', '101101', '11', '1000', '001100']",1,5,14,10,3,24,5.416666666666667,33,23
"['10101', '100', '10', '11']",1,4,5,7,2,12,3.592857142857143,12,17
"['01', '01111', '0110100']",1,3,6,8,0,14,1.6825396825396823,11,10
"['11011', '100001', '11101', '11']",1,4,6,12,2,18,3.533766233766234,18,33
"['1111100', '101100', '100010']",1,3,9,10,2,19,1.7307692307692308,9,10
"['0', '101', '001110']",1,3,5,5,0,10,1.2301587301587302,11,4
"['0011', '0011101', '0000000', '11']",1,4,12,8,2,20,2.6305916305916304,26,19
"['01', '010', '1000011', '1010001', '010011']",1,5,14,11,2,25,6.108302808302808,33,27
"['010', '0100', '11']",1,3,5,4,0,9,1.5904761904761904,6,6
"['1110110', '000010', '1101']",1,3,8,9,0,17,1.434965034965035,11,6
"['1010111', '1001', '11']",1,3,4,9,0,13,1.8383838383838382,10,15
"['0', '01011', '111']",1,3,3,6,0,9,0.8333333333333333,9,6
"['100100', '1', '011', '1000111']",1,4,8,9,0,17,2.6955433455433457,24,17
"['0', '101', '0111010', '1001111']",1,4,7,11,2,18,2.914285714285714,26,9
"['0110000', '01101', '1']",1,3,7,6,0,13,1.25,13,7
"['1', '00101', '011100', '0001111', '01010', '1101', '0100']",1,7,16,16,4,32,11.191502941502941,66,52
"['0011', '10001', '1001', '00110', '000111']",1,5,13,11,4,24,7.315656565656566,22,28
"['110110', '11110', '1110']",1,3,4,11,0,15,2.0343434343434343,4,17
"['0001', '0101', '0000']",1,3,9,3,3,12,1.75,4,11
"['01', '1001', '0111']",1,3,4,6,2,10,1.8333333333333333,7,8
"['101', '1101101', '010000']",1,3,8,8,0,16,1.505982905982906,12,6
"['011001', '1111101', '001', '10101', '000000', '1011000', '1000011', '000111', '101001']",1,9,28,25,7,53,20.1005217005217,119,119
"['0', '10111', '11010', '11']",1,4,4,9,2,13,2.4095238095238094,19,15
"['1010001', '0011110', '1', '0000010']",1,4,13,9,3,22,2.4642857142857144,29,10
"['1100011', '1000', '111001']",1,3,8,9,0,17,2.0965034965034963,8,10
"['00101', '000', '001100', '111000', '110']",1,5,14,9,4,23,6.1893939393939394,28,39
"['00011', '0011101', '100111', '0000']",1,4,12,10,0,22,3.775291375291375,18,18
"['0', '0100111', '11100']",1,3,6,7,0,13,1.0833333333333333,15,8
"['110110', '11110', '00', '1']",1,4,5,9,0,14,1.95021645021645,20,13
"['001', '00011', '100', '0000', '0101']",1,5,13,6,4,19,6.035714285714286,20,32
"['0', '1010100', '10011']",1,3,7,6,0,13,1.0833333333333333,13,5
"['011101', '0011', '010100']",1,3,8,8,2,16,1.6666666666666665,8,8
"['0110111', '00100', '0010100', '1011', '01011']",1,5,14,14,4,28,6.61082251082251,28,32
"['011011', '0101', '11100']",1,3,6,9,0,15,1.7898989898989899,8,8
"['01', '10101', '1001110', '001111']",1,4,8,12,0,20,3.497224997224997,20,14
"['1111', '111011', '1110001', '00', '1111011']",1,5,7,19,2,26,5.577805527805528,33,58
"['101', '0001', '100', '111001']",1,4,8,8,2,16,3.742857142857143,14,20
"['0100000', '00101', '011', '111']",1,4,10,8,2,18,3.0166666666666666,21,14
"['10100', '10', '000000', '11']",1,4,10,5,2,15,2.2564935064935066,21,13
"['1', '011', '001000']",1,3,6,4,0,10,1.2301587301587302,11,4
"['0010', '10', '0000', '1101', '110101']",1,5,11,9,3,20,5.466666666666667,27,24
"['0010110', '1', '0011000', '1101101', '1010', '101111', '0100']",1,7,17,19,5,36,11.25004995004995,77,46
"['00100', '0101', '1110', '101101']",1,4,9,10,2,19,3.5565656565656565,15,12
"['0100010', '010', '111']",1,3,7,6,2,13,1.3333333333333333,11,8
"['11000', '0101000', '1', '011']",1,4,9,7,0,16,3.0166666666666666,22,15
"['001111', '0110', '10', '11']",1,4,5,9,2,14,3.183333333333333,17,13
"['01001', '10', '01010']",1,3,7,5,2,12,1.9428571428571428,8,9
"['110000', '00101', '101', '100', '1010', '01110']",1,6,14,12,4,26,8.962265512265512,39,38
"['1000010', '010', '001', '0000']",1,4,13,4,2,17,3.7367965367965366,17,18
"['101', '01011', '000']",1,3,6,5,2,11,1.5833333333333333,7,4
"['1111', '1101010', '0111010', '00011']",1,4,9,14,2,23,3.4466089466089467,19,18
"['0', '0110111', '11000', '1000', '01110']",1,5,11,11,2,22,4.78030303030303,36,28
"['11110', '100', '1001', '111011']",1,4,6,12,0,18,3.573304473304473,16,19
"['0', '110000', '1001']",1,3,7,4,0,11,1.2857142857142856,11,4
"['110011', '101', '10101', '000']",1,4,8,9,2,17,3.4217171717171717,17,16
"['0010111', '000', '0111']",1,3,7,7,0,14,1.612987012987013,10,11
"['0001110', '1111101', '011']",1,3,6,11,2,17,1.5714285714285714,13,5
"['0011', '10010', '0110']",1,3,7,6,2,13,1.8611111111111112,6,7
"['01', '101', '10111']",1,3,3,7,0,10,2.1214285714285714,6,11
"['01', '10000', '0111']",1,3,6,5,0,11,1.1746031746031744,10,7
"['0110', '010110', '000']",1,3,8,5,0,13,2.038095238095238,7,16
"['001100', '1010', '101', '110100']",1,4,10,9,2,19,4.034920634920635,16,15
"['101000', '110', '1110000']",1,3,9,7,0,16,1.8136752136752137,9,9
"['1011', '00110', '10010', '1']",1,4,7,8,2,15,3.2,17,12
"['110', '101110', '000', '111']",1,4,6,9,3,15,2.7777777777777777,16,14
"['00111', '01011', '11']",1,3,4,8,2,12,1.9428571428571428,8,11
"['01101', '1100000', '11100']",1,3,9,8,2,17,1.7666666666666666,10,8
"['1010', '1000', '10110', '0000011']",1,4,12,8,2,20,3.7146464646464645,18,19
"['11011', '101', '1010111', '000', '01011', '0100101']",1,6,13,17,6,30,9.297619047619047,43,43
"['01', '1100101', '111']",1,3,4,8,0,12,1.4444444444444444,11,11
"['0', '0011011', '0001110']",1,3,8,7,2,15,1.2142857142857144,15,9
"['01', '100001', '0001', '1100000', '10100']",1,5,16,8,0,24,5.731568431568432,31,30
"['0011011', '01', '0010111']",1,3,7,9,2,16,1.746031746031746,12,9
"['00', '1010110', '11111']",1,3,5,9,0,14,0.7777777777777777,13,4
"['01101', '100111', '01000']",1,3,8,8,2,16,1.8727272727272726,9,5
"['010100', '100001', '0100010', '010010', '0110000', '000000', '0111', '0001011', '0100001']",1,9,38,18,8,56,22.985481185481184,97,133
"['0010', '00', '0011011', '110', '110101']",1,5,11,11,0,22,5.945709845709846,31,29
"['0011', '1101000', '1011']",1,3,7,8,2,15,1.6590909090909092,10,11
"['11110', '010', '001', '0111011']",1,4,7,11,2,18,3.083333333333333,20,15
"['1', '1100010', '0001', '1010100', '010101']",1,5,14,11,2,25,4.478821178821179,37,22
"['110011', '100110', '11100', '1111110']",1,4,8,16,2,24,3.8496503496503496,17,20
"['0', '010000', '0011001', '01111', '1010', '111000', '1001111']",1,7,18,18,4,36,10.484004884004884,80,54
"['110000', '001001', '111', '1011111']",1,4,9,13,2,22,2.758119658119658,25,22
"['1100001', '1010101', '100', '0000', '0101']",1,5,15,10,4,25,5.95974025974026,31,26
"['1110001', '01', '001001', '0010000']",1,4,14,8,2,22,3.344932844932845,22,19
"['10101', '1100', '011', '10']",1,4,6,8,0,14,3.626190476190476,14,14
"['0010', '001', '110111', '000', '011010', '110']",1,6,13,12,5,25,8.596825396825396,40,43
"['0011001', '100', '011', '1000111']",1,4,10,10,4,20,3.4476190476190474,23,16
"['01', '1100001', '10001', '1101']",1,4,9,9,0,18,3.90981240981241,17,28
"['10111', '0011101', '110']",1,3,5,10,0,15,1.7666666666666666,10,7
"['1', '111100', '0010000', '11000', '101']",1,5,12,10,0,22,4.568969918969919,38,25
"['01', '001000', '10101', '1111', '0100']",1,5,11,10,2,21,5.20021645021645,29,20
"['01', '0010100', '1111']",1,3,6,7,0,13,1.1414141414141414,13,4
"['1001110', '1000001', '11', '100101', '0100100', '01001']",1,6,19,15,3,34,9.606393606393606,50,45
"['1111010', '1000', '11']",1,3,5,8,0,13,1.323232323232323,12,8
"['101010', '00', '010', '11']",1,4,7,6,2,13,2.8666666666666667,16,12
"['0000110', '011', '00000']",1,3,11,4,0,15,1.6833333333333333,10,14
"['10001', '011', '00000']",1,3,9,4,2,13,1.35,9,4
"['100100', '0110', '000010']",1,3,11,5,2,16,1.6666666666666665,9,10
"['0010100', '110', '0110100', '11']",1,4,10,9,2,19,3.546031746031746,20,17
"['001', '0011', '10100', '01001', '11100']",1,5,12,10,3,22,6.362698412698412,25,31
"['0011', '1100', '1111000']",1,3,7,8,2,15,1.5909090909090908,12,12
"['010', '111010', '011', '100', '00110', '01010', '1100', '0110110']",1,8,18,18,5,36,18.697008547008547,70,99
"['1111100', '010000', '101000', '1101', '1100']",1,5,14,13,4,27,6.332983682983683,29,31
"['011101', '1001', '10']",1,3,5,7,0,12,1.5666666666666667,9,8
"['10101', '11010', '110100']",1,3,7,9,2,16,2.4363636363636365,5,10
"['001', '000', '1110']",1,3,6,4,2,10,1.2380952380952381,7,8
"['01', '001', '1101111', '100111', '000', '01011']",1,6,11,15,2,26,8.256820956820956,47,38
"['101', '0011', '100011', '110', '0100101']",1,5,11,12,2,23,6.217138417138417,30,30
"['0101101', '0010011', '0000', '1011', '0101001']",1,5,16,13,5,29,6.496753246753247,28,26
"['010', '1011001', '101101']",1,3,7,9,0,16,2.18974358974359,8,9
"['1010111', '1100010', '0010']",1,3,9,9,2,18,1.844155844155844,11,8
"['10001', '10100', '0100001', '1100', '01110']",1,5,15,11,3,26,6.167676767676768,27,25
"['110000', '1100010', '1011', '0111']",1,4,10,11,2,21,3.3821678321678323,21,21
"['1011', '10', '0110001', '0100']",1,4,9,8,2,17,3.55050505050505,19,12
"['010', '00000', '11000', '1000010', '01010', '0100011']",1,6,22,10,5,32,9.297619047619047,42,53
"['1000011', '010000', '111000', '00101']",1,4,15,9,2,24,3.6270396270396272,19,15
"['1001110', '111111', '10100', '0111']",1,4,7,15,0,22,3.096891996891997,19,17
"['01001', '0100', '11']",1,3,6,5,0,11,1.7936507936507935,7,7
"['0', '001', '1111101']",1,3,4,7,0,11,1.15,13,5
"['0', '010', '010101', '11']",1,4,6,6,0,12,2.3523809523809525,18,12
"['110000', '100', '0010100', '1101100', '1000', '00', '01110']",1,7,21,13,2,34,12.643323343323344,64,82
"['11001', '1011010', '1101110', '100010', '00', '01110']",1,6,15,17,4,32,9.464413364413364,45,41
"['0011', '001', '10000']",1,3,8,4,0,12,1.8015873015873014,7,10
"['10100', '001101', '0100']",1,3,9,6,0,15,1.8343434343434342,7,11
"['0110101', '01', '1001']",1,3,6,7,0,13,1.4747474747474747,10,10
"['00', '11011', '111', '00011']",1,4,6,9,2,15,2.7071428571428573,17,21
"['1101', '1', '01011']",1,3,3,7,0,10,1.4,9,9
"['010', '11', '1000000', '100110', '10']",1,5,12,8,2,20,5.0487179487179485,34,25
"['010', '1111', '0101010', '00', '1000']",1,5,11,9,2,20,4.890981240981241,31,26
"['01', '101000', '10000', '0011111', '0010010']",1,5,16,11,2,27,5.05022755022755,38,29
"['101', '01', '1110', '0001111']",1,4,6,10,0,16,3.0946608946608944,20,15
"['110110', '010', '101', '100110', '1100']",1,5,10,12,4,22,6.487301587301587,24,26
"['101', '1101101', '100', '00', '011111', '111001']",1,6,10,17,4,27,8.312393162393162,49,41
"['1100011', '1110', '0']",1,3,5,7,0,12,1.1954545454545453,13,6
"['0010010', '010000', '10', '111101']",1,4,12,9,2,21,2.8547008547008548,23,12
"['0011', '0111101', '001000']",1,3,9,8,0,17,1.606993006993007,11,9
"['010', '00101', '00111', '1111', '110011', '0000011']",1,6,14,16,2,30,8.858169608169607,45,49
"['00100', '01101', '101001']",1,3,9,7,2,16,1.8727272727272726,6,5
"['0010', '110', '000000']",1,3,10,3,0,13,1.3936507936507936,10,11
"['0000110', '1', '011000']",1,3,9,5,0,14,1.151098901098901,15,6
"['01101', '10', '111']",1,3,3,7,0,10,1.7214285714285715,7,6
"['1000110', '01', '10011', '000']",1,4,10,7,0,17,3.3492063492063493,19,12
"['0100000', '11', '101', '100', '10']",1,5,10,7,4,17,5.633333333333334,27,22
"['1000', '110', '10', '1000111']",1,4,8,8,0,16,3.6098124098124096,18,19
"['0', '100010', '1111010', '10100', '1011']",1,5,11,12,0,23,4.908674658674658,35,25
"['01', '1101', '10']",1,3,3,5,2,8,1.8333333333333333,6,7
"['010100', '010', '1011101', '00', '1010010', '1110']",1,6,15,14,2,29,8.55012765012765,49,40
"['1', '0000', '1101', '11100', '01011', '0100']",1,6,12,11,5,23,6.6722222222222225,42,37
"['001111', '000111', '0101', '110', '1110']",1,5,9,14,4,23,6.050793650793651,28,32
"['0001001', '1010', '100', '0110110']",1,4,12,9,2,21,3.901298701298701,20,15
"['1000000', '00', '010001', '10110']",1,4,14,6,0,20,3.1767121767121766,23,15
"['1001100', '110010', '0011110', '11']",1,4,10,12,2,22,3.333943833943834,24,14
"['101', '11', '001000']",1,3,6,5,0,11,1.4944444444444445,10,4
"['01', '111', '0111']",1,3,2,7,0,9,1.9238095238095236,5,11
"['0', '101000', '11010', '010011']",1,4,10,8,2,18,2.844155844155844,22,13
"['0100000', '111', '1011101', '0100100', '1011', '000100', '111001']",1,7,21,19,5,40,11.4999777999778,74,59
"['110000', '1110111', '011100', '11', '1000', '110']",1,6,12,16,2,28,8.58976578976579,50,46
"['0', '101', '1101100', '1100', '001011']",1,5,10,11,0,21,5.016466866466867,36,27
"['0011', '01', '111000']",1,3,6,6,0,12,1.3166666666666667,12,8
"['01', '111', '011100', '00001', '0011', '1111010', '1100110', '1110']",1,8,16,22,4,38,15.353951603951604,92,82
"['1110101', '00', '100001']",1,3,8,7,0,15,1.5598290598290598,12,5
"['1110010', '1000', '1011000', '1110110', '01100']",1,5,15,15,3,30,7.261904761904762,26,30
"['11010', '00111', '01010', '1011', '1110']",1,5,9,14,5,23,6.277777777777778,22,30
"['1', '101', '11000', '100', '1111010']",1,5,8,11,2,19,5.366666666666666,31,25
"['11110', '111', '00000', '101', '1011101', '1000', '010110', '000001', '011010']",1,9,23,22,7,45,18.792185592185593,114,97
"['0101101', '10111', '00', '0101000']",1,4,11,10,2,21,3.2222222222222223,22,15
"['10100', '00', '1100', '1101']",1,4,8,7,2,15,3.876984126984127,12,18
"['10111', '00', '1010100']",1,3,7,7,0,14,1.3968253968253967,12,8
"['11011', '10110', '100010', '10100', '010110']",1,5,13,14,5,27,6.881818181818182,21,28
"['01110', '110100', '1111']",1,3,5,10,0,15,1.812121212121212,8,6
"['1011', '001011', '1100100', '0100']",1,4,11,10,2,21,3.7881118881118883,19,20
"['1110110', '010', '0001110', '10']",1,4,9,10,2,19,3.2603174603174603,23,21
"['00', '0101110', '111']",1,3,5,7,0,12,1.0444444444444443,12,4
"['011111', '1010', '0010', '0110']",1,4,8,10,3,18,3.4,15,20
"['0000011', '010000', '111', '011000']",1,4,14,8,2,22,2.976923076923077,22,20
"['0100010', '01', '11101', '110000']",1,4,11,9,0,20,2.913891663891664,22,13
"['00000', '100', '1010011', '110', '01011', '1111111']",1,6,13,17,6,30,6.035714285714286,56,41
"['0111000', '1111010', '011110', '11111', '101110']",1,5,10,21,4,31,7.2306027306027305,23,32
"['0010', '011', '100', '1111', '10100', '11101', '000']",1,7,13,14,7,27,10.484920634920634,51,56
"['011', '001000', '101000', '1101101', '10', '0001011']",1,6,17,14,4,31,7.936385836385837,55,43
"['101', '0011', '100', '00001']",1,4,9,6,2,15,3.4761904761904763,14,17
"['011101', '00', '01011', '1101']",1,4,7,10,0,17,3.416883116883117,16,15
"['00', '11011', '0100']",1,3,6,5,0,11,1.3968253968253967,9,6
"['1000101', '10101', '00', '000010', '110']",1,5,14,9,0,23,5.408336108336108,31,23
"['01111', '0001000', '11']",1,3,7,7,0,14,1.126984126984127,14,6
"['1000000', '1', '01011', '100110']",1,4,11,8,0,19,2.545038295038295,26,14
"['1001110', '00111', '110111']",1,3,6,12,0,18,2.3298368298368297,6,10
"['1010110', '1111', '0110000', '111110', '001010', '0101']",1,6,15,19,6,34,8.266300366300367,47,40
"['001', '1', '101010', '100110', '110']",1,5,9,10,4,19,4.7936507936507935,31,25
"['100000', '01010', '1100', '01011', '101001']",1,5,15,11,4,26,6.174747474747475,25,24
"['10001', '010', '10', '11']",1,4,6,6,2,12,3.342857142857143,13,12
"['10001', '1100110', '10', '000']",1,4,10,7,0,17,3.4325396825396823,19,12
"['1100111', '0111101', '111']",1,3,4,13,2,17,1.7714285714285714,12,14
"['100110', '1', '100001']",1,3,7,6,2,13,1.2380952380952381,13,10
"['001100', '100', '010010']",1,3,10,5,2,15,2.0,9,11
"['100110', '010', '110', '111011']",1,4,7,11,4,18,3.5555555555555554,17,16
"['001', '010000', '1', '10110']",1,4,9,6,0,15,2.6089466089466087,21,11
"['1000', '1100', '0010011']",1,3,9,6,2,15,1.8409090909090908,9,10
"['00101', '11', '0001', '100101', '000000', '1011']",1,6,16,11,4,27,7.859307359307359,42,46
"['0010', '1', '011100', '010011', '0101']",1,5,11,10,4,21,5.021428571428571,33,23
"['000001', '0011000', '00001']",1,3,14,4,0,18,1.8706293706293706,7,19
"['0101', '10110', '1110100', '0100101']",1,4,11,12,2,23,3.6774891774891776,19,17
"['00', '00010', '111']",1,3,6,4,0,10,0.8214285714285714,10,6
"['1001110', '011', '0010000', '011010', '1001', '000010', '000111']",1,7,23,16,5,39,12.639516039516039,66,61
"['101', '1001', '0110']",1,3,5,6,2,11,1.9285714285714284,7,6
"['00011', '10101', '0011010', '0111', '0000', '0001011', '011010']",1,7,21,17,6,38,13.78052503052503,55,68
"['00001', '10001', '100011', '11']",1,4,10,8,2,18,3.7935064935064933,15,27
"['001111', '0011000', '101011', '0110', '1101100', '10']",1,6,15,17,4,32,8.802591852591853,52,40
"['110000', '01', '010', '0001101', '0001011']",1,5,15,10,2,25,5.517399267399267,40,30
"['1001100', '0011', '10001', '000']",1,4,12,7,0,19,3.982034632034632,16,17
"['1111101', '00', '0111', '11111', '0101']",1,5,6,16,2,22,5.007575757575758,32,35
"['01', '0010', '1100100', '1110001', '11111', '011000']",1,6,15,16,2,31,8.21926961926962,54,38
"['11110', '01', '00', '010111']",1,4,6,9,2,15,2.616883116883117,20,15
"['00111', '0001', '0110100']",1,3,9,7,0,16,1.6969696969696968,10,9
"['0', '100010', '0101010', '000111', '110']",1,5,13,10,2,23,4.3539072039072035,37,27
"['110011', '010010', '01100']",1,3,9,8,2,17,2.121212121212121,7,5
"['11001', '01', '1', '00000', '00001']",1,5,12,6,3,18,4.561904761904762,30,28
"['1011', '011', '101111']",1,3,3,10,0,13,2.3238095238095235,6,15
"['1000', '100000', '1']",1,3,8,3,0,11,1.4857142857142858,10,11
"['11', '00', '010010', '100010']",1,4,10,6,4,16,2.8333333333333335,20,13
"['000110', '1101000', '011']",1,3,9,7,0,16,1.528205128205128,12,9
"['00010', '111', '0110011']",1,3,7,8,0,15,1.5166666666666666,11,6
"['01', '1110011', '1001', '1011', '110']",1,5,7,13,2,20,6.125180375180375,26,34
"['010', '01101', '101011', '00', '000001']",1,5,13,9,2,22,5.474963924963925,30,22
"['01', '11010', '0101000', '101101', '00111', '00100', '1001', '0000001', '10100', '111101']",1,10,28,24,8,52,26.16214896214896,139,126
"['10100', '101110', '0100100', '11']",1,4,10,10,0,20,3.5251970251970253,19,15
"['10101', '100', '1', '010101']",1,4,7,8,0,15,3.4448051948051948,17,19
"['100001', '0101101', '100110', '10', '0100100', '0111', '0111110']",1,7,19,20,5,39,12.036630036630036,74,58
"['00100', '10101', '00', '011001', '110']",1,5,12,9,2,21,5.582251082251082,27,23
"['10111', '1000', '1111000', '000']",1,4,10,9,0,19,3.3788600288600286,19,24
"['10111', '00100', '00', '10011', '0001011', '1011', '010011']",1,7,17,17,3,34,13.388711288711288,56,70
"['001101', '0010000', '101', '10101', '1001']",1,5,14,11,0,25,6.368992118992119,28,36
"['0', '11011', '100000', '0101', '01110']",1,5,11,10,2,21,4.412987012987013,35,19
"['10001', '10010', '00011']",1,3,9,6,3,15,2.2,6,8
"['101000', '10011', '000', '0001011', '0101']",1,5,15,10,0,25,6.0056943056943055,31,31
"['0100110', '001101', '1000110', '01111', '11101', '10', '0000', '000111']",1,8,21,21,6,42,16.374542124542124,90,78
"['0010', '11', '101', '1010101', '00']",1,5,9,9,2,18,4.805772005772005,29,22
"['110110', '10011', '0111']",1,3,5,10,0,15,1.993939393939394,7,9
"['1010', '011010', '01111', '001101']",1,4,9,12,2,21,4.132323232323232,14,17
"['110000', '01', '11', '01000', '1101010']",1,5,12,10,2,22,5.159201909201909,34,27
"['0010', '0000100', '10111', '1100100', '0110010', '01110', '0100']",1,7,23,16,7,39,13.754906204906204,62,78
"['11000', '00', '111']",1,3,5,5,0,10,1.0714285714285714,9,8
"['01001', '10', '101101']",1,3,6,7,0,13,1.7987012987012987,9,8
"['0111', '001011', '000', '11111']",1,4,7,11,0,18,2.5826839826839825,18,19
"['100001', '0000010', '1', '1111011']",1,4,11,10,2,21,2.302197802197802,28,12
"['01', '00101', '011100', '101101', '111']",1,5,9,13,2,22,5.380519480519481,30,24
"['01', '110', '10', '000001']",1,4,8,5,2,13,2.6722222222222225,19,14
"['100', '0000', '1010', '11111', '01100', '0100']",1,6,14,11,5,25,8.102380952380953,36,44
"['01', '100', '01111', '001']",1,4,6,7,2,13,3.1880952380952383,15,15
"['0100000', '001111', '110001', '10', '0100']",1,5,15,10,2,25,5.011460761460762,39,25
"['01101', '111111', '001', '11101']",1,4,5,14,2,19,3.294949494949495,16,23
"['01', '00011', '10001', '1001', '0111', '1110110', '0100']",1,7,15,16,5,31,12.551443001443001,60,54
"['01', '00001', '1100010', '0011', '001010', '11111', '1110']",1,7,16,17,4,33,10.483638583638584,67,60
"['1110100', '1101', '00', '10000']",1,4,10,8,0,18,3.020923520923521,20,16
"['0', '00100', '01100']",1,3,8,3,2,11,1.4666666666666668,9,15
"['1011010', '00', '011']",1,3,6,6,0,12,1.4444444444444444,11,6
"['1000', '000', '1110']",1,3,7,4,2,11,1.6428571428571428,6,10
"['1011', '010110', '01100', '0000']",1,4,11,8,2,19,3.4883838383838386,15,15
"['0', '101111', '11']",1,3,2,7,0,9,0.7857142857142857,11,6
"['0010', '0010000', '00000', '00111', '10111']",1,5,17,9,3,26,5.405050505050505,29,44
"['0011110', '110', '111']",1,3,4,9,2,13,1.8666666666666667,9,8
"['1111100', '01', '101010', '001010', '000010', '000100', '0001000']",1,7,26,14,6,40,12.197802197802199,66,90
"['1011010', '110010', '011', '1010', '110']",1,5,10,13,2,23,6.417138417138417,27,36
"['000110', '101', '111111', '11101', '10010', '010110', '0100']",1,7,15,20,5,35,11.874458874458874,61,51
"['11001', '010', '111000']",1,3,7,7,0,14,1.6717171717171717,9,5
"['010', '10000', '10100', '11111', '110101']",1,5,11,13,3,24,5.366666666666666,27,22
"['1100010', '110010', '100101', '10']",1,4,11,10,2,21,3.97008547008547,19,21
"['010001', '010', '0011001', '111111', '111110', '11100', '101111']",1,7,14,25,4,39,11.549106449106448,67,71
"['0001', '1010101', '100']",1,3,8,6,0,14,1.535064935064935,9,9
"['00111', '0011', '00', '011']",1,4,7,7,0,14,4.134126984126984,11,23
"['001', '110001', '1010111', '10010', '0101']",1,5,12,13,0,25,6.237512487512488,28,28
"['1000001', '0111001', '001', '01101', '11', '01111', '1011']",1,7,14,19,4,33,12.165512265512266,66,70
"['1100010', '00100', '00', '10010', '011110', '000010', '01011']",1,7,22,14,5,36,12.344044844044843,64,77
"['0', '110100', '11']",1,3,4,5,0,9,0.7857142857142857,11,6
"['110000', '1', '0011110', '1101011', '001010', '1011100', '1100011']",1,7,19,22,6,41,11.005494505494505,84,60
"['11010', '0100110', '10']",1,3,7,7,0,14,1.5158730158730158,11,9
"['0010110', '010', '001000', '1000', '11111', '1011000', '1100', '101110']",1,8,22,20,6,42,16.173459873459873,85,89
"['010001', '11011', '1110', '1100011', '1011', '0101', '01100', '0110011']",1,8,18,24,7,42,18.843584193584192,73,95
"['0001001', '110010', '1', '0011', '01100']",1,5,13,10,0,23,5.2723110223110226,37,22
"['00010', '01011', '01000', '111010']",1,4,12,9,3,21,3.436363636363636,15,21
"['01', '011', '00000', '11111']",1,4,7,8,2,15,2.1214285714285714,21,13
"['1001100', '101', '000111', '011010']",1,4,11,11,2,22,3.7623931623931623,21,12
"['110110', '10101', '1']",1,3,4,8,0,12,1.3463203463203464,12,8
"['1011101', '00', '0101', '011']",1,4,7,9,0,16,3.5137085137085133,17,13
"['0', '0011101', '11', '101010', '0011111']",1,5,9,14,2,23,3.954822954822955,41,24
"['0001100', '00', '0101', '10010']",1,4,12,6,0,18,3.5613275613275612,20,18
"['0', '001', '01010', '1011', '01110']",1,5,9,9,2,18,5.271428571428571,26,22
"['1010', '0001', '0100011', '01010']",1,4,12,8,2,20,3.7727272727272725,16,17
"['01', '001101', '01100']",1,3,7,6,0,13,1.7987012987012987,9,9
"['100110', '10111', '00', '0000110']",1,4,11,9,0,20,3.226662226662227,21,17
"['110010', '010', '0010000', '0001', '1010010']",1,5,18,9,2,27,6.420712620712621,29,33
"['11', '1001', '10110', '1110101', '0000', '011111', '01001', '1100', '110101']",1,9,18,25,7,43,20.937690087690086,104,108
"['101', '01', '1000101', '0000']",1,4,10,6,0,16,3.1907647907647907,19,15
"['11011', '100', '10000', '110100']",1,4,10,9,2,19,3.5893939393939394,15,22
"['0010', '0111001', '100101', '011110']",1,4,11,12,2,23,3.6634032634032634,19,15
"['01', '110100', '00', '11111', '1001001', '110']",1,6,11,14,2,25,6.855955155955156,51,37
"['01', '001101', '1011100']",1,3,7,8,0,15,1.5598290598290598,12,8
"['0', '11000', '100', '00101']",1,4,9,5,2,14,2.8166666666666664,19,15
"['1', '00000', '011110', '011111', '0100']",1,5,11,11,2,22,3.7946608946608946,37,28
"['0', '101', '011']",1,3,3,4,2,7,1.6666666666666665,6,4
"['0', '1110010', '10111', '100011', '01100']",1,5,11,13,2,24,4.857159507159507,38,21
"['00001', '100010', '011110', '000', '110']",1,5,14,9,4,23,4.979797979797979,31,30
"['01', '10111', '0100', '00110', '00010', '011000']",1,6,16,11,3,27,9.076911976911976,40,45
"['1100111', '100101', '101110', '1']",1,4,7,13,2,20,2.85989010989011,24,19
"['0101101', '101', '100', '0111', '000100']",1,5,12,11,2,23,5.5775779775779775,31,25
"['0001', '11011', '111', '01010']",1,4,7,10,2,17,3.0246031746031745,15,14
"['01101', '00101', '11', '110001', '10']",1,5,9,11,4,20,5.858441558441559,28,28
"['11010', '0011', '0001', '101', '000']",1,5,11,8,4,19,5.7936507936507935,21,27
"['00101', '11', '101000', '10110', '001010', '0101100']",1,6,17,14,4,31,9.801520701520701,42,40
"['0', '0011100', '111001']",1,3,7,7,0,14,1.304945054945055,14,4
"['000110', '1', '0000100', '0001', '110']",1,5,14,7,0,21,5.0845987345987345,34,29
"['111100', '111', '011', '00100', '111110', '000100', '001011', '01110']",1,8,18,22,8,40,15.607575757575757,83,102
"['0101', '10001', '1001', '1111110', '1011', '111000', '01011']",1,7,14,21,5,35,11.908313908313907,61,68
"['00111', '1101', '1101010']",1,3,6,10,0,16,1.6717171717171717,10,11
"['010100', '100', '1']",1,3,6,4,0,10,1.4523809523809523,10,6
"['00', '1', '110111', '01100']",1,4,6,8,0,14,1.9859307359307359,23,10
"['10111', '00', '10001', '001011']",1,4,9,9,2,18,3.22987012987013,18,14
"['0', '0001110', '1101101', '10011', '01011', '0110001']",1,6,15,17,5,32,7.907142857142857,58,32
"['110010', '0010', '001', '1101100', '000', '110']",1,6,15,11,3,26,8.798068598068598,40,53
"['01010', '0011111', '000']",1,3,8,7,0,15,1.65,11,10
"['11110', '10101', '011', '1101010']",1,4,7,13,2,20,3.5833333333333335,16,16
"['0', '0111011', '00011']",1,3,6,7,0,13,1.0833333333333333,13,8
"['010', '0100110', '1001', '0101011', '1111', '1110100', '110101']",1,7,16,22,5,38,13.032201132201132,64,57
"['00001', '11', '010010', '0111', '1011']",1,5,10,11,2,21,5.685209235209235,28,24
"['1111010', '100111', '011']",1,3,5,11,0,16,1.528205128205128,12,10
"['010', '1', '001111']",1,3,4,6,0,10,1.2301587301587302,11,4
"['10111', '111100', '11']",1,3,3,10,0,13,1.6168831168831168,10,14
"['010', '011', '0001', '100100', '0001111', '000', '11111']",1,7,16,15,3,31,10.835780885780885,65,65
"['0010', '1', '101000', '1100001', '0010100', '01100']",1,6,19,11,2,30,8.173382173382173,53,38
"['1', '000010', '0000']",1,3,9,2,0,11,1.0857142857142859,11,10
"['1100010', '1101', '110001']",1,3,8,9,0,17,2.4503496503496507,6,18
"['1001', '0111', '0100']",1,3,6,6,3,12,1.75,7,5
"['11001', '00', '010']",1,3,6,4,0,10,1.8714285714285714,7,4
"['0111000', '101100', '01', '0111010', '00000', '1111000', '0001100', '11100', '0111110']",1,9,28,25,7,53,22.06833166833167,111,153
"['10001', '10000', '000']",1,3,10,3,2,13,2.3,5,11
"['0', '01100', '110101']",1,3,6,6,0,12,1.3463203463203464,12,4
"['010000', '11', '0110', '1010', '0001011', '1011', '001011', '0011100']",1,8,21,19,7,40,17.10876900876901,89,84
"['000111', '0101011', '0111010']",1,3,9,11,2,20,2.098901098901099,8,8
"['001111', '10', '11111']",1,3,3,10,0,13,1.262987012987013,11,12
"['01', '1100', '10', '11']",1,4,4,6,3,10,3.1666666666666665,11,14
"['1011', '00101', '0110110', '101101']",1,4,9,13,0,22,4.175291375291375,15,15
"['0', '01', '010111']",1,3,4,5,0,9,1.4523809523809523,10,7
"['0', '1000110', '001110', '10', '01011']",1,5,11,10,0,21,5.214757464757465,36,27
"['0000101', '1101', '01101', '01111']",1,4,9,12,2,21,4.067676767676767,15,22
"['01', '1010', '001', '1100100']",1,4,9,7,0,16,3.8098124098124098,17,14
"['011', '00111', '0111', '0101', '11100']",1,5,8,13,4,21,6.980952380952381,21,35
"['10111', '1', '0000011', '01000']",1,4,10,8,2,18,2.3166666666666664,25,13
"['0101110', '000101', '00', '1011000', '1100', '0100']",1,6,18,12,4,30,8.99070374070374,49,54
"['010001', '0010111', '001000']",1,3,12,7,2,19,2.0641025641025643,8,10
"['01101', '00000', '100', '1001011', '0100']",1,5,15,9,2,24,5.513708513708513,29,27
"['010', '0111101', '000', '0100']",1,4,10,7,2,17,3.6406926406926408,16,24
"['10100', '110010', '001']",1,3,8,6,0,14,1.893939393939394,9,7
"['10101', '00', '0011111', '0111', '0001011', '0001010', '110']",1,7,17,18,3,35,11.37056277056277,69,61
"['11001', '010001', '001111', '00111', '101', '1010111', '1001001', '00010', '101110']",1,9,23,27,8,50,22.491869241869242,106,112
"['11110', '11', '100', '1000111', '1000', '10010', '001100', '01110']",1,8,18,19,3,37,16.237823287823286,81,82
"['010000', '11', '00', '0101', '0001000']",1,5,15,6,2,21,4.664685314685315,35,32
"['11', '0100010', '1000', '00', '01001']",1,5,13,7,2,20,5.259018759018759,30,23
"['0011', '010000', '1', '1110']",1,4,8,7,2,15,2.3857142857142857,22,12
['0101011'],1,1,3,4,0,7,0,0,0
"['00000', '100000', '1100101', '1011', '110']",1,5,15,10,0,25,5.058025308025308,33,31
"['0010001', '0101010', '0011100', '11']",1,4,13,10,3,23,3.4761904761904763,24,13
"['0001', '1000', '11']",1,3,6,4,2,10,1.4166666666666665,8,8
"['0010110', '101000', '1110', '0']",1,4,10,8,0,18,2.6783716283716283,23,17
"['110000', '0001001', '010100', '101011', '0001', '100', '0111', '1001011']",1,8,24,19,7,43,16.3017316017316,85,85
"['11010', '011', '00111', '1111', '1000', '110']",1,6,9,15,6,24,8.46111111111111,38,49
"['0010', '010', '101', '1011000', '110']",1,5,11,9,3,20,6.345454545454545,26,25
"['01', '111', '0001', '10', '01001']",1,5,8,8,2,16,5.117460317460317,24,25
"['010001', '00011', '010010', '1010000', '0100']",1,5,19,9,2,28,7.098057498057498,24,35
"['101011', '010', '11101', '101101']",1,4,7,13,2,20,3.954545454545454,14,18
"['11011', '010', '0001', '11101', '0000', '01100']",1,6,14,12,5,26,7.865079365079365,39,37
"['1011010', '1', '00101']",1,3,6,7,0,13,1.0833333333333333,13,6
"['11001', '00', '011011']",1,3,6,7,0,13,1.7987012987012987,9,5
"['1', '10110', '110100', '1010', '001001']",1,5,11,11,2,22,5.533044733044733,31,24
"['0111111', '1100', '0111']",1,3,4,11,2,15,1.5909090909090908,11,13
"['101', '10', '111010', '000']",1,4,7,7,2,14,3.1444444444444444,16,12
"['11011', '001', '110', '00011']",1,4,7,9,4,16,3.433333333333333,16,20
"['110', '000', '110101']",1,3,6,6,2,12,1.4444444444444444,9,6
"['0111000', '011011', '0011', '000', '01000']",1,5,15,10,0,25,5.9499444999444995,29,47
"['0010110', '1', '1100100', '1101', '0100011']",1,5,13,13,3,26,4.643506493506494,43,23
"['11001', '0011101', '110']",1,3,6,9,0,15,2.0166666666666666,9,9
"['0001100', '100', '10000', '0100']",1,4,14,5,0,19,4.267748917748918,15,29
"['01', '111010', '100100', '0010101', '110111', '000111', '0001000']",1,7,21,19,6,40,12.026251526251526,73,62
"['1011110', '100110', '1']",1,3,5,9,0,14,1.304945054945055,13,9
"['000100', '010111', '011010']",1,3,10,8,3,18,1.6666666666666665,9,9
"['1100010', '00010', '010']",1,3,10,5,0,15,2.1833333333333336,8,16
"['0', '1011010', '100', '0010101']",1,4,10,8,2,18,2.914285714285714,25,14
"['0111000', '1001', '1111001', '00110', '01000']",1,5,15,13,4,28,6.4203463203463205,30,25
"['0', '1001110', '010', '0011111', '0001010']",1,5,13,12,3,25,4.65,41,31
"['0100010', '100', '0101011', '001001', '11100']",1,5,16,12,2,28,6.414868464868465,31,27
"['111', '1101', '1010', '0000011', '010011', '1100']",1,6,13,15,3,28,8.554584304584305,44,50
"['110', '1', '10000']",1,3,5,4,0,9,1.3333333333333333,9,6
"['10111', '111111', '001']",1,3,3,11,0,14,1.2676767676767677,10,12
"['01', '00', '011', '11']",1,4,4,5,3,9,3.0,8,13
"['1000100', '0010', '110', '0111100']",1,4,12,9,2,21,3.090909090909091,21,19
"['0101', '10011', '00011']",1,3,7,7,2,14,2.1333333333333333,6,9
"['0', '101000', '1011100']",1,3,8,6,0,14,1.304945054945055,13,9
"['010100', '1000110', '1101100', '00', '11101', '1110110']",1,6,16,18,3,34,8.963036963036963,50,43
"['001', '100001', '0011', '1010101', '000111', '0000110', '0001000']",1,7,25,15,5,40,13.246753246753247,64,65
"['011101', '00', '010', '10011']",1,4,8,8,0,16,3.5835497835497834,18,11
"['1', '0110', '000011']",1,3,6,5,0,11,1.2857142857142856,12,4
"['1010', '0110', '011', '1100101']",1,4,8,10,2,18,3.6194805194805193,16,14
"['1110011', '00110', '00', '001110', '1100']",1,5,12,12,0,24,6.367621267621267,33,35
"['101', '1010', '0011', '1']",1,4,5,7,2,12,3.2285714285714286,13,16
"['001', '101', '1011101', '10110', '10011', '0100']",1,6,12,15,4,27,9.738311688311688,38,45
"['0110101', '01', '1001', '0111111', '10010', '100000', '0100011']",1,7,19,19,3,38,10.96100011100011,74,60
"['11001', '100', '11100', '01010']",1,4,9,9,3,18,4.25,14,13
"['1000', '100', '10101']",1,3,7,5,0,12,2.2738095238095237,5,11
"['11101', '0110', '000011']",1,3,7,8,0,15,1.6303030303030304,10,5
"['0', '111', '01000']",1,3,5,4,0,9,0.5833333333333333,11,4
"['0101010', '01', '1110010', '011']",1,4,9,10,2,19,3.1174603174603175,23,18
"['1001110', '1011', '001001', '0010011']",1,4,12,12,2,24,4.307292707292707,18,20
"['0', '1111', '10011', '011001', '00010']",1,5,10,11,2,21,4.273593073593074,34,18
"['0100110', '011', '11', '1000', '0100001']",1,5,13,10,2,23,5.6767676767676765,34,25
"['01', '00101', '11', '1110101', '000111']",1,5,9,13,2,22,5.387223887223887,34,34
"['001111', '11', '1001', '11101', '0000010', '101111', '1101010']",1,7,15,22,4,37,11.606759906759907,72,70
"['0010110', '111', '00001', '100', '00110', '1011', '0101', '0110110']",1,8,19,19,8,38,16.04083694083694,77,74
"['0', '11010', '101101', '010101', '1010011']",1,5,11,14,2,25,5.647768897768898,35,23
"['0100001', '1011', '110111', '0111']",1,4,8,13,2,21,3.9024475524475526,18,22
"['01101', '010', '001001', '11111']",1,4,8,11,2,19,3.3575757575757574,17,12
"['01001', '0000110', '1100100', '11']",1,4,12,9,2,21,3.3650793650793647,22,13
"['1010', '01001', '1', '000']",1,4,8,5,0,13,2.4714285714285715,17,10
"['1000', '010111', '000', '1111']",1,4,8,9,2,17,2.5515873015873014,18,18
"['01', '00001', '11000', '10000', '1011', '110']",1,6,14,10,3,24,7.814285714285714,41,43
"['101', '01', '0111', '11111']",1,4,3,11,0,14,3.4904761904761905,14,20
"['0110', '10011', '1001010', '00000']",1,4,13,8,2,21,3.7383838383838386,17,14
"['0', '110', '0000111']",1,3,6,5,0,11,1.15,13,7
"['0', '1011010', '0001', '0011111']",1,4,9,10,2,19,2.3805194805194807,26,13
"['101010', '11011', '1']",1,3,4,8,0,12,1.3463203463203464,11,8
"['1010110', '1010101', '11']",1,3,6,10,2,16,1.746031746031746,12,12
"['1110000', '10000', '1000', '100101', '0000']",1,5,18,8,2,26,7.558313908313909,22,49
"['1010001', '01', '1110', '00001']",1,4,10,8,0,18,2.7683982683982684,21,17
"['000110', '001000', '11000', '101', '0111', '1111111']",1,6,14,17,2,31,6.917815517815518,58,42
"['10010', '1', '10110', '0100100']",1,4,10,8,2,18,3.216666666666667,20,12
"['10100', '11101', '0011100', '11']",1,4,8,11,2,19,3.5206349206349206,19,15
"['0010', '0000000', '1111', '0111111', '1101', '0100']",1,6,15,15,6,30,6.051948051948052,58,41
"['0010110', '110110', '100', '110011', '00']",1,5,12,12,2,24,6.195726495726496,32,30
"['11011', '0010', '0101']",1,3,6,7,2,13,1.8611111111111112,7,4
"['0010', '00000', '0001', '0111111', '110101']",1,5,14,12,2,26,4.8024475524475525,35,27
"['11', '1001', '0110', '100', '110111']",1,5,7,12,2,19,5.806349206349206,26,26
"['0110111', '100', '1111', '0111110', '101111']",1,5,7,20,2,27,5.712776112776113,33,33
"['11011', '011011', '1001', '01111', '00', '1110']",1,6,9,17,4,26,8.434054834054834,39,43
"['00110', '1', '011']",1,3,4,5,0,9,1.5833333333333333,8,4
"['0110101', '111', '011011', '1010', '1011']",1,5,8,16,2,24,6.755328005328005,23,35
"['000110', '1', '101011', '10011', '1010010']",1,5,12,13,2,25,5.662920412920413,34,28
"['101', '1010', '1100', '011']",1,4,6,8,4,14,3.988095238095238,12,15
"['0', '1000', '1001', '101101']",1,4,8,7,2,15,3.2357142857142858,17,15
"['1111100', '0100111', '0001100', '00', '0100']",1,5,15,12,3,27,5.714285714285714,38,48
"['101100', '011', '0100010', '10001', '111111', '0000010', '1011111']",1,7,19,22,5,41,10.794194694194694,76,60
"['1111100', '0010110', '0011000', '11', '111110']",1,5,12,17,3,29,5.690476190476191,37,35
"['010', '010001', '1100100', '11']",1,4,10,8,0,18,3.2264957264957266,21,14
"['00111', '001000', '111001']",1,3,9,8,2,17,1.5909090909090908,10,9
"['1000011', '100', '01110']",1,3,8,7,0,15,1.6,12,6
"['01', '000011', '1110100', '011110', '11100', '01000', '0110011']",1,7,19,19,6,38,11.894150294150293,72,69
"['00100', '0010', '100', '0111']",1,4,10,6,2,16,3.4404761904761902,13,22
"['010', '001010', '110']",1,3,7,5,2,12,1.7777777777777777,7,12
"['1110011', '1101', '011010', '000']",1,4,9,11,0,20,3.495038295038295,19,10
"['01', '0010', '1101']",1,3,5,5,2,10,1.8333333333333333,7,5
"['011111', '00', '0111101']",1,3,5,10,0,15,1.6175213675213675,11,10
"['00', '100', '0100']",1,3,7,2,0,9,2.3238095238095235,4,14
"['111', '011', '00', '110111', '01110', '01000']",1,6,10,14,4,24,7.733766233766234,43,42
"['00111', '01011', '010010']",1,3,8,8,2,16,2.0727272727272728,7,9
"['001', '101', '010111', '011010', '0111110']",1,5,10,15,4,25,5.573504273504273,30,24
"['1011', '01001', '001001']",1,3,8,7,0,15,2.175757575757576,6,10
"['0001110', '100', '100111', '01010', '0111101']",1,5,13,15,2,28,6.194355644355644,34,23
"['0101011', '111011', '01010', '1110110', '01110']",1,5,11,19,4,30,7.145987345987346,24,39
"['1011', '01', '00', '000011']",1,4,8,6,2,14,3.1,17,14
"['010101', '1', '01110']",1,3,5,7,0,12,1.3463203463203464,11,5
"['101000', '10', '01011', '11']",1,4,7,8,2,15,3.188311688311688,18,15
"['0', '111', '101', '010010', '1010001']",1,5,10,10,2,20,4.782722832722833,35,19
"['0010', '110100', '000']",1,3,9,4,0,13,1.9015873015873015,7,13
"['1000', '100101', '01010']",1,3,9,6,0,15,2.193939393939394,7,6
"['101', '010001', '111', '1110']",1,4,6,10,2,16,3.606349206349206,15,19
"['10100', '1000', '00010', '1111']",1,4,10,8,4,18,2.8499999999999996,16,15
"['01', '00', '10', '11']",1,4,4,4,4,8,2.5,8,10
"['01', '00', '11101', '010110', '001011']",1,5,10,11,4,21,5.463203463203463,32,23
"['1001', '01010', '01001', '01100', '0100']",1,5,14,9,5,23,8.038888888888888,18,35
"['010', '0110', '100011', '1101', '110']",1,5,9,11,4,20,6.648412698412698,23,25
"['01', '1010100', '1001000', '1010', '0111101']",1,5,14,13,3,27,5.714285714285714,38,28
"['011100', '01011', '1000111']",1,3,8,10,0,18,1.8275058275058274,11,6
"['0100110', '1001', '111011', '001110', '10', '11111']",1,6,11,19,2,30,8.607703407703408,49,37
"['1101001', '0011', '01', '11']",1,4,6,9,2,15,3.2676767676767673,19,20
"['1000010', '001101', '111', '0000']",1,4,12,8,0,20,3.0093240093240095,22,12
"['0001101', '00', '1100011', '1100110']",1,4,12,11,3,23,3.619047619047619,24,16
"['011011', '1101', '1', '0100100']",1,4,8,10,0,18,2.8965534465534466,23,12
"['111010', '10110', '100010', '0001100', '00', '1100']",1,6,17,13,2,30,9.648973248973249,44,48
"['01', '100', '11010', '0000']",1,4,9,5,0,14,3.0706349206349204,15,14
"['00010', '10', '01000', '0100']",1,4,12,4,2,16,3.9650793650793648,13,26
"['101', '1000110', '0000', '001110', '1010011', '1100']",1,6,17,14,4,31,8.806981906981907,47,38
"['010000', '10', '011']",1,3,7,4,0,11,1.3444444444444446,10,7
"['11000', '10100', '00', '1']",1,4,8,5,2,13,2.6095238095238096,18,15
"['0010110', '0101', '111', '0']",1,4,7,8,0,15,2.3487012987012985,21,10
"['001', '1', '010010', '1000', '1011']",1,5,10,8,2,18,5.295238095238095,27,20
"['0010110', '11010', '1011001', '011111']",1,4,10,15,2,25,3.5033300033300034,20,12
"['11001', '1', '101101', '0000']",1,4,8,8,0,16,2.1907647907647907,22,13
"['0110101', '1', '0101110', '0001', '1110']",1,5,10,13,4,23,4.121428571428572,38,23
"['101', '00', '011001', '1011', '00010']",1,5,11,9,0,20,5.6002886002886,28,21
"['01', '00111', '10', '1011100', '010011', '001011', '01000', '011000']",1,8,21,18,7,39,16.485858585858587,90,84
"['1011', '00', '0101', '11']",1,4,5,7,4,12,3.083333333333333,13,12
"['1010', '010', '110', '101110']",1,4,7,9,2,16,4.228571428571429,11,22
"['00111', '0011', '000']",1,3,7,5,0,12,1.9603174603174602,6,14
"['000010', '0110', '0011100']",1,3,11,6,0,17,1.9426573426573426,9,15
"['100100', '10010', '1111000', '111']",1,4,10,11,0,21,3.7355866355866354,19,21
"['100', '1', '0111010']",1,3,5,6,0,11,1.35,12,4
"['0', '11101', '1100']",1,3,4,6,0,10,1.4,9,5
"['0', '101000', '0011001']",1,3,9,5,0,14,1.151098901098901,14,7
"['000100', '100', '1', '000000']",1,4,13,3,2,16,2.7301587301587302,21,21
"['1100001', '00', '01011', '11010']",1,4,10,9,2,19,3.187301587301587,20,14
"['1111', '00', '10010', '001100', '111101', '1101010']",1,6,13,17,2,30,7.625935175935176,50,41
"['0', '010', '101111', '101101']",1,4,6,10,2,16,3.015873015873016,20,11
"['1000110', '001', '0100011']",1,3,10,7,2,17,2.057142857142857,10,6
"['0', '101101', '10101', '100', '1110110']",1,5,9,13,0,22,5.7307026307026305,33,24
"['0', '11001', '001111', '011', '00111', '1110001', '01001']",1,7,14,18,3,32,11.563919413919415,71,65
"['110000', '01', '0011000', '11', '101010', '111001', '1100', '0100']",1,8,20,17,7,37,16.543434343434342,84,76
"['010100', '001', '001111', '0110', '0101010', '000']",1,6,17,12,4,29,8.975258075258076,42,59
"['010100', '000100', '0001111', '010110', '0111', '00010', '0101']",1,7,22,16,5,38,13.626146076146076,51,87
"['0011', '00101', '00000']",1,3,10,4,2,14,1.9333333333333331,6,12
"['101', '01', '0111101', '111001']",1,4,6,12,0,18,3.7803418803418802,19,22
"['00111', '100', '000101', '111010']",1,4,10,10,2,20,3.3838383838383836,21,17
"['1110010', '0001', '1111', '100101', '1110100', '10', '0111100']",1,7,16,21,5,37,11.382567432567432,73,58
"['011110', '1010001', '01010', '001100']",1,4,13,11,2,24,3.8648018648018647,18,14
"['0', '10001', '010000', '1100']",1,4,11,5,0,16,3.012987012987013,19,11
"['011', '00', '0100110', '0010']",1,4,10,6,0,16,3.2279942279942277,18,22
"['010100', '1', '0110', '1011100', '1011111']",1,5,10,15,2,25,5.2034965034965035,37,23
"['01101', '1', '0101101', '100', '0000', '0111110', '1101010']",1,7,16,18,3,34,10.034704184704184,79,51
"['000100', '1110000', '11', '00111', '10001', '110011', '1101', '111000', '01000']",1,9,24,22,6,46,21.144538794538793,117,125
"['0111000', '00000', '100010', '111011', '01001']",1,5,17,12,4,29,5.479254079254079,31,23
['1110101'],1,1,2,5,0,7,0,0,0
"['1011110', '0111011', '11']",1,3,4,12,2,16,1.4603174603174602,13,8
"['011', '100100', '10110', '1111001', '1000010', '10100', '1000', '01000']",1,8,24,18,5,42,17.76145521145521,78,82
"['0', '10001', '0001111', '100110', '010101', '111001']",1,6,15,16,3,31,7.647935397935398,57,36
"['101', '1101', '0111101']",1,3,4,10,0,14,2.1844155844155844,8,15
"['101000', '1101', '110001', '1001111']",1,4,10,13,2,23,3.855710955710956,19,24
"['101', '1110110', '1100', '01010']",1,4,8,11,0,19,3.982034632034632,16,12
"['11010', '010010', '01010', '11']",1,4,9,9,2,18,3.897402597402597,14,21
"['00110', '011010', '01011']",1,3,8,8,2,16,2.0727272727272728,6,10
"['11110', '00', '1']",1,3,3,5,0,8,0.6190476190476191,10,4
"['1001', '1', '011010']",1,3,5,6,0,11,1.2857142857142856,11,4
"['1111100', '00001', '11', '000101', '000010']",1,5,15,11,2,26,4.898573648573649,38,32
"['01', '0010', '10011']",1,3,6,5,0,11,1.9047619047619047,7,4
"['01', '00', '0010']",1,3,6,2,2,8,1.8333333333333333,5,10
"['101', '000110', '010000', '11']",1,4,10,7,2,17,3.1055555555555556,21,10
"['00001', '0011', '100100', '0101001', '0100']",1,5,17,9,2,26,6.278010878010878,26,32
"['11010', '0101101', '10', '000001', '01011']",1,5,13,12,2,25,4.9722666222666225,33,27
"['100', '110', '000', '1111']",1,4,6,7,3,13,2.5238095238095237,13,14
"['011', '00011', '0011010', '1111', '10', '0101']",1,6,11,14,2,25,8.459235209235208,42,37
"['0100001', '110', '10', '1111']",1,4,7,9,0,16,2.912842712842713,21,15
"['0010', '100', '111']",1,3,5,5,2,10,1.1904761904761905,7,5
"['0001001', '00111', '1000010', '00', '0101100', '1011', '101110']",1,7,21,17,3,38,12.143989343989343,71,56
"['0011', '1100000', '010010', '0111']",1,4,12,9,2,21,3.2926573426573427,21,17
"['10110', '0110', '01000', '000', '101001']",1,5,14,9,2,23,6.4759740259740255,23,30
"['1001', '1010', '0000011', '1100', '1011111']",1,5,12,14,5,26,5.4058441558441555,37,30
"['010', '001', '001101', '110011', '11101']",1,5,10,13,4,23,6.232323232323232,29,27
"['11000', '1000110', '0110110', '11']",1,4,10,11,2,21,3.3650793650793647,22,15
"['0', '0011', '10011']",1,3,5,5,0,10,1.6222222222222222,8,7
"['1000', '100', '100111']",1,3,7,6,0,13,2.123809523809524,7,13
"['100', '000', '00011']",1,3,8,3,2,11,1.9166666666666665,6,13
"['110010', '00', '1']",1,3,5,4,0,9,0.7857142857142857,11,4
"['0111001', '001111', '11', '011011', '101011', '110001', '111000']",1,7,15,24,5,39,12.982905982905983,67,76
"['01', '101101', '110001', '1111010', '0111', '0000']",1,6,13,16,4,29,8.054817404817404,51,36
"['11001', '11101', '1']",1,3,3,8,2,11,1.4666666666666668,9,14
"['11000', '10100', '00', '110100']",1,4,11,7,2,18,4.261038961038961,14,26
"['00100', '100', '10']",1,3,7,3,0,10,2.1214285714285714,6,10
"['0', '1011', '010', '000101']",1,4,8,6,0,14,3.0238095238095237,18,10
"['101', '10000', '0001111', '00', '001100', '011010', '1001111']",1,7,19,17,4,36,11.714352314352315,74,61
"['10000', '01', '1000101', '111']",1,4,9,8,0,17,2.8134920634920633,21,18
"['0011', '11100', '001011', '011001']",1,4,10,11,2,21,3.4353535353535354,17,20
"['0', '0001', '011']",1,3,5,3,0,8,1.4714285714285715,7,6
"['01', '011', '11010']",1,3,4,6,0,10,1.8714285714285714,7,8
"['00110', '0001', '10110']",1,3,8,6,2,14,1.911111111111111,6,10
"['110000', '11000', '00']",1,3,9,4,0,13,1.9805194805194803,8,16
"['0001011', '10', '01000']",1,3,9,5,0,14,1.5158730158730158,12,8
"['101', '010', '000000', '011000']",1,4,13,5,4,18,2.944444444444444,20,17
"['101', '010000', '1', '001100']",1,4,10,6,2,16,2.626984126984127,23,10
"['101', '0010000', '0101001']",1,3,11,6,2,17,1.7142857142857144,12,5
"['1101011', '00110', '1', '001000']",1,4,10,9,0,19,2.557858807858808,25,11
"['11110', '0100000', '111010', '100', '0110', '1010', '100111']",1,7,17,18,4,35,12.443062493062493,62,61
"['011011', '101011', '0011', '0010101', '10011', '000100', '1100']",1,7,19,19,5,38,13.754156954156954,56,70
"['011', '10100', '111110', '0111', '1110110']",1,5,8,17,0,25,5.637173937173937,29,33
"['110', '000', '1']",1,3,4,3,2,7,0.8333333333333333,7,4
"['1010', '1', '00101']",1,3,5,5,0,10,1.4,9,6
"['010', '1100000', '0100']",1,3,10,4,0,14,1.8025974025974025,10,11
"['0011', '0101', '10']",1,3,5,5,2,10,1.75,7,6
"['101', '1100', '011']",1,3,4,6,2,10,1.8095238095238093,7,7
"['0', '1111001', '11']",1,3,3,7,0,10,0.6944444444444444,13,6
"['11110', '111101', '0010101']",1,3,6,12,0,18,1.7039627039627039,8,12
"['0', '0101010', '010', '1100110']",1,4,10,8,2,18,2.7714285714285714,25,24
"['0', '01', '0101011', '0111110']",1,4,7,10,2,17,2.484126984126984,26,17
"['101', '010', '0110', '00011']",1,4,8,7,2,15,3.761904761904762,15,12
"['0', '10110', '0110']",1,3,5,5,0,10,1.6222222222222222,8,11
"['1100011', '10', '0']",1,3,5,5,0,10,1.3611111111111112,12,4
"['00010', '001', '1', '10']",1,4,7,4,0,11,3.2214285714285715,14,12
"['00111', '1010001', '1', '0000']",1,4,10,7,0,17,2.073232323232323,24,12
"['0', '0010', '0001110']",1,3,8,4,0,12,1.3772727272727274,12,14
"['00111', '10', '1100', '01000', '1110']",1,5,10,10,4,20,5.5626984126984125,28,28
"['0001', '1010', '0111111', '110', '01000', '1011111']",1,6,12,18,4,30,7.150649350649351,55,40
"['010100', '01', '0000000', '1111', '000001', '01100']",1,6,20,10,2,30,6.187745587745588,55,50
"['0', '0100', '1111']",1,3,4,5,2,9,0.65,10,4
"['101', '110', '1011111']",1,3,3,10,2,13,1.6666666666666665,11,11
"['110011', '010', '100', '01000']",1,4,10,7,2,17,3.823232323232323,16,13
"['1001001', '1101', '11110']",1,3,6,10,0,16,1.5454545454545454,9,10
"['010100', '0010', '0100']",1,3,10,4,2,14,2.15,6,19
"['000011', '1001', '000101', '1000010', '10100']",1,5,18,10,2,28,6.374825174825175,28,29
"['100', '0110', '10', '00011']",1,4,8,6,0,14,3.4904761904761905,15,15
"['1010010', '000111', '000']",1,3,10,6,0,16,1.882051282051282,11,10
"['0100000', '010', '0011', '100', '1110001', '1000']",1,6,18,10,6,28,8.873160173160173,48,40
"['0', '100110', '01001', '0001101']",1,4,11,8,0,19,3.0322177822177823,23,13
"['00100', '100011', '001', '100101']",1,4,12,8,2,20,4.1893939393939394,16,16
"['1010111', '100', '100010']",1,3,8,8,0,16,1.882051282051282,10,10
"['1100011', '01001', '0100']",1,3,9,7,0,16,2.1010101010101008,8,7
"['0', '0010111', '1101110']",1,3,6,9,2,15,1.2142857142857144,15,7
"['1000001', '011100', '100', '010010', '01010', '101111', '00010', '1111111']",1,8,22,23,7,45,15.136568986568987,97,75
"['00100', '0001', '101', '0110', '0111', '110']",1,6,12,11,5,23,8.623015873015873,34,36
"['0110011', '1110', '0100']",1,3,7,8,2,15,1.7727272727272727,9,8
"['11101', '1', '01010']",1,3,4,7,2,11,1.2666666666666666,11,4
"['11010', '11011', '10111', '100', '110001', '10000', '00110', '111110']",1,8,17,23,7,40,16.229292929292928,75,86
"['010', '0110', '000010', '100010']",1,4,13,6,2,19,4.223809523809524,14,30
"['11', '01', '111100', '0100']",1,4,6,8,2,14,2.85,18,15
"['001', '111', '101', '11000', '10001', '0110', '100110', '01010', '011111', '01011']",1,10,20,25,9,45,26.626406926406926,117,120
"['01', '1110100', '101101']",1,3,6,9,0,15,1.7136752136752138,12,7
"['00', '0110', '1']",1,3,4,3,0,7,1.0666666666666667,7,4
"['1100011', '1010110', '1001000']",1,3,11,10,3,21,1.8571428571428572,10,7
"['10111', '0101', '1111']",1,3,3,10,2,13,1.8333333333333333,5,12
"['01', '010', '11000', '111110', '1100']",1,5,9,11,0,20,5.219264069264069,29,28
"['1110010', '010', '010000', '1010', '0111']",1,5,13,11,2,24,6.083349983349983,30,34
"['1101001', '01101', '1111111', '0']",1,4,6,14,2,20,2.321428571428571,27,13
"['0', '101', '1010010']",1,3,6,5,0,11,1.35,12,6
"['1100010', '011', '11111']",1,3,5,10,0,15,1.4,12,11
"['01111', '0100000', '0110']",1,3,9,7,0,16,1.5454545454545454,11,12
"['110', '1001', '1010', '11100', '1111111']",1,5,7,16,2,23,5.603463203463203,31,31
"['011110', '01100', '10', '011100']",1,4,9,10,2,19,4.041125541125541,15,29
"['001', '101', '100110', '1101', '0100']",1,5,10,10,4,20,6.271428571428571,22,24
"['00', '01101', '1100', '100010']",1,4,10,7,0,17,3.55021645021645,18,14
"['100010', '1010', '0111111', '01001', '101001']",1,5,13,15,2,28,6.202564102564103,31,32
"['0110100', '011100', '10100', '1100110', '01011']",1,5,15,15,4,30,6.6492840492840495,27,35
"['100', '1001', '000', '1111']",1,4,7,7,4,14,2.880952380952381,13,14
"['0', '010', '0110100']",1,3,7,4,0,11,1.35,12,13
"['1', '1111101', '0000']",1,3,5,7,0,12,0.4318181818181818,16,4
"['0', '001', '000011', '0010100', '0001101', '01011', '1111011']",1,7,19,17,3,36,10.923426573426573,79,61
"['1', '100', '110', '01000']",1,4,7,5,2,12,3.25,14,11
"['11110', '01', '101111', '00000']",1,4,8,10,2,18,2.1805194805194805,23,13
"['011100', '111011', '100110', '10100', '00', '1110']",1,6,13,16,3,29,8.817388167388167,43,41
"['0', '001', '0101011', '110']",1,4,7,7,2,14,2.3833333333333333,21,13
"['11010', '0010100', '0111111', '10', '0111']",1,5,10,15,2,25,5.1060606060606055,38,28
"['01', '10010', '011']",1,3,5,5,0,10,1.8714285714285714,7,7
"['01', '100001', '000', '010111']",1,4,10,7,2,17,3.011111111111111,21,12
"['010000', '110001', '011000', '1000', '10010', '010111', '110', '1101010']",1,8,24,19,4,43,18.124497724497726,75,80
"['001011', '010', '1', '110111']",1,4,6,10,2,16,2.849206349206349,22,12
"['10', '0110100', '11']",1,3,5,6,2,11,1.3888888888888888,11,4
"['010100', '01', '010', '1110000', '11']",1,5,11,9,2,20,5.0487179487179485,34,25
"['11110', '001', '0010111', '1110110', '01100']",1,5,11,16,4,27,5.254761904761905,34,32
"['100110', '0010', '001011', '001101']",1,4,12,10,3,22,4.733333333333333,13,20
"['01', '11011', '00111', '10110', '1000', '0000011', '1100', '1110']",1,8,17,19,6,36,15.653679653679653,84,83
"['0010', '110010', '1011110', '101011', '0110000']",1,5,15,15,4,30,6.036696636696637,32,27
"['100001', '10', '01010', '111']",1,4,8,8,0,16,2.961327561327561,20,12
"['10100', '1110010', '00']",1,3,8,6,0,14,1.6825396825396823,11,8
"['00111', '01', '0100110']",1,3,7,7,0,14,1.6825396825396823,11,7
"['0', '111000', '00011']",1,3,7,5,0,12,1.1645021645021645,14,9
"['101', '100', '01010']",1,3,6,5,2,11,2.1666666666666665,5,5
"['11', '010', '00101', '111001']",1,4,7,9,0,16,3.211327561327561,18,13
"['01', '100', '0010', '001000']",1,4,11,4,0,15,3.604761904761905,15,21
"['0100101', '10110', '001011', '0011100']",1,4,13,12,2,25,4.003829503829504,19,15
"['0101010', '00', '0110']",1,3,8,5,0,13,1.8383838383838382,10,14
"['0', '110', '10']",1,3,3,3,0,6,1.9666666666666668,4,7
"['0001011', '101', '00']",1,3,7,5,0,12,1.4444444444444444,11,6
"['01001', '1', '00000']",1,3,8,3,2,11,0.7333333333333334,11,4
"['0010', '0100110', '1111110', '0110000', '0101', '110']",1,6,16,16,5,32,8.537012987012988,52,51
"['101100', '0111001', '011010']",1,3,9,10,2,19,2.371794871794872,8,8
"['0001110', '1111', '1010111', '110011', '00', '100111', '1011', '1101010']",1,8,16,27,7,43,17.136863136863138,84,99
"['1', '00000', '101010', '0001111', '11101']",1,5,12,12,2,24,3.7881618381618383,41,24
"['1000100', '00000', '100', '10011', '01001']",1,5,17,8,3,25,6.366666666666667,27,30
"['0001001', '1', '10001', '100000', '1110']",1,5,14,9,0,23,4.64029859029859,38,29
"['1000000', '10010', '100111', '011']",1,4,12,9,0,21,3.222144522144522,21,20
"['1001', '1111', '1010', '0000010', '0000', '011010']",1,6,17,12,4,29,7.9653846153846155,45,40
"['001011', '1111000', '1']",1,3,6,8,0,14,0.9972527472527473,16,8
"['1000100', '1011101', '00101', '10']",1,4,11,10,2,21,3.198412698412698,22,18
"['0', '110111', '0100']",1,3,5,6,0,11,1.0857142857142859,12,4
"['01', '01101', '000111', '1001']",1,4,8,9,0,17,3.50981240981241,17,16
"['10101', '010', '0110001']",1,3,8,7,0,15,2.0166666666666666,9,6
"['0110101', '0001000', '100', '1110']",1,4,12,9,2,21,3.2519480519480517,22,14
"['0011001', '10', '01010']",1,3,8,6,0,14,1.6825396825396823,12,7
"['1000001', '111100', '1', '0101100', '0001010']",1,5,16,12,3,28,4.4423076923076925,43,21
"['010', '0101110', '00100', '1010100', '100110', '100011', '000']",1,7,22,15,6,37,13.43914973914974,61,66
"['00', '1', '001010']",1,3,6,3,0,9,0.7857142857142857,11,6
"['0111000', '11010', '1101']",1,3,7,9,0,16,2.1010101010101008,8,7
"['0', '1111101', '111', '00110', '100111']",1,5,7,15,0,22,4.324525474525474,37,26
"['1011', '1000', '000']",1,3,7,4,2,11,1.6428571428571428,6,9
"['101010', '00110', '01011']",1,3,8,8,2,16,1.890909090909091,6,7
"['001', '1001', '1111', '001110', '1100']",1,5,9,12,3,21,5.93095238095238,26,26
"['0', '11110', '010111', '1000011', '01011']",1,5,10,14,2,24,4.672311022311022,37,30
"['00011', '100011', '011111', '111000', '01110']",1,5,12,16,5,28,6.266666666666667,33,33
"['0101', '11110', '100', '100101']",1,4,8,10,0,18,3.346176046176046,16,17
"['1110111', '101', '0001', '010101', '10010', '000000', '0111', '110']",1,8,19,19,6,38,14.234382284382285,88,73
"['11010', '1', '000000']",1,3,8,4,0,12,0.696969696969697,14,4
"['101', '110110', '0100100', '0111100']",1,4,11,12,2,23,3.468864468864469,20,13
"['1010010', '011', '000', '011110']",1,4,10,9,2,19,2.952136752136752,20,17
"['100', '000', '01001', '1100', '01000']",1,5,14,6,4,20,6.978571428571429,17,37
"['010001', '010111', '1111']",1,3,6,10,2,16,1.6666666666666665,8,12
"['00111', '00', '1100', '0110']",1,4,8,7,2,15,3.765873015873016,15,20
"['010', '1011100', '11']",1,3,5,7,0,12,1.4444444444444444,11,4
"['01100', '10100', '110', '1']",1,4,7,7,2,14,3.216666666666667,16,12
"['01', '1110000', '00', '10', '011110']",1,5,10,9,3,19,4.726495726495727,36,26
"['10001', '00', '1']",1,3,5,3,0,8,0.9047619047619047,9,4
"['100', '110', '1']",1,3,3,4,2,7,1.6666666666666665,5,6
"['0', '01', '001011', '1100110']",1,4,8,8,0,16,2.762210012210012,25,13
"['000110', '110010', '010', '001', '10000', '100011', '1001011']",1,7,21,15,5,36,13.967288267288268,59,57
"['0', '11010', '11000', '100', '01010', '111101']",1,6,12,13,3,25,8.498340548340549,41,36
"['11001', '0001', '110', '0100']",1,4,9,7,2,16,3.4404761904761902,13,15
"['000110', '100', '10010']",1,3,9,5,0,14,1.9217171717171717,8,10
"['0110010', '111100', '00101']",1,3,9,9,0,18,1.6456876456876457,10,7
"['111', '100100', '0000', '10011', '011110', '011001', '1100011']",1,7,18,19,3,37,11.813830613830614,69,55
"['110110', '01111', '0111110', '111']",1,4,5,16,0,21,3.856993006993007,16,23
"['101', '100', '1']",1,3,3,4,2,7,1.6666666666666665,5,9
"['1011010', '010', '011']",1,3,6,7,2,13,1.8666666666666667,9,9
"['01', '010', '011', '01111', '00', '0110010']",1,6,11,11,4,22,8.829365079365079,40,52
"['11110', '1011111', '11']",1,3,2,12,0,14,1.6825396825396823,11,15
"['10111', '0110010', '10', '011000']",1,4,10,10,0,20,3.651071151071151,21,16
"['1010111', '1000', '010010']",1,3,9,8,0,17,1.9608391608391609,9,5
"['1000110', '1100100', '00', '1011011', '1100']",1,5,14,13,3,27,5.818181818181818,37,30
"['100', '00', '011111', '110', '0100']",1,5,9,9,2,18,5.2785714285714285,27,30
"['000110', '00', '010', '11111']",1,4,8,8,0,16,2.58030303030303,21,15
"['1000001', '010', '100001', '00101', '0011110', '100010', '1000']",1,7,24,14,4,38,13.442463092463093,65,71
"['111111', '1000', '000101', '100111']",1,4,9,13,3,22,2.9,19,22
"['0', '1011', '1111101']",1,3,3,9,0,12,1.1954545454545453,13,5
"['00111', '001', '110', '10']",1,4,6,7,2,13,3.0690476190476192,15,16
"['00', '1', '1100101']",1,3,5,5,0,10,0.6944444444444444,13,4
"['1101001', '01', '1111', '1000', '000', '110', '1110']",1,7,12,15,5,27,10.038816738816738,56,59
"['00111', '00110', '011']",1,3,6,7,2,13,2.3,5,10
"['011111', '1110011', '10', '1001011']",1,4,7,15,2,22,2.776251526251526,24,22
"['110110', '111', '0010011', '0000', '1011011']",1,5,12,15,2,27,5.1136197136197135,36,30
"['00111', '00', '10', '1010011']",1,4,8,8,2,16,2.9126984126984126,21,14
"['11', '1101000', '0101001', '00000']",1,4,13,8,2,21,2.4365079365079363,23,16
"['00100', '00', '1100101', '1010']",1,4,11,7,0,18,3.743145743145743,18,14
"['1011110', '1111', '10', '000', '11100', '111101']",1,6,9,18,0,27,7.728538128538129,49,44
"['110000', '001000', '011011', '1100010', '0001', '10', '10011', '0100101']",1,8,25,18,5,43,16.686025086025086,89,76
"['1001', '0010011', '10', '000', '0101', '1100', '0001000']",1,7,20,11,5,31,12.553823953823953,63,60
"['101100', '01111', '101000', '000000']",1,4,14,9,3,23,2.757575757575758,18,21
"['100', '1111000', '10010', '0111', '0001011', '1101']",1,6,14,16,4,30,8.161976911976911,50,43
"['11011', '10110', '0110', '000', '0111', '111101']",1,6,10,17,4,27,8.74098124098124,38,37
"['101000', '01', '1']",1,3,5,4,0,9,1.4523809523809523,10,6
"['1011', '10', '111']",1,3,2,7,0,9,1.638095238095238,5,11
"['0101110', '111010', '11', '1001101', '011000']",1,5,12,16,4,28,5.742368742368742,36,20
"['00', '0101', '0100110', '0110110']",1,4,11,9,2,20,3.5815295815295816,19,25
"['111', '11000', '10101', '0011010', '1011', '11100']",1,6,12,17,3,29,9.494660894660894,38,46
"['010000', '111', '110001', '0110', '10011', '000', '0111', '110']",1,8,17,17,7,34,15.77034632034632,74,77
"['100', '0101011', '011101', '1000010', '1000', '10', '010011']",1,7,19,16,4,35,12.340492840492841,69,60
"['0101001', '1010', '0000', '1101', '1100', '01110']",1,6,15,13,4,28,8.752525252525253,37,35
"['1000100', '01101', '111', '0110', '0010100', '01111', '10', '0110010', '001011']",1,9,23,23,5,46,21.037662337662336,112,108
"['11010', '1001', '00010', '101110', '1110']",1,5,11,13,4,24,6.0353535353535355,23,29
"['0110101', '01', '1110010', '100', '10110', '000']",1,6,14,13,4,27,8.624603174603175,49,36
"['1011010', '01101', '1', '10000', '111001', '1001001', '0100']",1,7,18,17,4,35,11.83006993006993,68,53
"['0', '0001100', '101101']",1,3,8,6,0,14,1.151098901098901,14,4
"['01', '011010', '110', '00101']",1,4,8,8,0,16,3.365367965367965,17,15
"['00100', '01', '10']",1,3,6,3,2,9,1.6428571428571428,8,6
"['1011', '010000', '1', '100000']",1,4,11,6,2,17,2.604761904761905,23,14
"['0010010', '1', '1101']",1,3,6,6,0,12,1.0136363636363637,13,4
"['11010', '111100', '011', '10', '01100']",1,5,9,12,2,21,5.991847041847042,27,29
"['0', '1110001', '010010']",1,3,8,6,0,14,1.151098901098901,15,4
"['00111', '0110010', '11001']",1,3,8,9,2,17,1.9333333333333333,10,5
"['101100', '1011101', '111110']",1,3,6,13,2,19,2.2051282051282053,6,9
"['1011', '11101', '1111110', '111']",1,4,3,16,0,19,3.618398268398268,16,32
"['0', '01010', '0100']",1,3,7,3,0,10,1.6222222222222222,8,14
"['00110', '01', '10000', '001000']",1,4,13,5,2,18,3.4116883116883114,18,21
"['00101', '011', '01110']",1,3,6,7,2,13,2.1,7,8
"['0', '001111', '0001', '1101', '111101']",1,5,8,13,4,21,4.738095238095238,33,29
"['10111', '100', '1001', '10110', '010010', '010111']",1,6,13,16,4,29,10.327344877344878,33,44
"['100110', '01001', '1']",1,3,6,6,0,12,1.3463203463203464,12,6
"['1010', '010111', '011010', '0000110', '001011']",1,5,15,14,3,29,6.043123543123543,27,30
"['0011', '10111', '1010010', '100', '010110', '000', '0101', '110']",1,8,18,17,5,35,16.88265068265068,73,73
"['1111010', '010101', '0010100']",1,3,10,10,2,20,1.9560439560439562,9,6
"['0001001', '0010', '010', '1', '0011']",1,5,12,7,2,19,5.783116883116883,28,24
"['0', '11010', '110', '101001', '1110']",1,5,8,11,0,19,5.364574314574314,27,26
"['00111', '10111', '10000', '110011', '11101', '10']",1,6,11,17,4,28,8.427272727272728,43,53
"['00111', '0001', '0111001', '00001']",1,4,12,9,2,21,4.2161616161616156,14,23
"['0', '11110', '111', '1010', '00110']",1,5,7,11,2,18,4.3769841269841265,27,26
"['111', '10111', '0001', '01010', '0100']",1,5,10,11,4,21,5.143650793650793,25,23
"['01', '11', '10011', '000000', '1100011']",1,5,12,10,2,22,4.4402541902541905,38,30
"['0100000', '11011', '1111101', '010', '1010', '111111']",1,6,12,20,2,32,7.826850926850927,54,44
"['01111', '0010', '1']",1,3,4,6,0,10,1.1777777777777778,10,4
"['010', '1011100', '0000', '110', '1110']",1,5,11,10,4,21,5.493290043290044,27,29
"['0010001', '110110', '1000100', '11110', '11000', '10110']",1,6,18,17,5,35,9.13969363969364,44,46
"['11000', '1111101', '11']",1,3,4,10,0,14,1.5158730158730158,12,13
"['11110', '011', '1000000', '00010', '110']",1,5,13,10,4,23,4.916666666666667,35,29
"['1010000', '0000010', '10', '00001']",1,4,16,5,2,21,3.246031746031746,22,23
"['01101', '1100', '1', '00000']",1,4,9,6,2,15,2.2444444444444445,20,12
"['101', '0010', '1101011']",1,3,6,8,0,14,1.7168831168831167,10,4
"['11001', '11011', '100001', '1001', '010111']",1,5,11,15,4,26,6.801010101010101,23,47
"['111110', '0111010', '011001', '11']",1,4,7,14,2,21,3.3290598290598292,21,15
"['0001111', '00', '100101', '110111', '11111', '0101']",1,6,11,19,2,30,7.906021756021756,48,50
"['01', '11', '11000', '1101000', '00', '01011']",1,6,12,11,5,23,7.20952380952381,47,46
"['1101000', '1100', '1110']",1,3,7,8,2,15,2.0227272727272725,7,11
"['1000101', '00101', '11', '1110001', '0100100', '1010000', '011010', '11100']",1,8,25,21,6,46,16.868586968586968,91,75
"['0', '10111', '100111', '01100']",1,4,7,10,2,17,3.006926406926407,21,12
"['01101', '11', '00', '0111', '111000', '1001111']",1,6,10,16,2,26,7.921567321567322,50,44
"['001', '1', '010001', '1100110', '1110110']",1,5,11,13,2,24,4.886446886446887,39,26
"['101100', '000001', '1101', '01000', '0100']",1,5,16,9,4,25,5.63939393939394,26,30
"['01', '000101', '11101', '1011', '01100']",1,5,10,12,2,22,5.751948051948052,28,25
"['001', '10', '000010', '11']",1,4,8,5,2,13,2.716666666666667,17,12
"['10010', '011', '00011']",1,3,7,6,2,13,1.85,7,8
"['0101101', '0010100', '000', '11']",1,4,11,8,2,19,2.803174603174603,24,14
"['11110', '11011', '001000', '100', '00', '1011', '001100']",1,7,16,15,4,31,11.194372294372295,62,66
"['000110', '001', '0110110', '1110']",1,4,10,10,0,20,3.1132201132201134,18,22
"['11010', '101', '100100', '000', '1101']",1,5,11,10,2,21,6.275685425685426,23,26
"['0', '11010', '00111', '0011', '001011']",1,5,10,11,2,21,5.54025974025974,30,34
"['010', '11011', '1', '000']",1,4,6,6,2,12,2.25,17,8
"['010', '00011', '0011', '1110011', '110001', '1110']",1,6,13,16,2,29,9.138350538350538,44,52
"['11010', '0100000', '0011110', '100', '1111', '00', '0101']",1,7,17,15,4,32,10.796031746031746,71,56
"['10101', '001', '1001010']",1,3,8,7,0,15,1.7666666666666666,8,8
"['11110', '010111', '011110']",1,3,5,12,2,17,2.121212121212121,6,13
"['011', '0010101', '1111', '1110101', '0010011']",1,5,11,17,3,28,6.150649350649351,33,41
"['1011', '00', '10', '011100']",1,4,7,7,2,14,3.1,18,13
"['0000110', '110', '011', '0111']",1,4,8,9,2,17,3.8406926406926405,17,19
"['01', '000', '11']",1,3,4,3,2,7,0.9,6,4
"['01001', '110', '11100', '1110']",1,4,7,10,2,17,4.04047619047619,13,19
"['0', '0110101', '100001', '00101', '110111', '011001']",1,6,15,16,3,31,7.7435064935064934,49,40
"['0111111', '1', '000']",1,3,4,7,0,11,0.45,15,4
"['0', '111000', '1011001']",1,3,7,7,0,14,1.304945054945055,13,4
"['100', '1', '011100']",1,3,5,5,0,10,1.4523809523809523,10,6
"['0', '111100', '10']",1,3,4,5,0,9,1.4523809523809523,10,6
"['01', '001', '111', '000', '01110']",1,5,8,8,3,16,4.921428571428572,22,22
"['00', '0110100', '110010', '0100']",1,4,12,7,0,19,3.7076146076146075,20,26
"['1010', '010', '0000001']",1,3,10,4,0,14,1.6207792207792209,11,8
"['00101', '1101011', '0101010', '10011', '011111', '00010', '000111', '0100']",1,8,22,23,7,45,17.264402264402264,76,77
"['0', '1001', '110', '1011111']",1,4,5,10,0,15,2.666883116883117,22,12
"['11110', '111', '10011', '0100']",1,4,6,11,2,17,3.0468253968253967,16,17
"['011101', '00', '1']",1,3,4,5,0,9,0.7857142857142857,11,4
"['0', '10010', '0011111', '011001', '1100']",1,5,11,12,0,23,4.788161838161838,38,22
"['0001110', '001101', '101', '0001', '0000010', '10011']",1,6,19,13,2,32,9.502147852147852,45,42
"['0001', '001', '000']",1,3,8,2,2,10,2.380952380952381,3,15
"['111100', '10000', '110100', '1000', '000']",1,5,15,9,2,24,6.342496392496392,22,44
"['11110', '010', '010000']",1,3,8,6,0,14,1.5303030303030303,10,11
"['0110100', '10101', '0000', '01011', '1011111']",1,5,13,15,4,28,5.305772005772005,33,22
"['011011', '1100001', '0000']",1,3,10,7,0,17,1.7426573426573428,11,5
"['0111001', '1', '011', '0010000', '001100', '0101']",1,6,16,12,2,28,8.192141192141191,52,38
"['1000', '110', '10']",1,3,5,4,0,9,2.038095238095238,5,8
"['00111', '0101', '0110111', '11']",1,4,6,12,0,18,3.90981240981241,17,20
"['011', '101000', '10001', '101', '000010']",1,5,14,9,4,23,5.871212121212121,29,25
"['1000', '11011', '1011100', '111']",1,4,7,12,0,19,3.2922799422799423,19,20
"['00111', '01010', '01111', '0111']",1,4,7,12,3,19,4.444444444444445,10,24
"['0011', '10100', '01100']",1,3,8,6,2,14,1.911111111111111,8,10
"['0000111', '0010', '000101', '0']",1,4,12,6,0,18,3.0503996003996003,22,18
"['011011', '1101', '110']",1,3,4,9,0,13,2.3238095238095235,6,10
"['11', '0011', '0011010', '10', '0101']",1,5,9,10,4,19,5.9267676767676765,28,24
"['0110111', '1', '0001111']",1,3,5,10,2,15,1.2142857142857144,15,8
"['001', '000101', '10']",1,3,7,4,0,11,1.5666666666666667,9,8
"['010', '001001', '1']",1,3,6,4,0,10,1.4523809523809523,10,4
"['1000110', '01', '1010010', '101110']",1,4,11,11,2,22,3.6416361416361416,20,20
"['101', '110001', '1', '011010']",1,4,7,9,2,16,3.071428571428571,21,13
"['001', '110', '01010', '111011']",1,4,7,10,2,17,2.9898989898989896,17,13
"['0', '011', '10']",1,3,3,3,0,6,1.5666666666666667,5,6
"['10111', '1101', '01110']",1,3,4,10,2,14,2.1333333333333333,7,5
"['101011', '101100', '111101', '0000']",1,4,10,12,3,22,2.6666666666666665,20,15
"['11', '101101', '100010']",1,3,6,8,2,14,1.6666666666666665,11,9
"['011110', '0110111', '1']",1,3,4,10,0,14,1.151098901098901,13,6
"['1', '0000100', '100000', '001110', '01010', '01100', '0100']",1,7,23,11,4,34,11.78988233988234,65,77
"['11011', '001', '0111', '000', '00010', '101110']",1,6,13,13,4,26,8.246536796536796,41,38
"['00110', '00', '010101', '011000']",1,4,12,7,2,19,3.6926406926406927,20,24
"['0100111', '101', '0110', '111110', '1010011', '01001', '111101']",1,7,14,24,4,38,12.166838716838717,66,66
"['010001', '011', '11111', '01111', '011101', '00110', '1010011', '1110110', '0100']",1,9,19,29,7,48,21.706415806415805,102,111
"['0100', '101111', '11111']",1,3,4,11,0,15,1.3494949494949495,9,10
"['10101', '01111', '0110', '10011', '001100', '101110']",1,6,13,18,5,31,10.044444444444444,37,35
"['1', '011', '0000001', '100010', '110101']",1,5,13,10,2,23,4.422283272283273,40,24
"['0111000', '101', '100', '100010', '0001010']",1,5,16,10,4,26,6.013186813186813,33,28
"['1100111', '001100', '0110', '1111000']",1,4,11,13,2,24,3.693106893106893,22,15
"['11010', '010010', '10', '0101100', '1110110']",1,5,13,14,2,27,6.104673104673105,32,32
"['0', '0001100', '1110011', '000111']",1,4,11,10,2,21,2.741758241758242,28,18
"['001100', '11010', '101', '011']",1,4,8,9,2,17,3.755050505050505,17,11
"['0010', '010', '011', '101001', '10001', '10110', '1100100', '10000', '1001011']",1,9,25,20,7,45,23.198684648684647,95,97
"['11', '11000', '1010100', '00', '00010']",1,5,13,8,4,21,4.655555555555555,33,30
"['0010', '010', '011', '0011000', '11', '1100010', '11101']",1,7,16,15,4,31,12.068831168831169,66,58
"['101100', '1110010', '0100']",1,3,9,8,0,17,2.114685314685315,9,8
"['1011', '01', '001111']",1,3,4,8,0,12,1.7666666666666666,9,7
"['1100101', '110', '01010']",1,3,7,8,0,15,1.7666666666666666,9,7
"['00', '1011001', '0011010', '11111']",1,4,9,12,2,21,2.6031746031746033,25,10
"['0110100', '11000', '00', '0000111', '0100']",1,5,16,9,2,25,5.789321789321789,35,45
"['0110010', '1110001', '1000', '011110', '000', '1101', '0101']",1,7,18,17,5,35,12.807631257631257,62,52
"['11001', '0101000', '101', '011110', '001011']",1,5,13,14,2,27,5.949456099456099,32,20
"['0', '11010', '010001', '000101', '1111110', '011110']",1,6,14,17,3,31,6.628121878121878,58,41
"['010', '001', '11', '101', '100']",1,5,7,7,4,14,6.0,17,21
"['11', '10000', '10100', '010101', '0111', '1010000', '1100', '0100']",1,8,21,16,5,37,17.16899211899212,73,86
"['11011', '0100111', '111000', '10']",1,4,8,12,0,20,3.1895326895326894,23,18
"['101100', '01', '111', '1111110', '01001', '11100']",1,6,10,18,2,28,8.125557775557775,49,45
"['011', '10', '000']",1,3,5,3,2,8,1.1333333333333333,6,6
"['10001', '00', '001', '101110']",1,4,9,7,0,16,3.6113275613275615,17,15
"['111', '101011', '10111', '01111', '1111001', '1000', '1011']",1,7,10,24,4,34,12.287678987678987,54,104
"['0', '000111', '10110', '0110100']",1,4,10,9,0,19,2.6965534465534464,25,15
"['0', '001', '10111', '101', '1011', '001100']",1,6,10,12,2,22,8.50974025974026,39,38
"['110010', '1001', '000010']",1,3,10,6,2,16,2.0666666666666664,7,7
"['010001', '110', '1']",1,3,5,5,0,10,1.2301587301587302,11,6
"['0101010', '1101100', '11']",1,3,7,9,2,16,1.6031746031746033,13,6
"['101000', '10100', '00']",1,3,9,4,0,13,1.9805194805194803,8,15
"['11101', '1', '0000']",1,3,5,5,0,10,0.5555555555555556,12,4
"['0101101', '011', '0110110']",1,3,7,10,2,17,2.057142857142857,10,10
"['10110', '0010100', '0101', '1100', '01000']",1,5,15,10,4,25,6.554545454545455,25,30
"['111111', '0000', '00010', '110', '0100']",1,5,12,10,2,22,4.238961038961039,32,30
"['0', '100001', '111010', '1101000', '111111', '10100']",1,6,14,17,3,31,6.970612720612721,55,37
"['1110011', '100', '1000', '01010', '0000111', '1100']",1,6,16,14,4,30,9.3008658008658,46,44
"['0010', '1110010', '01', '0010100', '00']",1,5,14,8,4,22,5.637085137085137,35,39
"['1010', '010', '11011', '001110']",1,4,8,10,0,18,3.635930735930736,16,14
"['00000', '0001', '1010101', '10010', '01000']",1,5,18,8,3,26,6.196969696969697,23,30
"['0001', '1', '000101']",1,3,7,4,0,11,1.4857142857142858,10,10
"['01101', '1010101', '100', '100010', '000']",1,5,14,10,2,24,5.860839160839161,29,26
"['0', '0101111', '011', '10101', '1101011', '000111', '001011']",1,7,14,21,4,35,12.43151848151848,67,62
"['01101', '01', '1001', '0111111']",1,4,6,12,0,18,3.1572871572871573,20,19
"['1010', '00', '101100', '1101']",1,4,8,8,2,16,3.65,16,14
"['11110', '1', '0010']",1,3,4,6,0,10,1.1777777777777778,10,5
"['1000010', '00', '01111']",1,3,8,6,0,14,1.0634920634920635,14,6
"['111100', '01011', '10']",1,3,5,8,0,13,1.435064935064935,11,7
"['0', '1011', '1101000']",1,3,6,6,0,12,1.1954545454545453,13,5
"['0001', '0100111', '001110', '0000']",1,4,13,8,2,21,3.81013986013986,17,21
"['000110', '010010', '111', '000010']",1,4,13,8,3,21,3.611111111111111,17,19
"['00110', '0101', '1110']",1,3,6,7,2,13,1.8333333333333333,8,8
"['0', '1000100', '01001', '111']",1,4,9,7,0,16,2.15,25,10
"['0001101', '0111110', '0111']",1,3,7,11,2,18,2.025974025974026,10,9
"['0100011', '0111', '0100']",1,3,8,7,2,15,1.7727272727272727,8,12
"['1110010', '100', '10', '0111', '0110010']",1,5,11,12,2,23,5.637806637806638,33,32
"['000100', '001011', '10', '11']",1,4,9,7,4,16,2.9166666666666665,21,14
"['0', '0001010', '0001']",1,3,9,3,0,12,1.3772727272727274,12,11
"['11100', '010000', '10010', '11']",1,4,10,8,2,18,3.0837662337662337,19,13
"['11', '1101100', '1110101', '100000', '10011', '01000']",1,6,16,16,4,32,7.672788322788323,53,45
"['0101111', '010', '011', '1101', '0101', '1100']",1,6,10,15,5,25,9.503030303030302,36,47
"['0001110', '1001010', '10101', '0001100', '1000', '111110', '01000']",1,7,23,18,5,41,11.985625485625485,64,69
"['1010111', '110', '1']",1,3,3,8,0,11,1.15,12,9
"['000110', '1100', '110', '101']",1,4,8,8,2,16,3.806349206349206,16,15
"['010', '011', '011100', '001101', '00111', '10111', '1100110']",1,7,15,20,6,35,14.308857808857809,56,58
"['0001', '1001', '011', '000']",1,4,9,5,4,14,3.6547619047619047,10,16
"['1010', '00', '011', '11010']",1,4,7,7,0,14,3.598412698412698,13,16
"['010010', '10100', '000', '0111', '0101', '110', '1111011']",1,7,15,17,4,32,11.285275835275835,61,53
"['1', '10011', '011001']",1,3,5,7,0,12,1.3463203463203464,12,8
"['1000101', '111010', '01100', '00000']",1,4,14,9,2,23,3.272960372960373,18,12
"['010', '110', '10']",1,3,4,4,2,8,2.2666666666666666,3,9
"['110110', '0101000', '0111011', '11', '01000']",1,5,13,14,2,27,5.509435009435009,36,31
"['01', '11011', '1000', '010111', '011010', '110']",1,6,11,15,2,26,8.136291486291487,44,38
"['0011', '01', '11']",1,3,3,5,2,8,1.8333333333333333,5,8
"['1110', '01011', '111101', '00001']",1,4,8,12,2,20,2.775757575757576,18,17
"['0101', '0110', '00000']",1,3,9,4,2,13,1.6388888888888888,8,9
"['1', '01111', '10110', '0001111', '100110', '1011100']",1,6,12,19,4,31,7.988611388611389,52,43
"['0', '0101000', '10110', '11']",1,4,8,7,0,15,2.265873015873016,23,10
"['0001', '10', '0110011']",1,3,7,6,0,13,1.505050505050505,11,6
"['1010111', '1101101', '00011']",1,3,7,12,2,19,2.0238095238095237,9,11
"['0111', '1', '10000', '01000']",1,4,9,6,2,15,2.533333333333333,20,13
"['1100011', '110', '000000']",1,3,10,6,0,16,1.2837606837606836,13,7
"['01', '011', '0010000', '001000', '11000']",1,5,16,7,0,23,5.691619491619492,33,40
"['0010', '11', '10', '000100', '01011', '0100']",1,6,14,9,4,23,8.621645021645021,39,42
"['11', '000', '1011', '01011', '101001']",1,5,9,11,0,20,5.384415584415584,26,29
"['00101', '001000', '110001', '10110', '100010', '1001101', '00110', '11111', '01001', '1110']",1,10,27,27,8,54,27.762626262626263,121,124
"['01', '0010', '111', '101011', '1100', '0000010', '110', '0100']",1,8,18,15,5,33,14.607425907425908,82,75
"['0100001', '01', '011110']",1,3,8,7,0,15,1.4059829059829059,13,10
"['00100', '010001', '0010011']",1,3,12,6,0,18,2.3298368298368297,7,11
"['1110110', '011', '10', '000000']",1,4,10,8,0,18,2.2243589743589745,26,14
"['1101111', '10111', '100000', '101001', '1101010']",1,5,13,18,4,31,6.112887112887113,29,38
"['00100', '101110', '011110', '11']",1,4,8,11,2,19,3.20995670995671,20,13
"['101', '0101', '1100000']",1,3,8,6,0,14,1.6207792207792209,11,8
"['1111001', '001', '10011']",1,3,6,9,0,15,2.0166666666666666,10,11
"['11011', '11000', '1001', '10110', '00']",1,5,10,11,3,21,6.095238095238095,25,24
"['11001', '00101', '10011', '1010000', '1011', '0101']",1,6,15,15,5,30,9.92979797979798,39,50
"['1001', '110', '0000']",1,3,7,4,2,11,1.3571428571428572,7,4
"['101', '01', '0000110', '1110']",1,4,8,8,0,16,3.0946608946608944,20,13
"['001', '00101', '111']",1,3,5,6,2,11,1.5833333333333333,7,9
"['0', '0001001', '0011', '1101', '0110001']",1,5,13,10,4,23,4.735064935064935,38,24
"['1000100', '1100101', '1101100']",1,3,11,10,3,21,1.7142857142857142,6,10
"['001', '1', '1000', '0001010', '111101']",1,5,11,10,0,21,4.458580308580308,38,23
"['001', '1', '100010']",1,3,6,4,0,10,1.4523809523809523,10,6
"['01', '1101101', '010010', '11111', '001100', '1110']",1,6,12,18,2,30,7.7336552336552336,50,36
"['010', '1001', '1000', '0111', '0100']",1,5,11,8,4,19,6.071428571428571,22,25
"['10000', '11011', '10', '011001']",1,4,9,9,2,18,3.3155844155844156,18,13
"['1011', '1100', '0110100', '111011']",1,4,8,13,2,21,3.7881118881118883,18,19
"['1011', '1101000', '1001', '00000']",1,4,12,8,2,20,3.0075757575757573,19,16
"['1011010', '00', '1000101']",1,3,9,7,2,16,1.3174603174603174,13,5
"['1', '001110', '111100', '111101']",1,4,6,13,3,19,3.0238095238095237,22,15
"['11110', '10110', '110100', '00', '11100']",1,5,10,13,3,23,6.328571428571428,23,32
"['000110', '00101', '00011', '101', '1010', '11101', '0110010', '0100']",1,8,21,18,5,39,17.608097458097458,75,75
"['111010', '0100', '1010011']",1,3,8,9,0,17,1.9426573426573426,9,5
"['0', '11110', '0010010']",1,3,7,6,0,13,0.9166666666666666,14,9
"['01', '00', '010111']",1,3,5,5,2,10,1.5,9,7
"['1110111', '001', '100', '110011', '010110']",1,5,10,15,4,25,5.795726495726496,32,23
"['11', '0101', '0100']",1,3,5,5,2,10,1.75,6,6
"['1', '0001', '100', '11101', '1100101']",1,5,9,11,0,20,4.811327561327561,32,32
"['0011101', '01', '001', '100101']",1,4,9,9,0,18,3.7803418803418802,20,21
"['1010000', '00', '011', '0010']",1,4,11,5,0,16,3.027994227994228,20,19
"['101011', '001', '110', '010110']",1,4,8,10,4,18,3.1666666666666665,17,13
"['111101', '10', '011100', '1111011']",1,4,6,15,2,21,3.6495726495726495,19,16
"['1101100', '10', '111']",1,3,4,8,0,12,1.4444444444444444,11,8
"['0011', '01', '1100000', '1011']",1,4,9,8,2,17,3.032828282828283,21,17
"['101', '01', '001', '1111']",1,4,4,8,2,12,3.4571428571428573,11,17
"['0000111', '11010', '000111']",1,3,9,9,0,18,1.8018648018648018,10,15
"['01', '001', '101', '1101', '1111', '00010']",1,6,9,12,4,21,8.79047619047619,32,40
"['1', '00000', '1010', '0100100', '1011111']",1,5,13,11,2,24,3.6972582972582972,43,20
"['0', '010000', '111010', '0101101', '1011101', '110011']",1,6,15,18,5,33,7.727106227106227,57,33
"['011', '110100', '01110']",1,3,6,8,0,14,1.7398989898989898,9,9
"['101', '001', '000011', '11']",1,4,7,7,2,14,3.477777777777778,15,18
"['110010', '010', '1011100', '01010']",1,4,11,10,0,21,3.844172494172494,18,22
"['10010', '000101', '011000']",1,3,11,6,2,17,1.9545454545454546,9,8
"['110101', '011110', '0000']",1,3,8,8,2,16,1.3,11,4
"['100', '0010111', '111', '0100']",1,4,8,9,2,17,3.0216450216450217,19,18
"['0000100', '1010100', '100', '10010', '11111']",1,5,15,12,4,27,5.314285714285714,34,31
"['010', '0001110', '10100', '1011', '00010']",1,5,14,10,2,24,6.094660894660895,28,31
"['1', '11000', '0011110', '1101011', '01010', '011111']",1,6,12,19,4,31,7.263669663669663,56,35
"['011', '101000', '101', '01111', '0101011']",1,5,10,14,2,24,5.706798756798757,31,30
"['1001', '000010', '11']",1,3,7,5,0,12,1.5166666666666666,10,4
"['001', '010110', '10', '1010011', '000111', '1110']",1,6,13,15,2,28,8.226701076701076,49,38
"['01', '0010', '100', '0000', '011111']",1,5,11,8,2,19,4.615079365079365,30,28
"['11', '000', '1011', '1110110', '0101']",1,5,8,12,2,20,5.057647907647907,31,23
"['011', '1111', '00', '01010', '1011', '110', '0100']",1,7,11,14,5,25,11.252380952380951,46,55
"['0', '00100', '010010']",1,3,9,3,0,12,1.3463203463203464,12,12
"['1001110', '010', '00', '001010', '0100']",1,5,14,8,0,22,6.4496059496059495,28,43
"['001', '111', '1100001', '100000', '0000011']",1,5,16,10,4,26,5.452747252747253,36,35
"['0011011', '010', '10010', '1110']",1,4,9,10,0,19,3.577994227994228,18,17
"['111', '0100', '001000']",1,3,8,5,0,13,1.307936507936508,10,6
"['1011', '0010111', '0000001', '00001']",1,4,14,9,2,23,3.2972582972582973,19,22
"['11001', '11110', '011', '100', '1000111', '100110']",1,6,12,17,4,29,9.107109557109556,45,47
"['01', '110010', '1000101', '1111', '00', '1011', '011010']",1,7,14,17,6,31,10.731080031080031,67,48
"['1100011', '1000', '0100011', '10']",1,4,11,9,2,20,3.867243867243867,19,19
"['0101110', '0101000', '1011001', '1']",1,4,11,11,3,22,2.892857142857143,26,11
"['11010', '101110', '10011']",1,3,6,10,2,16,1.6727272727272728,6,9
"['10101', '1111', '00', '10010', '0001000']",1,5,13,10,2,23,4.846897546897547,35,21
"['010', '011', '011100', '11', '0000001', '001010', '000010', '101110']",1,8,23,16,6,39,15.429487179487179,91,83
"['11000', '00', '011110']",1,3,7,6,0,13,1.6168831168831168,10,10
"['10001', '100', '10000']",1,3,9,4,2,13,2.3,5,14
"['0', '0001001', '10110', '0000101', '1111010']",1,5,15,12,3,27,4.464285714285714,45,24
"['1101', '10', '0000']",1,3,6,4,2,10,1.25,8,4
"['11010', '00101', '11', '100', '1001']",1,5,9,10,2,19,6.25,23,28
"['11', '0010011', '1011100', '101111', '011000']",1,5,12,16,4,28,5.72954822954823,37,30
"['010', '1', '0100010', '1100001', '1000000', '011110']",1,6,19,12,3,31,7.12985347985348,63,34
"['001', '1', '00001', '011101', '1010', '000100']",1,6,15,10,2,25,7.472655122655122,46,38
"['0011', '10111', '100100', '0001111', '10100', '01010', '000000', '0110010']",1,8,26,19,7,45,16.048507048507048,89,85
"['1010000', '100', '101', '1']",1,4,8,6,2,14,3.1166666666666667,19,19
"['1000000', '110001', '110', '0000']",1,4,14,6,0,20,3.295038295038295,20,18
"['00', '1', '1101100']",1,3,5,5,0,10,0.6944444444444444,13,6
"['1100010', '100', '10110']",1,3,8,7,0,15,1.85,9,8
"['1010', '011', '0100', '11']",1,4,6,7,2,13,3.6928571428571426,12,13
"['101000', '1001', '0000']",1,3,10,4,2,14,1.7,7,9
"['010', '1100', '110', '01011', '0100']",1,5,10,9,4,19,6.634920634920634,18,35
"['110000', '0110100', '11', '101', '1110011', '1110001', '0011100']",1,7,18,21,4,39,12.777167277167278,75,63
"['110110', '01', '0010', '00101', '1000']",1,5,12,9,2,21,5.922438672438672,28,27
"['010101', '011110', '11111', '010011', '1001111']",1,5,10,20,3,30,6.456876456876457,28,31
"['0', '01', '011']",1,3,3,3,0,6,1.9666666666666668,4,7
"['1', '0010111', '001000', '1001', '0000000', '110']",1,6,18,10,2,28,6.066172716172716,61,39
"['11000', '001001', '100', '001011']",1,4,12,8,2,20,3.6035353535353534,17,21
"['1', '110', '1000101', '101001']",1,4,8,9,0,17,2.4955433455433456,22,20
"['1110010', '101', '1111', '1011', '01110']",1,5,7,16,2,23,6.119480519480519,26,30
"['10', '1100100', '011110', '1111']",1,4,7,12,0,19,3.0847707847707846,22,13
"['100', '0011111', '0011100']",1,3,8,9,2,17,1.7142857142857144,12,15
"['11010', '011100', '0101010', '1000', '10011', '000000']",1,6,20,13,4,33,8.545221445221445,43,44
"['00100', '10001', '000']",1,3,10,3,2,13,2.1,7,8
"['101010', '1111', '100110', '00', '00010', '01110']",1,6,14,14,4,28,7.6620490620490616,42,41
"['00111', '0010000', '0']",1,3,9,4,0,13,1.0833333333333333,14,11
"['110', '10', '0010101', '11111']",1,4,6,11,0,17,2.9301587301587304,21,15
"['101', '001', '0110']",1,3,5,5,2,10,1.8095238095238093,6,5
"['1', '0010100', '0111']",1,3,6,6,0,12,1.1954545454545453,13,4
"['00', '110', '1', '00101']",1,4,6,5,0,11,2.3047619047619046,16,12
"['1011', '0101011', '10011', '101011']",1,4,8,14,0,22,5.081662781662782,10,39
"['010', '01101', '100100', '110', '0100101']",1,5,13,11,2,24,6.425796425796426,26,27
"['1000', '1100', '1100110']",1,3,8,7,2,15,2.2045454545454546,7,10
"['10101', '110', '0000001']",1,3,9,6,0,15,1.0333333333333332,12,7
"['0011', '00', '0111101', '00101']",1,4,9,9,0,18,3.783549783549783,18,20
"['0', '01101', '00100', '1100001', '100111', '0111']",1,6,14,14,2,28,7.935947385947386,52,34
"['0100100', '1100', '1110']",1,3,8,7,2,15,1.6590909090909092,8,9
"['11010', '0001111', '1000', '001010', '100011', '000', '1011', '1101']",1,8,20,19,5,39,16.93086358086358,79,87
"['1011', '1100', '1001000', '0000']",1,4,12,7,3,19,2.8863636363636362,18,19
"['100001', '00111', '1001000', '010110', '0001010', '011010', '01011', '0100']",1,8,27,19,7,46,18.07994227994228,76,86
"['1011110', '1000', '1']",1,3,5,7,0,12,1.1954545454545453,13,7
"['011101', '0000110', '0100100']",1,3,12,8,2,20,1.9450549450549453,9,10
"['10101', '100', '0110', '1111', '11101', '011111', '1011011', '0100']",1,8,13,25,5,38,17.172910422910423,70,82
"['0011101', '001', '10']",1,3,6,6,0,12,1.4444444444444444,11,9
"['0', '1100010', '01100']",1,3,8,5,0,13,1.25,14,8
"['1', '1100', '1001011']",1,3,5,7,0,12,1.1954545454545453,13,9
"['11110', '01100', '10', '01001', '110', '1001011']",1,6,12,15,3,27,8.658730158730158,45,37
"['1001110', '1', '10111', '1010', '0100101']",1,5,10,14,2,24,5.22034632034632,35,27
"['010', '001', '101', '0111110', '111101']",1,5,8,14,3,22,5.724786324786325,33,22
"['111', '11000', '00', '10', '0111']",1,5,7,9,2,16,4.511111111111111,26,27
"['0101', '0001110', '101001', '11']",1,4,9,10,0,19,3.571950271950272,22,11
"['010', '000001', '00011']",1,3,10,4,0,14,1.6717171717171717,9,8
"['1010', '1100', '1', '011']",1,4,5,7,2,12,3.192857142857143,15,13
"['0010', '01100', '1111']",1,3,6,7,2,13,1.1388888888888888,8,5
"['1001', '1', '0010000']",1,3,8,4,0,12,1.1954545454545453,13,4
"['110110', '011', '10100', '10', '1000011', '1011']",1,6,12,15,0,27,9.242945942945942,43,49
"['0', '1010', '011011', '1111001']",1,4,7,11,0,18,2.6965534465534464,24,11
"['00', '01001', '001']",1,3,7,3,0,10,2.1214285714285714,6,10
"['0101', '00110', '11101', '0100100']",1,4,11,10,2,21,3.827272727272727,18,15
"['1011011', '0001', '010101', '1']",1,4,8,10,0,18,2.4685814185814188,23,15
"['01', '001', '100001', '110100']",1,4,10,7,2,17,3.411111111111111,19,17
"['0110101', '11011', '0000100', '1100010', '00', '0101100']",1,6,20,15,4,35,8.420634920634921,55,43
"['101011', '100', '1111', '010110', '0111100']",1,5,10,16,2,26,5.656576756576756,29,22
"['100', '011010', '0110']",1,3,7,6,0,13,2.038095238095238,7,12
"['1000110', '01', '1101111']",1,3,6,10,2,16,1.4603174603174602,13,6
"['0110000', '001', '1001']",1,3,9,5,0,14,1.8025974025974025,10,7
"['110', '111', '1010101', '010110', '1100']",1,5,9,14,2,23,6.121034521034521,27,26
"['101', '1', '10011']",1,3,3,6,0,9,1.5833333333333333,8,13
"['0', '1011001', '111', '100010', '10010', '100000', '01100']",1,7,19,14,4,33,10.492291042291042,71,52
"['1101001', '11001', '1001010', '11', '100', '0110010', '110']",1,7,16,18,5,34,13.147619047619047,66,63
"['10111', '11100', '10011', '000']",1,4,8,10,3,18,3.25,18,17
"['00110', '11110', '000001', '01000']",1,4,13,8,3,21,2.8727272727272726,18,20
"['0111011', '10100', '1010001', '01001', '111101']",1,5,13,17,4,30,6.344622044622045,28,32
"['001', '1011001', '00011', '10010', '110']",1,5,12,11,4,23,5.8,30,26
"['011', '0101', '0110', '111']",1,4,5,9,4,14,4.273809523809524,9,16
"['0010', '10', '0100']",1,3,7,3,2,10,2.083333333333333,6,10
"['110011', '1011', '0111', '0010101']",1,4,8,13,2,21,4.21993006993007,17,20
"['11001', '1', '10']",1,3,3,5,0,8,1.5714285714285714,8,8
"['101010', '0101', '00000']",1,3,10,5,0,15,1.7898989898989899,8,6
"['10111', '10000', '01010', '01100', '1110']",1,5,12,12,4,24,5.822222222222222,26,24
"['011100', '0001', '110100', '10010', '0000011', '10']",1,6,18,12,2,30,7.529548229548229,55,41
"['111100', '11', '11000', '0000001', '110100', '11101', '0011011', '1011011', '001100']",1,9,24,27,8,51,20.391597291597293,117,134
"['0', '0101101', '10']",1,3,5,5,0,10,1.3611111111111112,12,6
"['0', '1011', '1000', '101001']",1,4,8,7,2,15,2.9857142857142858,17,14
"['0011', '100101', '010010', '00011']",1,4,12,9,2,21,4.576767676767677,12,14
"['0010', '11010', '001000', '1001000', '0000']",1,5,19,7,2,26,6.669036519036519,23,51
"['01', '010', '001101', '100000', '010110', '0100']",1,6,17,10,3,27,8.984920634920634,45,50
"['01', '10010', '0111', '010011', '011010']",1,5,11,12,2,23,6.037085137085137,26,30
"['010', '0100110', '11111', '0101', '0000110']",1,5,13,13,2,26,5.548124098124098,33,32
"['00', '010', '1001000', '1010011']",1,4,12,7,2,19,3.4603174603174605,22,13
"['001100', '10011', '1001101']",1,3,9,9,0,18,2.3298368298368297,7,8
"['11011', '001101', '101011', '1000010', '0110000', '011110', '11111', '001001', '1100', '0110110']",1,10,27,32,9,59,27.576845376845377,136,120
"['0', '00011', '10111', '100', '110111', '111101']",1,6,9,17,4,26,7.257287157287157,48,46
"['0', '11110', '010110']",1,3,5,7,0,12,1.3463203463203464,11,10
"['1011', '0110', '0100']",1,3,6,6,3,12,2.0,6,5
"['00011', '010', '111001', '0000']",1,4,11,7,0,18,3.127994227994228,19,15
"['11011', '00011', '101', '1100101', '11111', '00010']",1,6,12,18,4,30,8.883333333333333,40,54
"['1010', '01', '11101', '1100100']",1,4,8,10,0,18,3.743145743145743,18,14
"['0011110', '1100101', '1']",1,3,6,9,2,15,1.0714285714285714,17,4
"['000111', '00000', '10', '11']",1,4,9,6,2,15,2.081168831168831,22,16
"['110110', '1010', '1']",1,3,4,7,0,11,1.4857142857142858,10,7
"['101011', '0010011', '011101', '010011', '1100', '1110']",1,6,14,19,5,33,9.046270396270396,42,48
"['1000', '11011', '0010000']",1,3,10,6,0,16,1.505050505050505,11,7
"['100', '10', '11']",1,3,3,4,2,7,1.7000000000000002,4,7
"['101', '111111', '01101', '100001']",1,4,7,13,2,20,3.1035353535353534,19,23
"['1001001', '0001001', '01000']",1,3,13,6,2,19,2.1904761904761902,7,11
"['00001', '00011', '1011101', '0011110', '000001', '001100']",1,6,21,15,6,36,9.077222777222778,44,54
"['00', '100', '1111']",1,3,4,5,0,9,1.0857142857142859,8,6
"['00100', '110', '010110', '101001']",1,4,11,9,2,20,3.7323232323232323,16,12
"['100111', '110111', '1111']",1,3,3,13,2,16,2.033333333333333,5,26
"['0001', '111', '001000']",1,3,8,5,0,13,1.107936507936508,11,7
"['0', '00100', '0011111']",1,3,7,6,0,13,1.0833333333333333,14,11
"['01', '1001', '10110', '110011', '000001']",1,5,12,11,2,23,5.895670995670995,30,27
"['1011', '11110', '0110', '10000']",1,4,8,10,4,18,3.15,15,14
"['1111100', '11110', '011', '101', '000001']",1,5,10,14,2,24,4.678399378399378,39,27
"['101', '00', '100', '1101110']",1,4,7,8,2,15,3.511111111111111,17,13
"['1000001', '1011', '11011']",1,3,7,9,0,16,1.9343434343434343,9,17
"['0100001', '1', '010010']",1,3,9,5,0,14,1.304945054945055,13,7
"['1000011', '0011', '0111']",1,3,7,8,2,15,2.0227272727272725,8,11
"['010100', '101', '10010', '1']",1,4,8,7,0,15,3.081168831168831,19,11
"['001', '1', '001000', '0000', '1011']",1,5,12,6,2,18,4.245238095238095,30,27
"['00011', '11', '0001', '1110011', '010010']",1,5,12,12,0,24,6.092873792873792,30,31
"['0', '100', '111011']",1,3,4,6,0,10,1.2301587301587302,11,4
"['101', '0000110', '100000', '1111']",1,4,11,9,0,20,2.748740148740149,24,14
"['00', '1001', '010010', '01100']",1,4,11,6,0,17,3.932034632034632,16,15
"['01101', '111', '00001', '0100010', '100', '0110', '10']",1,7,16,13,4,29,11.605050505050505,58,51
"['0', '1100001', '111']",1,3,5,6,0,11,0.85,13,6
"['000110', '011010', '1100101']",1,3,10,9,2,19,2.051282051282051,10,5
"['1111000', '10000', '00011']",1,3,10,7,2,17,1.7666666666666666,12,13
"['0110111', '1000101', '0111']",1,3,7,11,2,18,1.844155844155844,11,11
"['0', '1011001', '11000', '1001', '10000', '1010']",1,6,15,11,4,26,8.554545454545455,43,41
"['0101', '11100', '10', '111110']",1,4,6,11,0,17,3.3098124098124098,18,15
"['01', '101010', '110100', '0011011', '1110110']",1,5,12,16,4,28,6.205738705738706,34,25
"['0', '110011', '1000', '000111', '11111', '01001', '0101']",1,7,14,17,6,31,10.62092352092352,67,55
"['0101000', '1', '0100']",1,3,8,4,0,12,1.3772727272727274,12,7
"['00111', '1110101', '10']",1,3,5,9,0,14,1.2301587301587302,13,8
"['01', '00010', '111100']",1,3,7,6,0,13,1.185064935064935,12,7
"['11100', '011', '1110']",1,3,4,8,0,12,1.9603174603174602,6,11
"['011', '0110', '010010', '1001001', '010011', '00010']",1,6,18,13,2,31,10.395604395604396,38,47
"['01111', '0100', '100011', '000111', '01110', '1110']",1,6,13,17,6,30,9.345454545454546,41,46
"['001101', '00101', '100', '1111000', '001001']",1,5,15,12,2,27,6.285703185703186,30,38
"['10101', '1001', '000', '0011000']",1,4,12,7,0,19,3.6057720057720055,18,16
"['101010', '00111', '0100100', '0001010', '0110010', '011010', '11100']",1,7,24,19,7,43,13.715051615051616,57,84
"['0010', '110', '001000']",1,3,9,4,0,13,1.8158730158730159,8,13
"['101100', '000101', '0000']",1,3,11,5,2,16,1.7000000000000002,8,13
"['1000100', '010011', '11011']",1,3,9,9,0,18,1.8426573426573427,10,9
"['0111010', '101', '100', '0110000', '10']",1,5,12,10,4,22,6.06984126984127,32,25
"['0101101', '111', '000']",1,3,6,7,2,13,1.2,11,4
"['1001000', '10', '0000']",1,3,10,3,0,13,1.323232323232323,11,11
"['1000100', '1', '1100', '001011', '01110']",1,5,12,11,0,23,4.375341325341325,38,23
"['01', '0001', '01011']",1,3,6,5,0,11,1.6825396825396823,7,8
"['11010', '1101111', '00', '01010', '0101', '110', '01110']",1,7,13,18,3,31,12.975613275613275,54,65
"['00111', '0010', '0101', '11100']",1,4,9,9,4,18,3.572222222222222,16,18
"['00', '1', '0010']",1,3,5,2,0,7,1.0666666666666667,7,6
"['0110', '111011', '011101', '00', '110']",1,5,8,13,2,21,6.2404761904761905,27,24
"['1010111', '100111', '10', '11']",1,4,5,12,2,17,3.3119658119658117,20,28
"['0011001', '10101', '0101', '011']",1,4,9,10,0,19,4.48997113997114,14,18
"['1100011', '0010', '011']",1,3,7,7,0,14,1.7168831168831167,10,7
"['01101', '101', '110100', '1101110', '000001', '001100', '1100', '01000']",1,8,23,19,5,42,16.814746364746366,81,85
"['10101', '100111', '110111', '1110']",1,4,6,15,2,21,3.9323232323232324,13,28
"['1000001', '101101', '1011110', '1110001', '00110', '0111']",1,6,16,20,3,36,9.365101565101565,49,44
"['1010111', '1010101', '01111', '10']",1,4,7,14,2,21,3.3650793650793647,20,22
"['000101', '011', '01100']",1,3,8,6,0,14,1.7803030303030303,8,9
"['001', '00111', '10001', '0000001', '1111', '110']",1,6,14,13,4,27,7.5500721500721495,49,50
"['001', '011', '10']",1,3,4,4,2,8,1.4666666666666668,5,6
"['0101010', '0010', '1100', '0100']",1,4,12,7,3,19,3.8181818181818183,15,26
"['0010001', '1011011', '00111', '111']",1,4,9,13,2,22,3.6547619047619047,20,23
"['111', '001000', '0101101', '1001101', '000000']",1,5,17,12,4,29,4.9332112332112334,36,26
"['110111', '010', '1111000', '111011']",1,4,7,15,2,22,3.1991452991452993,22,21
"['0', '11000', '100111']",1,3,6,6,0,12,1.1645021645021645,13,5
"['10101', '0011', '0010', '1']",1,4,7,7,2,14,3.216666666666667,15,12
"['1000001', '00', '1', '0011010']",1,4,11,6,2,17,1.8174603174603174,28,10
"['01', '110010', '11011', '100', '00']",1,5,9,9,2,18,5.451082251082251,27,23
"['1010110', '1001', '01000']",1,3,9,7,0,16,2.0606060606060606,8,5
"['101', '11100', '1011000']",1,3,7,8,0,15,1.9333333333333333,9,9
"['00100', '000100', '111100']",1,3,11,6,2,17,1.9545454545454546,7,21
"['110110', '111', '011', '1100001', '1001', '1100000', '10', '110101']",1,8,17,21,6,38,16.61033411033411,87,104
"['11010', '0111', '001000']",1,3,8,7,0,15,1.612121212121212,10,7
"['0001', '0010101', '0000']",1,3,11,4,2,15,2.0227272727272725,7,14
"['11000', '1010', '0001110']",1,3,9,7,0,16,1.5303030303030303,11,9
"['10000', '0110100', '10', '011100']",1,4,12,8,0,20,3.484404484404484,19,21
"['01', '100', '000', '0100101', '1110']",1,5,11,8,2,19,4.665223665223665,30,24
"['0110101', '0010', '1', '1000', '110']",1,5,10,9,2,19,5.315584415584415,31,20
"['001', '11', '1011101', '1100100', '110']",1,5,9,13,4,22,5.193650793650794,36,30
"['0', '1010000', '10110']",1,3,8,5,0,13,1.25,13,8
"['0', '1011', '100011', '101101']",1,4,7,10,2,17,3.238095238095238,20,19
"['0001110', '0000100', '11', '1010111', '0111']",1,5,13,14,3,27,5.453102453102453,38,26
"['0000111', '01', '110', '1000101']",1,4,10,9,2,19,2.803174603174603,23,14
"['10111', '01', '101']",1,3,3,7,0,10,2.1214285714285714,6,11
"['0111000', '0010', '111', '101', '100', '000']",1,6,13,10,4,23,7.697835497835498,39,38
"['0', '1000', '11']",1,3,4,3,0,7,0.7333333333333334,8,4
"['1', '011', '100001', '011001', '0001011']",1,5,12,11,2,23,4.776129426129426,38,28
"['00111', '101', '0101', '000']",1,4,8,7,2,15,3.4285714285714284,13,14
"['0010001', '01', '101101', '100010', '0010011', '111011', '0000']",1,7,21,17,5,38,11.777733377733378,70,55
"['0011', '11000', '0110100', '10']",1,4,10,8,0,18,3.1724386724386724,21,16
"['101', '0000001', '1100100', '010110']",1,4,14,9,2,23,2.8644688644688645,23,12
"['0000001', '1000', '11101', '10', '0100101']",1,5,15,10,2,25,5.193362193362193,36,27
"['0', '100', '01011']",1,3,5,4,0,9,1.3333333333333333,9,6
"['101', '111', '10011']",1,3,3,8,2,11,1.9166666666666665,5,15
"['0', '101', '00100', '01100']",1,4,9,5,2,14,2.966666666666667,17,15
"['11101', '1', '01000', '0010011']",1,4,9,9,2,18,2.3166666666666664,24,12
"['1000001', '001', '00101', '00000', '00111', '0011', '1101']",1,7,20,13,5,33,12.808369408369408,54,72
"['1111100', '0010', '00001', '101', '0000001', '000010', '110', '1110']",1,8,23,16,6,39,14.322449772449772,98,90
"['101100', '01', '0110', '01011']",1,4,8,9,0,17,3.932034632034632,16,15
"['110110', '1010', '11110', '110101']",1,4,7,14,2,21,3.9686868686868686,11,21
"['01', '1001', '0011101']",1,3,6,7,0,13,1.6565656565656566,11,9
"['00000', '11', '100110', '1010', '100000']",1,5,15,8,2,23,5.382323232323232,30,31
"['0001001', '01111', '0011010']",1,3,10,9,2,19,1.880952380952381,10,7
"['0011101', '1100', '101001', '0000']",1,4,12,9,2,21,3.2524475524475527,18,16
"['010', '11', '0011110', '1110', '011000']",1,5,10,12,0,22,5.791863691863692,31,29
"['0', '001100', '01', '111']",1,4,6,6,0,12,2.2968253968253967,19,10
"['011111', '0', '11']",1,3,2,7,0,9,0.7857142857142857,11,6
"['000011', '0110110', '01100']",1,3,10,8,0,18,1.8403263403263403,9,12
"['1011', '000000', '1110']",1,3,8,6,2,14,0.9,12,5
"['0101', '1', '0010101']",1,3,6,6,0,12,1.3772727272727274,12,9
"['00001', '001111', '11']",1,3,6,7,0,13,1.331168831168831,11,9
"['1101', '010', '000101', '1']",1,4,7,7,0,14,3.0238095238095237,18,12
"['0', '1101', '1100', '10']",1,4,5,6,2,11,3.55,12,12
"['00011', '1', '011', '110101']",1,4,6,9,0,15,3.081168831168831,19,18
"['001', '0111100', '11']",1,3,5,7,0,12,1.2444444444444445,12,5
"['011100', '11', '0100100', '0101', '0100']",1,5,13,10,2,23,6.164374514374514,28,37
"['0010', '001', '111', '01010']",1,4,8,7,2,15,3.142857142857143,12,14
"['01', '00', '0111', '0110011']",1,4,7,8,2,15,3.116161616161616,19,17
"['01', '10', '1101010']",1,3,5,6,2,11,1.3888888888888888,12,7
"['11001', '00111', '11101', '11111', '0001011']",1,5,9,18,4,27,6.166666666666667,27,47
"['01011', '01010', '111']",1,3,5,8,2,13,1.8,6,9
"['010', '101', '0001111', '000000', '1100111', '1110110', '1001011', '1111011']",1,8,20,27,7,47,15.225641025641025,107,88
"['001', '001111', '000101', '0111', '110']",1,5,10,12,4,22,5.765079365079365,28,29
"['101100', '101', '1111111']",1,3,4,12,0,16,1.3743589743589744,12,10
"['01', '010011', '110', '11']",1,4,5,8,2,13,3.1444444444444444,16,18
"['1', '111100', '0000001', '10100', '1100110', '1010000']",1,6,19,14,3,33,7.182400932400933,60,44
"['01001', '001', '010101', '011']",1,4,9,8,2,17,4.186868686868687,12,20
"['0', '001', '010111']",1,3,5,5,0,10,1.2301587301587302,10,6
"['011101', '10001', '001110', '01000']",1,4,12,10,4,22,3.6333333333333333,17,13
"['000110', '1100', '10', '111100']",1,4,9,9,2,18,3.5666666666666664,20,19
"['101000', '1010100', '0101010', '0000', '0110010']",1,5,20,11,3,31,6.247352647352647,25,39
"['00111', '1110110', '10011']",1,3,6,11,2,17,1.9666666666666668,9,10
"['00110', '10101', '00001']",1,3,9,6,3,15,1.6,8,6
"['0110101', '1000', '10']",1,3,7,6,0,13,1.6565656565656566,11,7
"['001', '110111', '111']",1,3,3,9,2,12,1.4444444444444444,9,14
"['01', '0110', '110010']",1,3,6,6,0,12,1.7666666666666666,9,8
"['01', '111010', '111110', '1011', '110101']",1,5,7,17,3,24,5.716666666666667,29,31
"['111', '11000', '1011101', '0000001', '0101']",1,5,13,13,2,26,4.51067821067821,37,30
"['1101001', '001111', '1100000', '100110', '10100', '110111']",1,6,17,20,5,37,8.745754245754245,46,50
"['0100110', '111', '101011', '10001', '0111111', '111110']",1,6,11,23,4,34,8.07930957930958,48,50
"['10111', '0110', '0100']",1,3,6,7,2,13,1.8611111111111112,6,5
"['1000100', '01', '101101', '1111', '1110100', '101111']",1,6,12,20,4,32,8.722288822288823,50,57
"['1111101', '10', '0100', '11']",1,4,5,10,2,15,2.7525252525252526,21,12
"['111', '101', '0001', '10', '0001000']",1,5,11,8,2,19,4.828860028860029,31,25
"['01', '000011', '0011', '0001010', '101001']",1,5,15,10,2,25,6.28966588966589,32,26
"['0', '0010', '00101', '10101', '1110']",1,5,10,9,4,19,5.211111111111111,25,25
"['001001', '001011', '1001']",1,3,9,7,2,16,2.2333333333333334,6,12
"['10101', '1101101', '100', '110111', '000', '01010']",1,6,13,16,4,29,9.57913752913753,41,36
"['1', '010110', '01010', '1100', '1110']",1,5,9,11,2,20,5.58924963924964,26,26
"['0', '110010', '001001', '010110']",1,4,11,8,3,19,2.6904761904761902,23,15
"['10100', '100000', '1111']",1,3,8,7,0,15,1.1898989898989898,10,8
"['0010', '0010011', '10', '000001', '0101']",1,5,15,8,2,23,5.6938616938616935,30,27
"['0', '01', '1110', '011001']",1,4,6,7,0,13,2.7857142857142856,19,14
"['0110000', '01', '0101111']",1,3,8,8,2,16,1.3174603174603174,15,9
"['010', '11', '1100010', '011101', '10010', '100111']",1,6,13,16,2,29,8.88048063048063,49,44
"['000110', '0101', '10', '1011111']",1,4,8,11,0,19,3.218104118104118,22,12
"['11000', '110010', '0111']",1,3,7,8,0,15,1.9535353535353535,9,11
"['011', '101', '100', '0110', '0000011', '001100']",1,6,15,11,3,26,8.805283605283606,47,39
"['1111100', '111010', '1011101', '110001', '0000001', '1110001', '0000011', '01010']",1,8,26,26,7,52,16.175657675657675,96,93
"['1110111', '110', '10']",1,3,3,9,0,12,1.8444444444444446,10,9
"['0111', '1000', '000011', '1101']",1,4,9,9,3,18,2.85,18,17
"['0001001', '1', '10110']",1,3,7,6,0,13,1.0833333333333333,14,6
"['1110001', '10', '000']",1,3,7,5,0,12,1.4444444444444444,11,4
"['101011', '1010101', '0000000', '1000000', '10010', '01011']",1,6,23,14,5,37,9.11914751914752,45,52
"['010010', '1', '10011']",1,3,6,6,0,12,1.3463203463203464,11,4
"['111', '101000', '1001', '1100110', '0110011']",1,5,12,15,2,27,6.5121767121767125,32,28
"['0011', '1000', '00', '101000']",1,4,11,5,2,16,3.533333333333333,17,24
"['101100', '100', '0111', '11111', '1011']",1,5,7,15,2,22,5.398556998556998,26,36
"['1000110', '10', '1011', '01001', '110']",1,5,10,11,0,21,6.214574314574314,29,28
"['00', '010011', '10010', '01110']",1,4,10,8,2,18,3.3155844155844156,18,16
"['001101', '111', '0011001', '00', '1110110']",1,5,11,14,2,25,5.365445665445665,37,31
"['1101001', '00001', '101', '10110', '10000']",1,5,14,11,3,25,5.816666666666666,29,33
"['10', '1100100', '11']",1,3,5,6,2,11,1.3888888888888888,11,8
"['0110111', '1111001', '111110', '10', '011110', '110']",1,6,9,22,4,31,9.242368742368743,48,51
"['11100', '1101', '1']",1,3,3,7,0,10,1.4,9,9
"['0', '000001', '10011']",1,3,8,4,0,12,1.1645021645021645,12,4
"['101100', '010011', '1001', '1']",1,4,8,9,2,17,3.038095238095238,22,15
"['10111', '00', '0110100']",1,3,7,7,0,14,1.2301587301587302,13,6
"['0101', '1011011', '011']",1,3,5,9,0,14,2.0025974025974023,8,9
"['1', '1110101', '10011', '00010', '1011011']",1,5,10,15,4,25,4.623809523809523,37,29
"['11', '0000101', '100101', '1010000', '110']",1,5,14,11,2,25,5.38937728937729,36,32
"['1000110', '0111111', '0001']",1,3,8,10,2,18,1.5194805194805194,13,6
"['0', '00101', '000010']",1,3,9,3,0,12,1.3463203463203464,11,9
"['1101011', '0010000', '11']",1,3,8,8,2,16,1.0952380952380951,16,8
"['01', '0010', '10111', '0011', '01011']",1,5,9,11,4,20,6.692857142857143,21,25
"['0100000', '001', '000101', '110011', '00010', '110']",1,6,19,11,4,30,8.372066822066822,48,44
"['011', '010101', '10', '000', '111001']",1,5,10,10,4,20,4.688888888888889,31,21
"['01', '00', '0100110']",1,3,7,4,2,11,1.3888888888888888,11,9
"['0010', '1', '1011110', '1000110', '011101', '0000111', '11100']",1,7,17,20,3,37,11.025613275613276,81,50
"['000110', '11110', '001', '0000100', '011', '111010', '10101']",1,7,18,17,6,35,11.398445998445998,67,55
"['0010', '111', '10111', '0011110', '010111', '110', '101001']",1,7,13,21,4,34,12.768215118215117,60,62
"['011101', '00110', '1001', '01011']",1,4,9,11,2,20,3.806060606060606,14,12
"['010000', '010010', '0100']",1,3,12,4,2,16,2.4333333333333336,5,22
"['1000100', '00101', '11', '101', '1000110', '11000', '10000', '011101', '0100']",1,9,25,19,5,44,21.915379065379064,108,105
"['110000', '1101001', '1101011', '0100', '00', '11101', '1001100', '111001']",1,8,21,23,5,44,17.17724497724498,83,90
"['0001110', '111010', '11', '01001', '1110']",1,5,10,14,0,24,5.981762681762682,33,30
"['0', '001', '111001']",1,3,5,5,0,10,1.4523809523809523,10,6
"['010', '001', '1', '0000011']",1,4,9,5,2,14,2.9166666666666665,21,11
"['0100000', '001', '111', '10100', '0011011', '1110']",1,6,15,14,4,29,7.224963924963925,54,42
"['0', '010100', '0100010', '1101101', '01111', '0001101', '1011000']",1,7,21,19,4,40,11.113220113220112,80,55
"['10111', '00010', '1001011']",1,3,8,9,2,17,1.7333333333333334,8,6
"['1111100', '1100100', '01100', '0']",1,4,10,10,2,20,2.738095238095238,24,22
"['011110', '111', '01100', '0']",1,4,6,9,0,15,2.512987012987013,20,14
"['0001', '11110', '010', '1100']",1,4,8,8,2,16,3.0317460317460316,16,15
"['1011', '10100', '10011', '111001']",1,4,8,12,2,20,4.21010101010101,14,26
"['1101000', '100111', '001011', '1101011']",1,4,11,15,4,26,4.009157509157509,16,30
"['0', '111', '00101', '010101', '10010', '1100110']",1,6,13,14,2,27,7.657159507159507,51,34
"['1011010', '01101', '00101', '111011', '10']",1,5,10,15,2,25,6.108746808746809,28,24
"['00', '011', '0100']",1,3,6,3,0,9,1.638095238095238,6,11
"['110011', '1100', '111']",1,3,4,9,0,13,2.038095238095238,7,18
"['110011', '1010', '0001110', '11010']",1,4,10,12,0,22,3.695182595182595,18,18
"['001', '011', '10111', '1111110', '000001']",1,5,10,14,2,24,4.645260295260295,37,27
"['101', '00000', '11']",1,3,6,4,0,10,1.05,10,4
"['0110101', '011', '111110', '010111', '001001', '110', '0101001']",1,7,16,22,7,38,12.403296703296704,66,66
"['0001100', '1011', '111', '110101']",1,4,8,12,0,20,3.598934398934399,19,17
"['01', '001001', '00111', '0001', '1000111', '1111', '100111', '0000', '1011011', '110']",1,10,22,26,7,48,24.616294816294815,137,149
"['01', '0111101', '10']",1,3,4,7,2,11,1.3888888888888888,12,8
"['10111', '110', '00001']",1,3,6,7,2,13,1.15,10,7
"['11011', '01101', '11']",1,3,3,9,2,12,1.9428571428571428,8,12
"['1101111', '01010', '11']",1,3,4,10,0,14,1.5158730158730158,12,8
"['1011', '0010010', '11']",1,3,6,7,0,13,1.6565656565656566,11,6
"['0', '11010', '1011001', '10101', '0100100']",1,5,13,12,4,25,5.347619047619047,37,19
"['0011011', '00', '10']",1,3,6,5,2,11,1.3888888888888888,11,8
"['11011', '101', '101000', '0000011', '11111']",1,5,11,15,2,26,5.320629370629371,34,39
"['1', '011', '0010101']",1,3,5,6,0,11,1.35,12,6
"['010', '0100110', '1010', '000', '111000']",1,5,14,9,2,23,6.167188367188367,29,36
"['01', '001101', '001001', '0011001', '1000', '000100']",1,6,20,11,3,31,9.571950271950271,43,58
"['000110', '001', '111', '101', '000']",1,5,10,8,4,18,4.888888888888888,24,24
"['001', '0110100', '1001', '000101', '0111111', '000']",1,6,16,14,4,30,7.986013986013986,51,45
"['1101111', '1000110', '10001', '10100', '1101']",1,5,12,16,4,28,5.967965367965368,29,37
"['011011', '001', '1']",1,3,4,6,0,10,1.2301587301587302,10,6
"['0010', '11010', '11']",1,3,5,6,0,11,1.5714285714285714,8,8
"['101100', '1101', '100', '10']",1,4,7,8,0,15,3.8047619047619046,15,17
"['101', '001', '0001000']",1,3,9,4,2,13,1.6666666666666665,10,7
"['1101', '1100000', '1', '001111']",1,4,8,10,0,18,2.388861138861139,27,19
"['0', '110001', '1011001']",1,3,7,7,0,14,1.304945054945055,13,6
"['010', '00011', '00001', '000', '0000110']",1,5,17,6,4,23,6.833333333333333,24,47
"['1001111', '0101011', '0000010', '10']",1,4,12,11,3,23,2.9047619047619047,25,13
"['01', '001110', '010110', '01100']",1,4,10,9,2,19,3.8593073593073592,17,24
"['00', '110010', '10', '01000']",1,4,10,5,2,15,3.37012987012987,17,17
"['11110', '101', '1011101', '100111', '010110', '01110', '011001', '000', '11100', '101001']",1,10,22,30,9,52,28.363286713286712,125,121
"['110000', '101', '001', '1']",1,4,7,6,2,13,2.841269841269841,18,16
"['0010', '00011', '101', '1001', '010011', '000101', '1111', '0000', '1101', '0110001']",1,10,25,22,7,47,26.89211899211899,113,130
"['110000', '1', '10111', '101011', '10110', '001110', '0100100']",1,7,17,19,5,36,11.058658008658009,72,53
"['0000100', '001000', '0101011', '0010101', '0100', '10', '010011', '101111', '0111100']",1,9,29,23,7,52,21.794927294927295,116,117
"['00', '10011', '1111']",1,3,4,7,0,11,1.0158730158730158,9,6
"['0001011', '01', '10']",1,3,6,5,2,11,1.3888888888888888,12,6
"['01', '001', '0111011', '11', '10011']",1,5,7,12,2,19,5.381746031746031,29,30
"['0', '01101', '101101', '0101', '0110110', '1110']",1,6,11,16,2,27,8.908985458985459,43,44
"['011011', '01010', '01110']",1,3,7,9,2,16,2.254545454545455,5,13
"['10111', '100', '00', '010101', '0100011']",1,5,12,11,0,23,5.95999555999556,31,24
"['010', '1', '00100', '10111', '000']",1,5,10,7,4,17,4.483333333333333,28,20
"['0', '001', '00101', '0101011', '1110101']",1,5,11,12,2,23,4.930952380952381,36,26
"['010', '11101', '0101001', '1011', '110', '0110110']",1,6,12,17,4,29,9.261688311688312,43,38
"['0011', '1000', '00101']",1,3,8,5,2,13,1.8333333333333333,7,10
"['00', '1', '1110', '011000']",1,4,7,6,0,13,2.119047619047619,20,12
"['001', '111', '1101110', '10', '011110']",1,5,7,14,2,21,4.958119658119658,33,25
"['11011', '010', '101', '0001', '111111', '1000', '0100011', '000100', '0000110', '1110']",1,10,25,24,9,49,24.096320346320347,147,124
"['00111', '100100', '1', '0101100']",1,4,10,9,0,19,2.5427072927072927,23,14
"['011011', '001', '110', '0100']",1,4,8,8,2,16,3.187301587301587,16,15
"['0001001', '100', '01000']",1,3,11,4,0,15,2.0166666666666666,9,10
"['10111', '00', '0110', '1101110']",1,4,7,11,0,18,3.624098124098124,18,13
"['1101', '010110', '0101100']",1,3,8,9,0,17,2.0685314685314684,8,9
"['01', '1111001', '11111']",1,3,3,11,0,14,1.5634920634920635,11,15
"['01', '110111', '101101']",1,3,4,10,2,14,1.6666666666666665,10,9
"['011100', '00011', '101', '110011', '00', '110']",1,6,12,13,4,25,8.421933621933622,47,39
"['1', '100100', '1100000', '0110', '0100']",1,5,14,8,2,22,5.145854145854146,34,24
"['0011', '11011', '10']",1,3,4,7,0,11,1.5714285714285714,8,9
"['011011', '01', '111010']",1,3,5,9,2,14,1.6666666666666665,10,8
"['0010001', '000000', '1011', '1110110', '0100101']",1,5,18,13,3,31,4.963236763236763,36,22
"['0100111', '11', '10110', '00', '11101']",1,5,8,13,4,21,4.655555555555555,34,24
"['11001', '1', '01100']",1,3,5,6,2,11,1.4666666666666668,10,4
"['101', '1101', '01110']",1,3,4,8,0,12,2.0238095238095237,7,6
"['111010', '111', '111011', '10', '1101', '101001']",1,6,8,19,3,27,9.790476190476191,38,65
"['01', '100010', '1110101', '111111', '10', '111001']",1,6,10,19,5,29,7.863247863247863,53,52
"['0', '00010', '10110']",1,3,7,4,2,11,1.2666666666666666,10,9
"['1', '0001101', '110011', '001010', '0000', '010011']",1,6,17,13,3,30,7.754928404928405,55,38
"['0010', '1', '101', '1000', '0100001', '001001']",1,6,16,9,2,25,8.437196137196137,46,38
"['101011', '1001', '1000', '00', '10010', '0111101', '1100']",1,7,16,16,3,32,13.353674103674104,57,57
"['00001', '101010', '0110', '0000001', '1111', '001010', '100111']",1,7,21,17,5,38,10.797435897435898,64,58
"['1010', '11101', '1001']",1,3,5,8,2,13,2.083333333333333,6,10
"['0001110', '0010000', '0010011', '0111101', '110']",1,5,17,14,4,31,5.571428571428571,38,34
"['100011', '0100110', '0110100']",1,3,11,9,2,20,1.8021978021978022,10,5
"['0001', '00', '110']",1,3,6,3,0,9,1.3523809523809525,7,8
"['00111', '00', '0111', '1010011']",1,4,8,10,0,18,3.45021645021645,18,17
"['011', '001011', '0111100', '0100']",1,4,10,10,0,20,3.6269064269064266,19,24
"['10101', '0110001', '11']",1,3,6,8,0,14,1.6825396825396823,11,9
"['100', '010', '1', '0000']",1,4,8,3,2,11,2.8095238095238093,14,12
"['11001', '0111000', '01', '001111', '1101000', '0000000', '1011100']",1,7,23,18,4,41,10.780497280497281,81,66
"['11010', '010', '011', '100100', '111111', '0101100', '000']",1,7,16,17,5,33,10.503069153069152,67,59
"['010', '011', '10101', '0110000', '0111', '000100']",1,6,16,12,2,28,9.17930957930958,43,43
"['0', '100100', '101110']",1,3,7,6,2,13,1.2380952380952381,12,7
"['0011001', '110100', '0111', '0101', '0100']",1,5,13,12,3,25,6.7972027972027975,26,31
"['0001', '1', '100010']",1,3,7,4,0,11,1.4857142857142858,10,6
"['0001', '11100', '101101']",1,3,7,8,0,15,1.5717171717171716,9,8
"['000110', '01', '011', '00010', '01100']",1,5,13,8,2,21,6.395887445887446,26,36
"['10100', '001', '100', '00011']",1,4,10,6,4,16,3.5666666666666664,16,20
"['0', '100', '11']",1,3,3,3,0,6,0.9,6,4
"['1', '1100001', '1001', '1100100', '001010', '1011']",1,6,15,14,4,29,7.805444555444556,53,43
"['0', '1101100', '1000', '110111', '0001011']",1,5,12,13,2,25,4.632667332667332,41,30
"['0101', '1100', '111', '1110']",1,4,5,10,3,15,3.75,11,19
"['01', '001', '001111', '1000011', '001100', '0100']",1,6,16,12,2,28,9.058763458763458,48,45
"['0', '1010', '10011', '11111', '111001']",1,5,7,14,2,21,4.584704184704185,32,28
"['011011', '101000', '0001111', '11101', '10', '1100110']",1,6,14,19,4,33,8.53096903096903,56,41
"['0010', '011', '111', '00110', '000001', '000']",1,6,15,9,3,24,8.081962481962481,38,45
"['00011', '11', '10001', '00110', '001001', '1001111', '1110']",1,7,16,18,3,34,12.823609723609723,62,62
"['00101', '101', '1100100', '11101', '10', '0000']",1,6,14,12,2,26,8.655844155844155,43,41
"['1000100', '0100111', '101000', '01010', '1011']",1,5,16,13,2,29,6.4021978021978025,30,26
"['11000', '00', '100111', '0110111']",1,4,9,11,0,20,3.3305583305583304,22,17
"['001', '10001', '00', '010101', '001011']",1,5,13,9,2,22,6.338600288600288,27,28
"['100101', '00', '1', '10101']",1,4,7,7,0,14,2.5995670995670994,19,16
"['001', '01011', '11']",1,3,4,6,0,10,1.4714285714285715,7,8
"['110010', '11011', '11', '100', '10']",1,5,7,11,2,18,5.736796536796537,26,33
"['0101101', '100', '0100']",1,3,8,6,0,14,2.1844155844155844,8,10
"['01', '0010010', '011000', '0010011']",1,4,14,8,2,22,3.476800976800977,20,22
"['1111101', '0110', '10', '0111', '110']",1,5,6,14,2,20,6.113924963924964,27,28
"['0101010', '01', '100', '100110']",1,4,10,8,0,18,3.2264957264957266,21,16
"['0010', '101', '0011', '1000', '1010', '10010']",1,6,14,10,4,24,10.654761904761905,24,47
"['010100', '110010', '1011001', '11', '10101', '100', '000000', '0000111', '01011']",1,9,26,21,7,47,19.67011322011322,122,99
"['1111100', '1001011', '00000']",1,3,10,9,2,19,1.2619047619047619,14,7
"['11001', '110000', '001', '011', '1010001']",1,5,13,11,2,24,6.335392385392385,29,34
"['010', '111', '0011', '01111', '0000011']",1,5,10,12,2,22,5.42012987012987,30,33
"['1000', '100', '1001', '1111']",1,4,7,8,3,15,3.5,11,21
"['0', '1001', '011']",1,3,4,4,0,8,1.4714285714285715,7,4
"['0011', '0001110', '000111', '01111']",1,4,10,12,0,22,4.510955710955711,13,23
"['111111', '1000000', '01', '01010']",1,4,10,10,0,20,2.061133311133311,28,11
"['0101110', '11', '110111', '10', '0000']",1,5,9,12,2,21,4.236907536907537,37,21
"['110011', '101', '000']",1,3,6,6,2,12,1.4444444444444444,9,4
"['1111000', '001001', '110111', '0111']",1,4,9,14,2,23,3.3685314685314687,21,22
"['101', '00', '110', '010110']",1,4,7,7,2,14,3.3,16,12
"['01', '111111', '10010', '000001']",1,4,9,10,2,19,2.3971861471861473,24,13
"['010', '0101', '00']",1,3,6,3,0,9,2.3238095238095235,4,10
"['0', '110010', '0100110', '00001', '000101', '010010', '1010001']",1,7,24,14,5,38,12.6996336996337,66,59
"['101010', '100', '11']",1,3,5,6,0,11,1.5666666666666667,9,7
"['11001', '111', '101011', '110011', '10100', '100000', '10', '1101', '000100']",1,9,21,22,6,43,20.852020202020203,102,124
"['010100', '0010', '1010010']",1,3,11,6,0,17,2.0965034965034963,8,12
"['01', '00', '0001000', '0100101']",1,4,13,5,4,18,2.992063492063492,24,20
"['11110', '001', '1110']",1,3,4,8,0,12,1.4246031746031744,8,11
"['110', '1100', '1']",1,3,3,5,0,8,1.7571428571428571,6,8
"['0100000', '0011110', '0110100']",1,3,13,8,3,21,1.7142857142857142,10,16
"['1', '111100', '000010']",1,3,7,6,2,13,0.9047619047619047,15,5
"['11001', '00', '0000110', '0011100', '011000']",1,5,17,10,2,27,5.9531579531579535,36,38
"['11000', '1101', '1100', '1']",1,4,6,8,2,14,3.4388888888888887,14,22
"['1111101', '011', '111', '101', '1100110']",1,5,6,17,5,23,5.9714285714285715,32,39
"['00', '01111', '11']",1,3,3,6,2,9,0.8571428571428571,9,6
"['010', '0110100', '11', '100', '10000', '01100']",1,6,15,10,4,25,8.651587301587302,43,46
"['1', '011011', '0001100', '0011011', '01110']",1,5,12,14,2,26,5.432400932400933,37,27
"['11', '1001', '011110', '000010', '01011']",1,5,11,12,2,23,5.245670995670995,31,20
"['0010001', '11010', '011', '11', '00011', '0011', '10000']",1,7,17,14,3,31,12.235209235209235,60,68
"['0110101', '1100001', '0011110', '10', '01010', '01001', '1110']",1,7,18,19,5,37,12.34040404040404,70,57
"['0011100', '1101000', '100011', '01010', '1011', '0101', '11100', '111101']",1,8,20,24,8,44,17.306199356199357,85,78
"['1100', '011', '10']",1,3,4,5,0,9,1.638095238095238,7,7
"['00111', '001', '10']",1,3,5,5,0,10,1.4357142857142857,8,8
"['101', '1001', '100', '10110', '0000']",1,5,11,8,4,19,6.349206349206349,19,29
"['110010', '111', '11000', '0001', '10011', '1101']",1,6,12,15,4,27,9.612554112554113,34,57
"['110000', '01', '10']",1,3,6,4,2,10,1.25,11,6
"['01001', '111110', '1']",1,3,4,8,0,12,0.9826839826839826,13,6
"['0111000', '0110111', '011', '111', '0001', '100', '100110']",1,7,15,18,5,33,11.25097125097125,69,59
"['010', '0011101', '0100100']",1,3,10,7,2,17,1.7714285714285714,12,11
"['111', '00001', '00100', '000', '1101', '001001']",1,6,16,10,4,26,7.797402597402597,39,50
"['110010', '010', '011', '1111', '00110', '0111100']",1,6,12,16,2,28,8.934143634143634,44,44
"['11', '11011', '001000', '1011111']",1,4,7,13,0,20,2.6038683538683536,25,20
"['101000', '110', '1']",1,3,5,5,0,10,1.2301587301587302,10,6
"['1010111', '11110', '00', '11']",1,4,5,11,2,16,2.246031746031746,22,16
"['0', '1010', '111001']",1,3,5,6,0,11,1.2857142857142856,11,4
"['0100111', '11', '0100100', '1100011', '0000111']",1,5,15,15,4,30,5.920634920634921,35,39
"['0100000', '010', '101111']",1,3,9,7,0,16,1.3521367521367522,13,6
"['0011000', '001010', '10011', '011110', '0101']",1,5,15,13,2,28,6.602797202797203,30,25
"['1001', '011', '000010', '0100']",1,4,11,6,2,17,3.537301587301587,16,12
"['0', '100110', '110']",1,3,5,5,0,10,1.4523809523809523,10,8
"['101011', '000101', '0110', '0101', '01110']",1,5,12,13,4,25,6.863131313131313,24,27
"['00010', '0100110', '10110']",1,3,10,7,2,17,2.2666666666666666,6,13
"['1011', '100', '10110', '0101100']",1,4,9,10,0,19,4.370923520923521,14,17
"['011111', '010', '011010', '1101']",1,4,7,12,2,19,3.549206349206349,16,17
"['0011', '01', '00001']",1,3,7,4,0,11,1.9047619047619047,7,8
"['001101', '100', '10000', '1000', '100101', '10011']",1,6,17,12,4,29,10.766233766233766,35,63
"['1', '0001110', '1100101', '0100001', '110']",1,5,13,12,3,25,4.707142857142857,43,23
"['010', '1000', '110111', '1011000', '0101']",1,5,12,12,2,24,5.8611277611277615,32,24
"['0100001', '010', '110', '0001000']",1,4,14,6,4,20,3.380952380952381,22,17
"['1', '1110', '0111100']",1,3,4,8,0,12,1.3772727272727274,12,4
"['11010', '0011', '00', '1110', '0100']",1,5,10,9,3,19,5.515873015873016,24,31
"['10011', '10', '0111']",1,3,4,7,0,11,1.5714285714285714,8,8
"['001100', '000111', '100', '10000']",1,4,13,7,2,20,3.6186868686868685,19,25
"['010', '100001', '101', '00', '10011', '01110', '0100011', '111101']",1,8,18,19,6,37,16.00008325008325,87,68
"['001100', '10010', '1111111']",1,3,7,11,0,18,1.3682983682983683,13,4
"['001', '1000101', '1', '10110', '1110101']",1,5,10,13,2,23,4.714285714285714,37,32
"['1110111', '0011011', '1000110', '01011']",1,4,10,16,3,26,4.166666666666667,18,19
"['1000100', '11011', '10', '0001011', '1101']",1,5,12,13,2,25,5.987734487734487,34,33
"['110010', '0010', '010', '1010', '1110']",1,5,11,10,3,21,6.902380952380952,17,40
"['01', '111', '00110', '000001', '1011', '1100']",1,6,12,12,2,24,7.515295815295815,44,37
"['001111', '00000', '0001', '100', '01111', '10100', '0100100']",1,7,21,14,3,35,10.92993672993673,65,76
"['1001100', '01100', '1100011', '0111']",1,4,11,12,2,23,3.9718614718614718,20,18
"['1100', '100011', '110111']",1,3,6,10,2,16,1.8666666666666667,8,14
"['0001001', '001', '10111', '101011', '000', '1101']",1,6,14,14,2,28,7.835658785658786,44,46
"['1101001', '00', '0100110']",1,3,9,7,2,16,1.6031746031746033,14,4
"['11110', '11011', '101', '10000', '110111', '000001', '01100', '0100']",1,8,19,20,6,39,14.71031746031746,81,76
"['0101101', '0100011', '001', '1']",1,4,9,9,2,18,2.7142857142857144,25,15
"['01100', '1', '011100', '01110']",1,4,8,9,2,17,3.5705627705627707,16,23
"['1110101', '01', '0010', '0000']",1,4,10,7,2,17,3.1035353535353534,20,13
"['110000', '0', '0111001', '1010100', '0101']",1,5,14,11,2,25,4.985314685314686,38,23
"['10111', '1011101', '1111', '110011', '00', '100111', '01011']",1,7,11,24,4,35,13.14882894882895,57,84
"['11000', '10010', '1']",1,3,6,5,2,11,1.4666666666666668,10,6
"['1001', '100010', '00', '01010', '1101', '0100']",1,6,15,10,3,25,9.505772005772005,35,35
"['00001', '11001', '000', '1110']",1,4,10,7,2,17,3.0246031746031745,16,17
"['00011', '011011', '0110', '1111000', '01000']",1,5,14,13,2,27,5.997902097902098,32,38
"['0010', '001', '11', '110011', '10100', '010111']",1,6,12,14,2,26,8.579076479076479,42,40
"['010100', '1111101', '00101', '0101011', '1111']",1,5,11,18,2,29,5.488633588633589,31,34
"['010', '00111', '101', '0110', '0101011', '1101110', '000']",1,7,15,17,5,32,12.553679653679653,61,55
"['01', '111010', '10101', '1111001', '00', '001100', '111000']",1,7,16,18,5,34,12.087107337107337,68,56
"['101', '0011', '00001']",1,3,7,5,0,12,1.7380952380952381,7,8
"['1010', '01', '111']",1,3,3,6,0,9,1.638095238095238,6,6
"['1010', '000', '101110', '0101001', '110101']",1,5,13,13,2,26,6.085026085026085,30,22
"['011', '1111', '1000', '10010', '1100101']",1,5,10,13,2,23,5.828354978354978,27,29
"['0', '0101', '1100011']",1,3,6,6,0,12,1.1954545454545453,13,4
"['11110', '1', '1011001', '101000', '10010']",1,5,11,13,2,24,4.795854145854146,34,27
"['1101111', '010010', '0100101']",1,3,9,11,2,20,1.9560439560439562,8,9
"['01111', '100', '110', '00000']",1,4,9,7,4,16,2.3666666666666667,19,15
"['01', '010011', '01111', '010']",1,4,7,9,0,16,3.5835497835497834,16,20
"['1010', '10001', '00101', '0011010']",1,4,12,9,2,21,3.993939393939394,15,17
"['1011', '10101', '0001', '000']",1,4,9,7,2,16,3.4761904761904763,12,17
"['01001', '110', '10011']",1,3,6,7,2,13,1.8,8,7
"['11001', '1011001', '000']",1,3,8,7,0,15,1.7333333333333334,9,8
"['010', '0101000', '101', '1101', '111101']",1,5,10,13,2,23,6.213342213342213,30,26
"['0', '001', '010101', '11101', '1100111', '001011']",1,6,12,16,2,28,7.674730824730824,51,40
"['001', '1', '0000']",1,3,6,2,0,8,1.0714285714285714,8,6
"['0001001', '110010', '11', '00010', '1100', '1110']",1,6,15,13,2,28,8.687462537462537,45,50
"['0011', '10101', '1010111', '10', '1001100']",1,5,11,14,2,25,6.129148629148629,32,33
"['100110', '00', '010']",1,3,7,4,0,11,1.7444444444444445,8,9
"['010011', '00', '01100']",1,3,8,5,0,13,1.7987012987012987,10,11
"['0001', '001110', '1', '1101']",1,4,7,8,2,15,2.7857142857142856,20,12
"['10', '01011', '111']",1,3,3,7,0,10,1.4714285714285715,7,8
"['00', '1', '011110']",1,3,4,5,0,9,0.7857142857142857,11,4
"['001110', '1111101', '100010']",1,3,8,11,2,19,1.7435897435897436,10,5
"['0001100', '001101', '11']",1,3,8,7,0,15,1.7136752136752138,11,6
"['0', '00100', '110001']",1,3,8,4,0,12,1.1645021645021645,13,4
"['000100', '0110', '00101', '1111011']",1,4,11,11,0,22,3.347086247086247,20,12
"['1011', '01', '1010001']",1,3,6,7,0,13,1.8383838383838382,10,11
"['0111010', '1011001', '011100']",1,3,9,11,2,20,2.406593406593407,7,8
"['00100', '1001000', '100101', '0100011', '01000']",1,5,20,10,4,30,7.6739593739593746,26,34
"['010', '1100', '11']",1,3,4,5,0,9,1.638095238095238,6,6
"['001', '00101', '00011', '11', '110']",1,5,9,9,4,18,5.976190476190476,25,30
"['1100010', '0101', '010110']",1,3,9,8,0,17,1.806993006993007,9,10
"['001100', '0101011', '01011']",1,3,9,9,0,18,2.175990675990676,9,13
"['0000', '101', '011', '011000']",1,4,10,6,2,16,2.949206349206349,17,16
"['0110101', '10', '0100']",1,3,7,6,0,13,1.6565656565656566,10,7
"['0011', '00110', '1']",1,3,5,5,0,10,1.6222222222222222,8,7
"['011', '110011', '11111', '1100', '0100']",1,5,8,14,2,22,5.853463203463203,26,37
"['0010110', '010', '100']",1,3,8,5,2,13,1.6666666666666665,10,10
"['011100', '1101101', '110111', '000', '1001100', '0000110']",1,6,18,18,5,36,8.77948717948718,51,44
"['010000', '1', '0000']",1,3,9,2,0,11,1.0857142857142859,11,10
"['11110', '11011', '1101110', '00', '00010']",1,5,10,14,3,24,4.987301587301587,32,33
"['1111000', '011101', '1111010', '01010', '110']",1,5,11,17,2,28,6.5023643023643025,28,32
"['110010', '001', '011', '00011', '010101', '11111', '110', '101111']",1,8,14,23,8,37,15.326767676767677,82,88
"['1000110', '11100', '10', '000000']",1,4,13,7,0,20,2.744893994893995,24,16
"['001', '0000100', '11', '0001', '1011011']",1,5,13,10,2,23,4.776623376623377,37,28
"['101', '0111', '0100']",1,3,5,6,2,11,1.6428571428571428,6,5
"['01', '1110000', '1111']",1,3,5,8,0,13,1.101010101010101,13,10
"['0010001', '001', '0011', '0101011', '000010']",1,5,17,10,2,27,6.3695637695637695,30,33
"['11001', '011', '111111', '10010', '0101', '01110']",1,6,10,18,3,28,8.706132756132757,42,39
"['1', '0000011', '000000']",1,3,11,3,0,14,1.0192307692307692,14,12
"['1110101', '101', '1']",1,3,3,8,0,11,1.35,12,14
"['00101', '000011', '011011', '111011', '00']",1,5,12,13,3,25,5.654761904761905,29,33
"['0011001', '110001', '100010', '001110', '10011', '011010', '101110']",1,7,21,21,5,42,14.65967365967366,58,58
"['001', '101', '0001', '10101', '11101', '1101']",1,6,10,14,6,24,9.568253968253968,26,69
"['001', '111', '101', '01010', '1011']",1,5,7,11,3,18,6.083333333333333,17,25
"['11011', '001', '111010', '000', '01011']",1,5,10,12,4,22,5.3782828282828286,27,27
"['00', '0111111', '10011', '1011', '1100']",1,5,8,14,2,22,5.258297258297258,34,28
"['010100', '110001', '1100100', '111110', '1100111', '01001']",1,6,17,20,5,37,9.211954711954712,42,52
"['0', '01111', '0110']",1,3,4,6,0,10,1.4,9,10
"['110', '100011', '11']",1,3,4,7,0,11,1.7444444444444445,9,13
"['1000', '110', '011']",1,3,5,5,2,10,1.5238095238095237,7,7
"['0100000', '001', '11', '0001', '10010', '000000']",1,6,20,7,0,27,7.605377955377955,48,48
"['0', '000110', '001', '01111', '10011']",1,5,10,10,2,20,5.241774891774892,31,20
"['0101', '1', '0100']",1,3,5,4,2,9,1.55,7,6
"['11111', '111000', '01000', '00011']",1,4,10,11,3,21,3.018181818181818,20,24
"['110', '0101011', '0000', '1010010', '1100', '01011', '011000']",1,7,20,16,4,36,12.252558552558552,61,67
"['11100', '1', '001100']",1,3,6,6,0,12,1.3463203463203464,11,8
"['0', '0011011', '1000', '0110010']",1,4,11,8,2,19,2.8870129870129873,26,15
"['010', '1', '0000010']",1,3,8,3,0,11,1.35,12,6
"['110000', '111', '00000', '101', '01010', '01110']",1,6,15,12,5,27,7.9237373737373735,43,36
"['011111', '1101', '1001', '010000']",1,4,9,11,4,20,2.8833333333333333,19,13
"['100', '0100', '010101', '1011000', '011000']",1,5,16,10,2,26,7.322877122877123,26,38
"['0111011', '1001010', '11', '000010', '111000']",1,5,14,14,4,28,5.018009768009768,39,27
"['100', '1000', '00', '010101', '0000111', '1011']",1,6,15,11,2,26,8.845976245976246,44,43
"['01', '1110000', '011', '00', '110', '1101010']",1,6,12,12,6,24,7.636507936507936,51,41
"['0101010', '101111', '11']",1,3,5,10,0,15,1.5598290598290598,12,6
"['101', '0101110', '0110', '0100']",1,4,9,9,2,18,3.9474025974025975,16,18
"['0', '0001', '110010']",1,3,7,4,0,11,1.2857142857142856,11,6
"['10100', '010001', '0100', '1001101']",1,4,13,9,0,22,4.230846930846931,16,18
"['001', '10101', '1001', '0111', '110']",1,5,8,11,4,19,5.9603174603174605,20,28
"['11001', '1110000', '10001', '010010', '0001011', '01001', '000100']",1,7,25,16,7,41,14.283782883782884,60,62
"['0', '110111', '0011', '111010']",1,4,6,11,2,17,2.638095238095238,23,16
"['101100', '1', '1111001', '1100100', '01011']",1,5,11,15,2,26,4.778554778554779,39,27
"['1101001', '101', '100011', '10011']",1,4,9,12,0,21,4.207808857808858,16,34
"['01111', '001111', '01010']",1,3,6,10,2,16,2.0545454545454547,6,11
"['1110101', '1000100', '101110', '011101']",1,4,11,15,4,26,3.8663003663003663,17,15
"['101100', '111010', '10001', '100', '01111', '0110']",1,6,13,16,4,29,8.846176046176046,43,39
"['1000', '0011101', '1001111']",1,3,8,10,2,18,1.7662337662337662,11,9
"['1110010', '00000', '0001', '1010', '1001001', '101001', '0111100']",1,7,23,17,5,40,12.694128094128095,65,60
"['00', '010', '110']",1,3,5,3,2,8,1.8666666666666667,4,9
"['0100000', '11010', '0010111', '1100010', '10000', '001110', '000000', '1010011', '1011']",1,9,32,22,8,54,20.392562992562993,118,115
"['01110', '0100101', '00000']",1,3,11,6,2,17,1.5666666666666667,9,9
"['0', '10110', '000011']",1,3,7,5,0,12,1.1645021645021645,13,6
"['0011', '01', '0000010']",1,3,9,4,0,13,1.6565656565656566,11,7
"['101110', '1', '1111000', '01100']",1,4,8,11,0,19,3.0322177822177823,23,11
"['000110', '010000', '110100']",1,3,12,6,3,18,1.8333333333333333,8,12
"['001', '00000', '011011', '100', '01001', '110', '1110']",1,7,16,13,5,29,10.944083694083695,57,55
"['1010111', '0111001', '11101', '111010']",1,4,8,17,2,25,4.198468198468198,16,23
"['0011101', '010', '0101101', '100', '0011010', '11111', '0101']",1,7,16,20,5,36,12.859595959595959,66,61
"['011', '1101000', '1001', '10110', '000', '111001']",1,6,14,14,2,28,8.469857919857919,44,39
"['101000', '01101', '11111']",1,3,6,10,2,16,1.509090909090909,9,6
"['111010', '10010', '10', '011100']",1,4,9,10,2,19,3.6774891774891776,19,17
"['11011', '010', '0110100', '1100001', '100', '1100']",1,6,15,14,4,29,9.464069264069265,45,42
"['00100', '10100', '00010', '11000']",1,4,14,6,4,20,4.2,14,26
"['10', '011', '01000']",1,3,6,4,0,10,1.4714285714285715,8,7
"['101', '01', '1111110', '01110']",1,4,5,12,0,17,3.16031746031746,21,15
"['110011', '101011', '1000', '1100100']",1,4,11,12,2,23,4.145221445221445,17,25
"['0011001', '00', '000001', '01100', '110101']",1,5,16,10,2,26,5.5042180042180044,32,31
"['101', '11100', '1110']",1,3,4,8,0,12,1.9603174603174602,6,9
"['110', '1001101', '11']",1,3,4,8,0,12,1.8444444444444446,10,10
"['0111', '0101100', '11111']",1,3,5,11,0,16,1.5454545454545454,9,9
"['0', '1101', '111010']",1,3,4,7,0,11,1.4857142857142858,10,5
"['01', '0010010', '11111', '1101', '000111', '110', '01011', '0001000']",1,8,19,20,4,39,14.502197802197802,95,80
"['1001001', '111100', '110', '11']",1,4,7,11,0,18,3.2726495726495726,20,19
"['1000100', '00', '010000']",1,3,12,3,0,15,1.7136752136752138,12,13
"['01', '010', '0101100']",1,3,7,5,0,12,1.8444444444444446,10,12
"['0111001', '1110010', '101', '1111', '10']",1,5,8,15,2,23,5.905339105339105,32,29
"['10111', '11110', '0011', '1100']",1,4,6,12,4,18,3.322222222222222,16,20
"['1100000', '0101011', '1010', '00110', '1000', '001011']",1,6,19,14,4,33,8.816988566988567,46,46
"['10111', '01', '1001001']",1,3,6,8,0,14,1.6825396825396823,11,10
"['01', '111', '10011', '00011']",1,4,6,9,2,15,3.342857142857143,14,21
"['000110', '00', '100011', '1110']",1,4,10,8,2,18,3.1666666666666665,20,15
"['01', '111', '101010', '000001', '11100', '0100']",1,6,14,12,2,26,7.386075036075036,46,38
"['1110011', '0101', '0110']",1,3,6,9,2,15,1.8409090909090908,10,5
"['10111', '01', '1110']",1,3,3,8,0,11,1.5714285714285714,8,8
"['0', '0010', '0011000']",1,3,9,3,0,12,1.3772727272727274,12,15
"['1010110', '001101', '10111', '101', '0001', '11111', '0010010', '0100101']",1,8,20,24,5,44,16.49059274059274,82,80
"['000110', '011', '11000', '10101', '10100', '0010010', '010011', '001011', '1111111']",1,9,24,26,8,50,21.057392607392607,115,103
"['11110', '0010', '1111000']",1,3,7,9,0,16,1.823232323232323,10,12
"['001', '1', '000', '0001010', '01100']",1,5,13,6,2,19,4.283333333333333,32,31
"['01', '111010', '1000', '000', '0101001']",1,5,13,9,0,22,5.14020424020424,33,26
"['101', '0010', '10011', '110101']",1,4,8,10,0,18,3.982034632034632,14,16
"['1110111', '11110', '1000101', '10', '0000', '0100']",1,6,14,15,4,29,7.016594516594516,54,34
"['0', '0010110', '100']",1,3,7,4,0,11,1.15,12,9
"['0111000', '0001001', '001', '111010', '0010100', '10100']",1,6,21,14,3,35,9.284537684537685,48,53
"['01', '110010', '00011']",1,3,7,6,0,13,1.6168831168831168,10,7
"['01', '001', '011']",1,3,4,4,2,8,2.2666666666666666,3,8
"['101', '100', '1101100']",1,3,6,7,2,13,1.8666666666666667,9,9
"['0', '0010111', '110111', '01110']",1,4,7,12,0,19,3.0322177822177823,23,15
"['0010', '1011001', '11', '11000', '101', '10100', '111110', '1100']",1,8,16,20,4,36,17.032917082917084,78,82
"['10001', '1001', '01011']",1,3,7,7,2,14,2.1555555555555554,6,12
"['011011', '01', '00', '0010001']",1,4,10,7,2,17,3.0042735042735043,22,16
"['001110', '100001', '110101']",1,3,9,9,3,18,1.6666666666666665,10,5
"['0000', '101', '0001111', '001100']",1,4,12,8,0,20,3.0909978909978912,21,20
"['0101', '010000', '001111', '0010100']",1,4,14,9,2,23,3.4913752913752916,19,22
"['110000', '0001', '00', '10001']",1,4,12,5,0,17,3.954256854256854,15,19
"['000111', '0111', '011010']",1,3,7,9,2,16,2.2666666666666666,8,11
"['111100', '1110000', '111', '10010', '0001010']",1,5,14,14,2,28,5.847652347652348,35,34
"['1011010', '0010000', '00011', '00000', '11', '011000']",1,6,21,11,4,32,7.705561105561105,52,56
"['01101', '011100', '11', '00', '0100100', '111001']",1,6,14,14,4,28,8.217060717060717,49,39
"['011011', '00', '10010']",1,3,7,6,0,13,1.6168831168831168,10,6
"['00010', '100000', '00001']",1,3,13,3,2,16,2.254545454545455,6,13
"['1000001', '1010001', '000001', '111001']",1,4,16,10,4,26,4.291208791208791,12,36
"['011111', '00110', '10011']",1,3,6,10,2,16,1.8909090909090909,8,5
"['0101111', '001', '10', '000111', '0000110']",1,5,13,12,2,25,5.315445665445665,35,27
"['00000', '100', '10011', '000001', '011001', '0101', '0110110']",1,7,22,14,4,36,12.25996780996781,60,62
"['01', '001', '1', '0000100']",1,4,9,4,0,13,3.261111111111111,19,13
"['0001000', '1111', '100110', '10100', '1010', '01100']",1,6,17,14,4,31,8.893162393162394,43,40
"['100', '1100', '11']",1,3,4,5,0,9,1.9238095238095236,5,10
"['0', '100', '011', '0111110']",1,4,6,8,2,14,2.5833333333333335,22,16
"['010', '00', '11101', '10', '0011100']",1,5,10,9,2,19,5.612698412698412,30,25
"['0', '010111', '001011', '011000']",1,4,10,9,3,19,2.6904761904761907,24,17
"['0', '011011', '1100', '01011', '01000']",1,5,11,10,2,21,5.118037518037518,30,32
"['110', '00000', '010111']",1,3,8,6,0,14,1.058080808080808,12,7
"['001110', '100101', '1110']",1,3,7,9,2,16,1.8666666666666667,8,7
"['01', '010111', '0110']",1,3,5,7,0,12,1.7666666666666666,9,9
"['01', '00', '110', '0111100']",1,4,7,7,2,14,2.7888888888888888,19,17
"['00111', '101100', '1']",1,3,5,7,0,12,1.1645021645021645,12,7
"['0111100', '10', '000', '110', '1110', '1111011']",1,6,10,16,4,26,8.2005772005772,48,40
"['011', '11', '00011', '010010', '000001', '011010']",1,6,16,12,3,28,8.649206349206349,44,42
"['010', '11011', '0001', '00', '11111']",1,5,8,11,2,19,4.54047619047619,29,22
"['01', '1101111', '100101', '1111']",1,4,5,14,0,19,3.2204351204351203,21,27
"['00100', '1101', '0000']",1,3,9,4,2,13,1.5833333333333333,7,8
"['01', '1000', '1100101']",1,3,7,6,0,13,1.505050505050505,11,7
"['011011', '110110', '01011', '10']",1,4,7,12,2,19,4.041125541125541,16,19
"['00011', '10101', '11']",1,3,5,7,2,12,1.7428571428571429,9,10
"['011', '00000', '0001', '00110', '010101', '1100111', '111101']",1,7,18,18,4,36,11.292096792096793,65,56
"['110000', '111010', '000011', '00011', '0100001', '0111110']",1,6,20,17,5,37,8.61854811854812,49,48
"['10101', '0110', '01010']",1,3,7,7,2,14,2.1333333333333333,6,6
"['00000', '00100', '1101101', '1010', '01001']",1,5,16,10,3,26,6.005050505050505,28,23
"['01', '001', '0110111', '10001', '10101', '10000', '0001111', '0000', '1110']",1,9,22,20,7,42,18.88888888888889,113,105
"['1100', '000010', '11']",1,3,7,5,0,12,1.3166666666666667,11,7
"['0101110', '1', '1110']",1,3,4,8,0,12,1.3772727272727274,12,7
"['010100', '010', '10111', '1010', '0100']",1,5,12,10,2,22,6.887518037518038,22,33
"['0100110', '1', '0011', '110111', '110101']",1,5,9,15,2,24,5.212803862803863,36,27
"['01101', '1100100', '1000111', '1001']",1,4,11,12,2,23,3.803751803751804,19,18
"['000111', '001110', '0110100', '1']",1,4,10,10,2,20,3.0393772893772892,25,13
"['0', '101100', '1010101', '0111']",1,4,8,10,0,18,3.0322177822177823,22,12
"['011', '111', '111001']",1,3,3,9,2,12,1.7777777777777777,8,15
"['010', '011', '11', '0011', '1010111', '10100', '100000']",1,7,15,15,2,30,11.58982128982129,63,59
"['001', '1101011', '01011', '111']",1,4,6,12,2,18,3.1666666666666665,16,25
"['0', '0011010', '011101', '011110', '110']",1,5,10,13,2,23,5.626556776556777,34,33
"['00', '0101', '0100']",1,3,7,3,2,10,2.083333333333333,5,12
"['1000010', '00100', '00']",1,3,11,3,0,14,1.6825396825396823,11,12
"['0010010', '10', '1000111', '11']",1,4,9,9,4,18,2.849206349206349,25,14
"['01', '11010', '111100', '00111', '1001', '000', '11100']",1,7,14,16,3,30,12.042929292929292,63,62
"['0011', '01111', '100110', '10', '1101']",1,5,8,13,2,21,5.3422799422799425,28,25
"['1000', '01101', '000010', '011100']",1,4,13,8,2,21,3.2505050505050503,18,20
"['1', '00101', '0110', '000', '0111101']",1,5,10,10,0,20,4.7653679653679655,33,24
"['0100011', '1', '101001']",1,3,7,7,0,14,1.304945054945055,14,8
"['001', '1', '010110']",1,3,5,5,0,10,1.2301587301587302,10,4
"['10100', '1011001', '001111']",1,3,8,10,0,18,1.8123543123543124,9,9
"['110000', '1101111', '10000', '0000000', '1011', '110']",1,6,18,14,2,32,7.42050172050172,56,57
"['0010', '0101111', '0000110']",1,3,10,8,2,18,1.844155844155844,10,10
"['00010', '010', '1']",1,3,6,3,0,9,1.5833333333333333,8,6
"['010', '00111', '0101011', '1111', '10100', '1011100', '0100']",1,7,16,19,6,35,12.455699855699855,58,65
"['11001', '010', '1', '001110', '0110110', '1110']",1,6,11,15,0,26,8.10061605061605,48,38
"['011011', '101', '0001011']",1,3,7,9,0,16,2.0358974358974358,9,9
"['1001100', '100', '101111', '11']",1,4,7,11,0,18,3.0042735042735043,22,22
"['0', '0010110', '11000', '100110', '0010010']",1,5,16,10,2,26,5.2267732267732265,37,36
"['0011', '000', '11']",1,3,5,4,0,9,1.2380952380952381,7,8
"['0011', '0110100', '111', '0100101']",1,4,10,11,2,21,3.6155844155844155,19,14
"['0101111', '1', '1100001', '1000', '1100110']",1,5,12,14,3,26,4.53961038961039,42,27
"['01', '111111', '00101']",1,3,4,9,0,13,1.185064935064935,12,7
"['1101', '1001', '1', '101101']",1,4,5,10,2,15,3.435714285714286,16,30
"['11110', '01', '010000', '0010000', '101', '0001', '001010', '01100', '1110']",1,9,25,17,6,42,18.914024864024864,110,111
"['010100', '01', '110', '01000']",1,4,10,6,0,16,3.1431457431457432,16,19
"['1010110', '001', '0001110', '01111', '01100']",1,5,13,14,4,27,5.814285714285714,31,29
"['100011', '10', '111']",1,3,4,7,0,11,1.3444444444444446,9,11
"['1000', '1', '11010']",1,3,5,5,0,10,1.4,9,6
"['0001011', '1011', '101010']",1,3,8,9,0,17,2.1426573426573428,8,11
"['11101', '01110', '0100']",1,3,6,8,2,14,1.911111111111111,7,5
"['11001', '11101', '100']",1,3,5,8,2,13,2.05,6,10
"['000100', '11011', '10', '011010']",1,4,10,9,2,19,3.329004329004329,20,11
"['1', '010000', '111000', '101111']",1,4,9,10,3,19,2.357142857142857,26,14
"['001', '1', '011011', '101011', '000111']",1,5,9,13,3,22,5.079365079365079,34,28
"['11001', '100001', '1000101', '0110']",1,4,12,10,0,22,3.7473193473193476,17,19
"['01101', '0011000', '100', '0000', '11111', '001100']",1,6,17,13,2,30,7.991980241980242,46,55
"['010', '11101', '1']",1,3,3,6,0,9,1.3333333333333333,9,4
"['1', '1110', '0100']",1,3,4,5,2,9,1.3,8,4
"['10100', '0110', '10', '1001011']",1,4,9,9,0,18,3.1724386724386724,19,14
"['0001101', '11101', '001001', '01100', '011000']",1,5,16,13,4,29,6.711888111888111,25,34
"['110011', '01111', '10110']",1,3,5,11,2,16,1.690909090909091,9,8
"['00100', '1001001', '1110', '1111']",1,4,9,11,2,20,3.159090909090909,18,14
"['01', '10111', '0011', '10', '1000011', '110']",1,6,10,13,2,23,8.263780663780663,45,44
"['0010', '010001', '00', '1101']",1,4,10,6,2,16,3.0,18,13
"['11000', '0100011', '0111']",1,3,8,8,0,16,1.6565656565656566,10,10
"['1001000', '0001111', '000', '1001001', '0101']",1,5,17,11,3,28,6.046753246753246,33,34
"['001000', '1', '1001101']",1,3,8,6,0,14,1.151098901098901,14,4
"['1001011', '1', '1110']",1,3,4,8,0,12,1.0136363636363637,13,9
"['0110101', '001101', '00011']",1,3,9,9,0,18,1.9965034965034967,7,9
"['001', '110', '10']",1,3,4,4,2,8,1.5333333333333334,6,7
"['0', '01110', '11']",1,3,3,5,0,8,0.9047619047619047,9,4
"['11011', '010', '1100', '10']",1,4,6,8,0,14,3.776190476190476,13,14
"['0110101', '010', '0111001', '001101', '111', '100', '0011011', '01001']",1,8,19,22,6,41,17.603818403818405,80,80
"['1101001', '010001', '0011000', '100010', '1010', '1101']",1,6,19,15,6,34,10.012304362304363,45,38
"['01', '11000', '10001', '100010', '0011011']",1,5,14,11,2,25,5.853335553335553,33,27
"['00111', '1010', '110']",1,3,5,7,0,12,1.5158730158730158,7,8
"['0', '01', '010011']",1,3,5,4,0,9,1.4523809523809523,10,7
"['0100000', '11010', '0100110', '01110']",1,4,14,10,4,24,3.480952380952381,17,27
"['001', '11011', '100', '100010', '01110']",1,5,11,11,4,22,5.509090909090909,29,22
"['110111', '1100', '01011', '1011']",1,4,6,13,2,19,3.9606060606060605,14,26
"['01110', '000', '111011']",1,3,6,8,0,14,1.4494949494949494,11,4
"['0111010', '111101', '011001', '00010', '110101', '1110', '0100']",1,7,17,21,5,38,13.461227661227662,54,55
"['0', '0101111', '010101', '01010', '0111100']",1,5,12,14,2,26,5.46037296037296,36,39
"['1', '0101', '100', '0111']",1,4,5,7,2,12,2.907142857142857,14,13
"['101', '1', '100001']",1,3,5,5,0,10,1.4523809523809523,10,14
"['10101', '100', '1000', '111110', '1100']",1,5,10,12,2,22,6.355699855699855,23,29
"['010', '001111', '1011101', '00', '001110', '10', '0011011', '1100']",1,8,17,20,6,37,16.57009102009102,87,84
"['011101', '00001', '01100', '0']",1,4,10,7,2,17,2.4432900432900433,21,18
"['1010111', '10', '0100', '00011']",1,4,9,9,0,18,3.0533910533910533,21,13
"['010', '100001', '111', '00', '0111', '1011000', '0110110']",1,7,16,16,4,32,10.836951936951937,72,50
"['101', '1010110', '1']",1,3,4,7,0,11,1.35,12,10
"['0', '010101', '110']",1,3,5,5,0,10,1.2301587301587302,10,6
"['10111', '110010', '001110', '011']",1,4,8,12,2,20,3.6338383838383836,18,14
"['01', '0100010', '101', '1100001', '1011101', '0011']",1,6,15,15,3,30,8.464935064935064,55,41
"['1101111', '001111', '10001', '1101011', '000010', '111101']",1,6,14,23,5,37,8.726606726606727,46,58
"['0000111', '100011', '011001']",1,3,10,9,2,19,2.051282051282051,9,7
"['011011', '0101', '101110', '01010']",1,4,9,12,2,21,4.41010101010101,13,18
"['001111', '1', '10110']",1,3,4,8,0,12,1.1645021645021645,12,6
"['1', '10110', '000000']",1,3,8,4,0,12,0.696969696969697,14,4
"['101011', '1', '011110']",1,3,4,9,2,13,1.0714285714285714,13,4
"['101011', '100', '100011', '11111']",1,4,7,13,2,20,3.143939393939394,16,28
"['11000', '0101', '110', '10']",1,4,7,7,0,14,3.8039682539682538,13,15
"['010011', '0111101', '0010101']",1,3,9,11,2,20,1.8021978021978022,8,9
"['1101', '0010', '00101']",1,3,7,6,2,13,2.0555555555555554,6,9
"['1', '10001', '1101011', '111011', '10100']",1,5,9,15,2,24,4.995854145854146,34,39
"['11010', '010001', '111', '1001', '010011', '011010', '1111011']",1,7,15,22,3,37,13.081413031413032,57,69
"['1011010', '10', '11']",1,3,4,7,2,11,1.3888888888888888,11,8
"['011110', '01', '10', '000']",1,4,7,6,2,13,2.7444444444444445,18,16
"['0', '0110101', '01000']",1,3,8,5,0,13,1.0833333333333333,13,9
"['1110', '1010000', '101011', '001000']",1,4,13,10,2,23,3.048251748251748,19,17
"['1101001', '100', '0110', '1111', '0111']",1,5,8,14,3,22,5.561038961038961,27,27
"['11110', '00000', '0001', '0101011', '0100']",1,5,15,10,4,25,4.402020202020202,31,32
"['001', '10110', '011101', '1100', '1101010']",1,5,11,14,0,25,5.903984903984904,29,25
"['11000', '1010', '0111101', '011110']",1,4,9,13,0,22,3.5806526806526806,17,18
"['1101', '1110010', '00101', '011100']",1,4,10,12,0,22,3.7934731934731936,18,14
"['11011', '10110', '011']",1,3,4,9,2,13,2.3,6,9
"['111', '101000', '00110', '10011', '1101', '01000']",1,6,14,14,3,28,8.747546897546897,40,38
"['1001110', '101011', '1111', '00001']",1,4,9,13,0,22,2.8005439005439006,19,17
"['10', '01011', '0110']",1,3,5,6,0,11,1.9047619047619047,7,8
"['0', '0000100', '11']",1,3,7,3,0,10,0.4722222222222222,14,4
"['1011', '01', '001', '0011100']",1,4,8,8,0,16,3.627994227994228,18,14
"['1000100', '010101', '1111101']",1,3,9,11,2,20,1.5054945054945055,10,8
"['010', '011', '01100', '111']",1,4,6,8,3,14,3.6666666666666665,11,16
"['10100', '1', '011', '1001011']",1,4,7,9,0,16,2.683333333333333,22,17
"['111', '00001', '10110', '0000101', '011101', '100011', '0000']",1,7,20,16,4,36,11.303302253302252,65,63
"['001', '1', '00011', '1100000', '010010', '000100']",1,6,19,9,2,28,7.836230436230436,51,42
"['0', '00100', '10110', '010010']",1,4,11,6,2,17,3.006926406926407,20,19
"['11011', '100', '1000', '101110', '0110011']",1,5,11,14,0,25,6.38969918969919,30,28
"['110011', '0101', '00011']",1,3,7,8,0,15,1.993939393939394,7,10
"['0110101', '11101', '101110', '101001']",1,4,9,15,2,24,4.144522144522145,16,20
"['010', '1101', '01011', '01100', '0100']",1,5,11,10,4,21,6.917460317460317,19,32
"['1011011', '100', '1']",1,3,4,7,0,11,1.35,12,9
"['00', '010', '110', '11']",1,4,5,5,4,10,3.066666666666667,9,13
"['11001', '0010', '11', '010111', '1110110']",1,5,9,15,0,24,5.488833388833388,34,29
"['11001', '1000000', '01', '011']",1,4,10,7,0,17,2.7936507936507935,23,15
"['1011', '0001', '110']",1,3,5,6,2,11,1.3571428571428572,7,7
"['0011', '101000', '100', '110001', '010101']",1,5,14,11,3,25,6.338095238095238,28,26
"['101100', '010000', '0001111', '00', '0000010', '01100']",1,6,22,11,4,33,8.014263514263515,53,70
"['11110', '010001', '0101000', '01', '0011', '10001', '0101011', '01110']",1,8,21,20,5,41,15.972227772227772,86,83
"['1101001', '11', '0111', '0']",1,4,5,9,0,14,2.3065656565656565,22,15
"['0010', '11', '00100', '00', '11101']",1,5,10,8,4,18,4.447619047619048,28,28
"['010', '001', '0001100', '000000', '1001100']",1,5,19,7,4,26,6.1973137973137975,32,45
"['1010111', '100101', '11011', '1100']",1,4,8,14,0,22,4.141958041958042,15,25
"['0', '100', '11101']",1,3,4,5,0,9,1.3333333333333333,9,4
"['0010', '1110', '0101001']",1,3,8,7,2,15,1.4090909090909092,9,7
"['0001001', '100010', '10011', '11']",1,4,11,9,0,20,3.679043179043179,20,18
"['11', '00000', '0101101', '0110', '1000111', '11101', '011111']",1,7,15,21,4,36,10.998301698301699,72,57
"['101', '010', '001110']",1,3,6,6,2,12,1.7777777777777777,9,5
"['010', '11101', '0110111', '01110']",1,4,7,13,2,20,3.9833333333333334,17,17
"['0', '101', '1100101', '100101', '01000']",1,5,12,10,0,22,5.452730602730603,34,26
"['1011', '01', '10000', '10011']",1,4,8,8,2,16,3.457142857142857,15,20
"['101010', '101', '1']",1,3,4,6,0,10,1.4523809523809523,10,10
"['1011110', '0011', '0110', '0010101', '110']",1,5,11,14,4,25,6.4772727272727275,31,29
"['0000', '10', '1111']",1,3,5,5,2,10,0.6666666666666666,10,4
"['0011', '0001', '110']",1,3,6,5,2,11,1.6071428571428572,7,8
"['10', '0011111', '00011']",1,3,6,8,0,14,1.1746031746031744,13,8
"['000110', '110010', '11110', '0011000', '11', '11101']",1,6,14,17,4,31,8.956066156066155,49,43
"['0110100', '0001', '00110', '0000011', '000001', '1110']",1,6,21,12,4,33,8.121461871461872,51,54
"['0', '0010010', '010111', '111111']",1,4,8,12,2,20,1.958791208791209,27,14
"['101', '1000010', '10100', '1001001', '110', '01000']",1,6,18,12,6,30,9.097619047619048,43,39
"['1000', '010', '111010']",1,3,7,6,0,13,1.838095238095238,8,8
"['0011', '0010', '1001', '00001']",1,4,11,6,3,17,4.25,11,16
"['0', '001111', '1010100', '1001001', '1100']",1,5,13,12,2,25,4.638661338661339,39,24
"['1011', '010000', '0110', '110']",1,4,9,8,2,17,3.623015873015873,16,14
"['1011', '11011', '11']",1,3,2,9,0,11,2.126984126984127,6,22
"['01101', '111', '1001']",1,3,4,8,0,12,1.7658730158730158,6,9
"['11110', '01101', '110111', '0111']",1,4,5,15,2,20,4.228282828282828,13,23
"['11011', '1001', '100101', '0010010', '001011']",1,5,14,14,2,28,7.12027972027972,25,31
"['110', '111', '00001']",1,3,5,6,2,11,1.1666666666666665,9,8
"['0100001', '1000110', '000']",1,3,12,5,2,17,1.9142857142857141,11,6
"['100010', '10', '11111', '0100001', '010011']",1,5,13,13,2,26,4.995892995892996,37,27
"['0111', '1001011', '0']",1,3,5,7,0,12,1.1954545454545453,12,5
"['0001010', '111010', '010110', '1111011']",1,4,11,15,4,26,3.8644688644688645,18,18
"['01', '10', '1011100', '0100100', '01100']",1,5,13,10,4,23,5.492063492063492,35,33
"['1010', '1000', '10011']",1,3,7,6,2,13,2.083333333333333,5,10
"['010', '001', '11', '100', '0000', '1011011', '011000']",1,7,16,12,3,28,10.815528915528915,63,53
"['11110', '1110010', '10110', '100010', '0001000', '1110']",1,6,17,17,4,34,9.436152736152737,42,54
"['010011', '10000', '011001']",1,3,10,7,2,17,1.9242424242424243,8,7
"['0100000', '10001', '0100101', '11']",1,4,13,8,2,21,3.4523809523809526,21,14
"['110', '1100', '1100000', '0000011', '11100', '0100']",1,6,18,12,4,30,9.198412698412698,47,61
"['010000', '011', '00101', '11', '0010101', '10100']",1,6,16,12,2,28,8.91985791985792,45,43
"['111010', '1111', '10', '0111', '1100']",1,5,6,14,3,20,5.783333333333333,25,35
"['0', '110000', '101', '0111', '000100', '0110011']",1,6,15,12,2,27,7.03978798978799,57,36
"['100001', '11000', '1010', '110', '1110']",1,5,11,11,2,22,6.183621933621933,22,29
"['10111', '11', '1110110', '101101']",1,4,5,15,0,20,3.8608613608613607,19,27
"['1011', '00101', '0111', '0000']",1,4,9,8,3,17,3.25,14,13
"['1', '011', '0011000']",1,3,6,5,0,11,1.35,12,4
"['0010111', '11', '00110', '000010', '0000', '011010', '01000', '0100']",1,8,25,14,6,39,15.452053502053502,79,113
"['01', '010', '0010111', '1110000', '100110']",1,5,13,12,2,25,5.2926739926739925,40,25
"['11001', '010', '1100000', '10110', '1111001']",1,5,13,14,4,27,5.888095238095238,33,28
"['110', '10', '0110110']",1,3,5,7,0,12,1.8444444444444446,10,10
"['10101', '110', '0101100', '0100']",1,4,10,9,0,19,3.732034632034632,16,14
"['01', '10', '0100101']",1,3,6,5,2,11,1.3888888888888888,12,8
"['00001', '101000', '0000', '01001', '110']",1,5,16,7,2,23,5.486219336219336,24,34
"['1111100', '0001110', '11', '00111', '10']",1,5,9,14,4,23,5.0396825396825395,38,28
"['10101', '10010', '001101']",1,3,8,8,2,16,2.0727272727272728,7,9
"['001111', '10010', '1110000', '1100101']",1,4,12,13,2,25,3.836663336663337,22,17
"['101', '01', '1011001', '00011']",1,4,8,9,0,17,3.4158730158730157,20,19
"['0', '00010', '0111011']",1,3,7,6,0,13,1.0833333333333333,14,8
"['0010', '1', '011010', '011011', '0101', '01000']",1,6,14,12,4,26,8.712337662337662,41,43
"['101', '011', '00000']",1,3,7,4,2,11,1.1666666666666665,10,4
"['1010001', '0111010', '1000101']",1,3,11,10,3,21,1.8571428571428572,10,6
"['1001110', '01', '10', '0010011']",1,4,9,9,4,18,2.992063492063492,26,14
"['01', '11011', '00000', '110100', '110']",1,5,11,10,2,21,4.714718614718615,31,29
"['1100011', '11011', '1']",1,3,4,9,0,13,1.4166666666666667,12,18
"['0', '1010', '100000', '11']",1,4,8,5,0,13,2.2023809523809526,20,11
"['011011', '01', '00', '010110']",1,4,8,8,4,16,3.1666666666666665,19,17
"['0', '10111', '0111100']",1,3,5,8,0,13,1.25,14,4
"['11100', '00010', '110', '001111']",1,4,9,10,2,19,3.1853535353535354,20,20
"['0', '10100', '0011101']",1,3,7,6,0,13,1.0833333333333333,14,7
"['11001', '010', '0000100', '0100011']",1,4,14,8,2,22,3.5809523809523807,21,13
"['01101', '1110110', '010']",1,3,6,9,0,15,1.8166666666666667,9,8
"['0100110', '00', '11101', '010111', '0110010', '000111', '0101001']",1,7,20,20,5,40,12.805194805194805,68,63
"['1011110', '00110', '000010', '000', '01011']",1,5,15,11,2,26,6.03041958041958,30,37
"['101', '001', '011', '010010']",1,4,8,7,3,15,4.0,13,12
"['0', '1011', '100', '1101101']",1,4,6,9,0,15,3.0487012987012987,20,12
"['01111', '1010', '000', '1000011', '1101']",1,5,11,12,2,23,4.9369408369408365,32,22
"['0111', '1001', '1111111']",1,3,3,12,2,15,1.4090909090909092,12,12
"['01', '0010', '0110']",1,3,6,4,2,10,2.083333333333333,5,10
"['1101', '10010', '10', '111011']",1,4,6,11,0,17,3.75021645021645,16,18
"['00011', '00100', '1000000', '001110', '10', '01010']",1,6,20,10,3,30,8.362526362526362,47,51
"['0', '01', '11011']",1,3,3,5,0,8,1.5714285714285714,8,4
"['100', '01010', '00001']",1,3,9,4,2,13,1.65,8,7
"['00010', '0110100', '111', '0000']",1,4,12,7,0,19,2.769191919191919,19,19
"['0', '11100', '110']",1,3,4,5,0,9,1.5833333333333333,8,7
"['1001110', '001', '011', '0001', '1010000']",1,5,14,10,4,24,5.757575757575758,34,27
"['01', '001', '000', '11111', '1100']",1,5,8,9,2,17,4.323015873015873,28,26
"['0', '1101', '100', '111110']",1,4,5,9,0,14,2.8015873015873014,19,11
"['100', '1', '0111011']",1,3,4,7,0,11,1.15,13,6
"['000110', '0110100', '101001']",1,3,11,8,2,19,2.051282051282051,10,5
"['0', '0001', '111000']",1,3,7,4,0,11,1.2857142857142856,12,8
"['0001001', '0101111', '111', '0011', '1100100', '1101']",1,6,14,18,5,32,8.879220779220779,50,53
"['0010001', '10110', '10', '10011']",1,4,10,9,2,19,3.5539682539682538,20,16
"['011011', '1010000', '10101']",1,3,9,9,0,18,1.8554778554778555,10,9
"['01101', '000100', '0101110', '1001']",1,4,12,10,0,22,3.2355866355866354,18,12
"['0', '101', '0011', '001']",1,4,6,5,2,11,3.4952380952380953,11,13
"['0010', '0010101', '111011', '0100100', '011111']",1,5,14,16,4,30,5.9560106560106565,33,27
"['001101', '00', '0101', '110', '001011']",1,5,11,10,2,21,6.182539682539683,27,29
"['0', '011', '111011', '0111111', '1100101', '101110']",1,6,9,21,4,30,7.815384615384615,56,41
"['101', '01001', '111000', '10']",1,4,8,8,0,16,3.6113275613275615,17,14
"['01', '10', '0000011', '110010']",1,4,10,7,2,17,2.628205128205128,25,14
"['00001', '11', '0000011', '10', '010110', '0011011', '0111110', '0100']",1,8,21,19,5,40,13.777633477633477,101,78
"['100', '10', '1111110', '111011']",1,4,5,13,0,18,3.2042735042735044,21,17
"['01001', '011010', '011100']",1,3,9,8,2,17,2.106060606060606,7,12
"['11', '0011', '000101', '01010', '01001']",1,5,12,10,2,22,6.697402597402597,24,24
"['0111000', '0000', '100010']",1,3,12,5,0,17,1.9608391608391609,9,12
"['111', '011100', '0101101', '10100', '100011', '000', '1100011', '1011']",1,8,19,22,6,41,16.447297147297146,86,84
"['00', '010', '10']",1,3,5,2,2,7,2.1,3,9
"['01', '10010', '10']",1,3,5,4,2,9,1.6428571428571428,8,8
"['00100', '01111', '10011', '1']",1,4,7,9,3,16,2.6,21,11
"['101001', '10', '1011100', '1110', '0100']",1,5,11,12,2,23,6.201554001554001,29,25
"['1001110', '0001001', '1011001', '0000000', '0000010', '0111', '1100', '1110']",1,8,28,19,8,47,15.454545454545455,99,85
"['0', '001', '11100']",1,3,5,4,0,9,1.3333333333333333,10,7
"['0000111', '101100', '0110', '101']",1,4,10,10,0,20,3.445088245088245,22,13
"['1001100', '1011001', '1']",1,3,7,8,2,15,1.3571428571428572,14,9
"['0101110', '100', '000', '011111', '1100']",1,5,11,12,2,23,5.3005217005217,32,30
"['101010', '1000', '1101']",1,3,7,7,2,14,1.9,6,7
"['110010', '0111001', '110']",1,3,7,9,0,16,2.0358974358974358,10,9
"['11001', '00101', '010010', '1000', '00110', '001010']",1,6,19,12,5,31,10.38989898989899,37,46
"['0101', '0011', '1001101', '100111', '000', '1011', '000100']",1,7,18,16,5,34,13.256116106116107,56,60
"['00100', '1011101', '000100', '11']",1,4,11,9,0,20,2.8507881007881006,23,15
"['010', '11', '00111', '1011110', '110111', '011001']",1,6,10,19,2,29,8.617660117660117,50,40
"['000100', '00', '100', '001110']",1,4,12,5,2,17,3.5777777777777775,18,32
"['1111010', '1', '0100']",1,3,5,7,0,12,1.1954545454545453,13,4
"['110001', '01111', '10110', '10', '11100']",1,5,9,14,3,23,5.746753246753246,32,26
"['10111', '101', '100', '100010', '00110']",1,5,11,11,4,22,6.122727272727273,25,28
"['1000100', '11', '10101', '011000', '001001', '0100']",1,6,18,12,2,30,9.333821733821734,46,37
"['110111', '100', '011', '1111']",1,4,4,12,2,16,2.9015873015873015,17,24
"['0', '11110', '10']",1,3,3,5,0,8,1.5714285714285714,8,7
"['1010', '0010010', '111', '000']",1,4,10,7,2,17,2.688311688311688,19,14
"['0', '111', '000010']",1,3,6,4,0,10,0.5079365079365079,13,4
"['01', '100', '111011', '0111111', '1110100', '0100']",1,6,11,18,2,29,8.157942057942059,53,48
"['10111', '00', '110']",1,3,4,6,0,10,1.1857142857142857,9,5
"['0', '0010', '11100']",1,3,6,4,0,10,1.1777777777777778,10,9
"['11110', '111', '0101101', '1101000', '10010', '1110100']",1,6,14,20,5,34,9.092857142857143,45,46
"['1001100', '011100', '0011010', '000']",1,4,14,9,2,23,4.04004884004884,17,29
"['1', '011100', '10110', '1010111', '111000', '0100']",1,6,13,16,2,29,8.198351648351649,53,35
"['0010', '1111101', '011', '11', '1100010', '1100000', '0011110', '0101', '011000']",1,9,23,24,6,47,20.33060828060828,132,104
"['1000', '011', '000']",1,3,7,3,2,10,1.476190476190476,6,10
"['0', '000100', '110', '011110']",1,4,9,7,2,16,2.6825396825396823,22,20
"['01', '100001', '011100', '11', '100110', '0110011']",1,6,14,15,5,29,8.376068376068377,54,37
"['11', '00', '1000', '0101', '001011', '01110']",1,6,12,11,4,23,7.832756132756132,42,36
"['11001', '10111', '100010', '010110', '10', '1011', '0111110', '01100']",1,8,17,23,5,40,16.845443445443443,82,72
"['01', '11110', '10111', '1001101', '1010', '1000', '000', '110']",1,8,15,18,6,33,14.745743145743145,74,75
"['1111101', '0011000', '0111', '1110110', '1110']",1,5,10,19,5,29,6.10064935064935,34,33
"['0100010', '0010', '1101011', '10']",1,4,11,9,2,20,3.3997113997113995,22,15
"['101110', '0011', '10']",1,3,5,7,0,12,1.4333333333333333,10,8
"['0000101', '00', '1001010']",1,3,11,5,2,16,1.6031746031746033,13,8
"['0', '11010', '001', '011001']",1,4,8,7,0,15,3.012987012987013,20,14
"['01', '110', '01100']",1,3,5,5,0,10,1.7214285714285715,7,7
"['0', '100100', '0111']",1,3,6,5,0,11,1.0857142857142859,12,6
"['1111101', '00111', '0001', '100010', '001010', '0111']",1,6,15,17,4,32,8.727117327117327,44,42
"['110110', '111010', '00110', '10', '0111', '001100']",1,6,13,16,3,29,9.21991341991342,43,49
"['1101', '1', '000', '0100']",1,4,7,5,2,12,2.157142857142857,15,10
"['101', '00', '1100', '011']",1,4,6,6,2,12,3.276190476190476,13,13
"['11001', '110010', '110100', '1100101', '0000', '00010']",1,6,19,14,4,33,10.413519813519814,35,56
"['001101', '1', '011']",1,3,4,6,0,10,1.4523809523809523,10,6
"['01', '00111', '10110', '111111', '11101', '10']",1,6,7,18,5,25,7.579220779220779,46,45
"['00110', '001', '0010', '111']",1,4,8,7,2,15,3.615079365079365,12,17
"['010', '011', '10', '11111', '01011']",1,5,6,12,4,18,5.373809523809523,24,29
"['0', '0001001', '1101001', '00101', '101111']",1,5,13,13,2,26,4.7890442890442895,38,26
"['0100111', '100', '111']",1,3,5,8,2,13,1.5333333333333332,10,10
"['00010', '1', '0011111']",1,3,6,7,0,13,1.0833333333333333,14,5
"['0101000', '011', '00101', '00111', '0000001', '0000101', '010111', '10', '110']",1,9,26,19,7,45,19.9018093018093,118,107
"['0100001', '010', '100111', '110']",1,4,10,9,2,19,3.1709401709401708,21,14
"['1', '0111110', '000']",1,3,5,6,0,11,0.65,14,4
"['11100', '0010', '0010111', '111010']",1,4,10,12,0,22,3.642346542346542,19,26
"['011111', '1011011', '10', '110100']",1,4,7,14,2,21,2.9123931623931623,24,16
"['11110', '0110', '0010101', '0000', '01000']",1,5,15,10,4,25,5.576767676767677,27,36
"['01', '00', '0000111', '0010010', '1110']",1,5,13,9,4,22,4.424963924963925,39,30
"['0001110', '1', '0100010', '1101100', '1000']",1,5,15,11,3,26,4.8253246753246755,41,23
"['00001', '100', '10000', '110', '01100']",1,5,14,7,5,21,5.966666666666667,25,31
"['01', '0001010', '00', '1011']",1,4,9,6,2,15,2.9343434343434343,20,12
"['0010', '0111101', '10']",1,3,6,7,0,13,1.6565656565656566,11,7
"['001001', '100', '1011000']",1,3,10,6,0,16,1.882051282051282,10,10
"['0100001', '01001', '111']",1,3,8,7,0,15,1.7333333333333334,10,11
"['101100', '00001', '1111001', '0010100', '00', '1101', '0110011']",1,7,20,18,3,38,11.977677877677877,73,59
"['100110', '110', '11']",1,3,4,7,0,11,1.9666666666666668,8,10
"['101100', '01', '11']",1,3,4,6,2,10,1.5,9,6
"['10101', '000001', '00001']",1,3,11,5,2,16,1.6727272727272728,6,15
"['001', '1', '01000']",1,3,6,3,0,9,1.3333333333333333,9,5
"['0010110', '1010000', '011001']",1,3,12,8,2,20,1.8021978021978022,9,7
"['01111', '001111', '111', '1010011']",1,4,6,15,0,21,3.841142191142191,16,30
"['0010001', '0001', '01010', '1101110']",1,4,13,10,2,23,3.2972582972582973,21,17
"['11010', '0101011', '001111', '11111']",1,4,7,16,2,23,3.488111888111888,16,25
"['0011', '110', '11111']",1,3,3,9,0,12,1.5158730158730158,9,11
"['0', '01101', '10111', '1010111']",1,4,6,12,2,18,3.216666666666667,21,16
"['001', '1011001', '0011000', '00001', '00111', '01100']",1,6,19,13,5,32,9.68095238095238,41,53
"['0001011', '0001', '110', '010111']",1,4,10,10,0,20,3.0266622266622267,20,18
"['00', '10', '011000']",1,3,7,3,2,10,1.5,9,10
"['010', '010101', '100010']",1,3,9,6,2,15,1.8333333333333333,9,10
"['0111000', '110', '10000']",1,3,9,6,0,15,1.7666666666666666,10,8
"['11001', '1010110', '010', '0101110', '11', '00']",1,6,12,14,4,26,7.677777777777777,51,34
"['1000', '0010', '0001000']",1,3,12,3,2,15,1.9545454545454546,8,16
"['100110', '11011', '1']",1,3,4,8,0,12,1.3463203463203464,11,8
"['0011001', '100110', '00', '1010']",1,4,11,8,0,19,3.7257964257964256,20,16
"['0', '01', '110', '101111']",1,4,4,8,0,12,2.7968253968253967,18,11
"['00000', '10101', '010111', '0000010', '01110']",1,5,17,11,3,28,5.313053613053613,31,30
"['0111000', '01', '10100', '000']",1,4,11,6,0,17,3.1825396825396823,19,22
"['00001', '11', '101010', '01111', '01010', '1100011', '01011', '0100']",1,8,19,20,4,39,15.761849261849262,77,81
"['1001001', '110010', '1', '00000']",1,4,12,7,0,19,2.517066267066267,25,10
"['0010', '001', '011', '1010', '000']",1,5,11,6,5,17,6.416666666666666,15,30
"['1', '001011', '01000']",1,3,7,5,0,12,1.1645021645021645,12,5
"['01', '00011', '101010', '0000', '1010011']",1,5,14,10,0,24,5.627528027528028,31,28
"['011111', '100', '10011']",1,3,5,9,0,14,1.5176767676767677,10,9
"['101', '0010011', '000000', '011001', '0111', '1101', '11100', '1001011', '011000']",1,9,25,23,7,48,20.711355311355312,109,104
"['101', '1011', '10']",1,3,3,6,0,9,2.3238095238095235,4,12
"['1001100', '1101101', '1', '0000']",1,4,10,9,2,19,2.3051948051948052,26,12
"['1100', '1', '0111']",1,3,3,6,2,9,1.3,9,7
"['01', '00000', '1111', '1110001', '00010']",1,5,13,10,2,23,4.551082251082251,36,25
"['01', '1110010', '1101', '10', '01001', '01000']",1,6,13,12,4,25,8.97965367965368,43,38
"['001', '11', '000101', '001110', '01011']",1,5,11,11,2,22,5.925974025974026,29,25
"['0010', '00000', '11101', '10', '01010', '000111']",1,6,16,11,3,27,7.759379509379509,45,43
"['0010001', '001111', '10110', '1010011', '1101', '01011', '01110']",1,7,17,22,5,39,12.954145854145853,59,55
"['0', '0011011', '10101', '00011']",1,4,9,9,2,18,2.8499999999999996,22,13
"['01', '110010', '1101000', '00', '10']",1,5,11,8,3,19,5.102564102564102,33,25
"['010011', '011', '0000100', '11010']",1,4,12,9,0,21,3.2275058275058273,21,17
"['00100', '101', '1000010', '011001', '010011', '00010']",1,6,20,12,4,32,9.842890442890443,42,37
"['0', '1011', '11011']",1,3,3,7,0,10,1.6222222222222222,8,8
"['010100', '0110', '10', '11']",1,4,7,7,2,14,3.6333333333333333,15,12
"['1110011', '001', '110', '0010']",1,4,8,9,2,17,3.507359307359307,18,15
"['1100111', '1000', '1', '10']",1,4,6,8,0,14,2.973232323232323,21,15
"['00110', '1001', '10', '11']",1,4,6,7,2,13,3.642857142857143,14,12
"['10001', '00010', '111']",1,3,7,6,2,13,1.55,9,4
"['0001', '0110', '011']",1,3,6,5,2,11,1.9285714285714284,6,8
"['0010', '000011', '1010100', '00010', '1001111']",1,5,17,12,2,29,5.658719058719059,31,30
"['11010', '11', '100100', '00', '10', '0111101']",1,6,11,13,3,24,7.403096903096903,49,34
"['11', '00010', '0110011']",1,3,7,7,0,14,1.3968253968253967,12,6
"['010', '0101111', '01101', '011100', '0101011', '0001101', '01010', '0110001']",1,8,23,24,6,47,18.37798867798868,77,107
"['100', '1111000', '000', '011001']",1,4,11,8,2,19,3.593162393162393,18,19
"['011101', '00', '01111', '000011']",1,4,9,10,2,19,3.24025974025974,20,18
"['001', '1101110', '1100011', '01001', '1100', '111001']",1,6,14,18,2,32,9.902147852147852,45,53
"['0101', '111000', '1', '1001']",1,4,7,8,2,15,2.585714285714286,20,15
"['1000', '100', '0001111']",1,3,8,6,0,14,1.8025974025974025,11,12
"['1001001', '1011011', '0101011']",1,3,9,12,3,21,2.0,7,12
"['001', '11011', '110', '00011']",1,4,7,9,4,16,3.433333333333333,16,20
"['100000', '1000', '000101']",1,3,12,4,2,16,2.0666666666666664,8,15
"['11', '0110100', '110101']",1,3,6,9,0,15,1.7136752136752138,11,6
"['1011', '000100', '101011']",1,3,8,8,2,16,1.7000000000000002,10,9
"['010', '100', '11101', '0001111']",1,4,8,10,2,18,3.1333333333333333,22,13
"['00', '0011101', '110100', '0111']",1,4,9,10,0,19,3.2204351204351203,23,18
"['001', '111000', '101101']",1,3,7,8,2,15,1.5555555555555554,10,8
"['11001', '01', '0110']",1,3,5,6,0,11,1.9047619047619047,8,6
"['0010', '11011', '0110', '0011111']",1,4,8,12,2,20,3.452020202020202,18,15
"['0010000', '100100', '1111110', '10', '0000']",1,5,16,10,2,26,4.7939504939504936,40,36
"['0101010', '010', '11']",1,3,6,6,0,12,1.4444444444444444,11,8
"['11', '100', '0011010', '000000', '01011', '01000']",1,6,18,10,2,28,7.287173937173937,50,45
"['0', '010', '0010101', '0111111', '101111']",1,5,9,15,2,24,4.686202686202686,40,22
"['1101', '100', '0000']",1,3,7,4,2,11,1.3928571428571428,7,6
"['1000011', '111', '111001', '0110011']",1,4,9,14,2,23,3.7655677655677655,19,31
"['0', '01101', '11000', '111011', '010110']",1,5,10,13,4,23,5.05021645021645,35,21
"['0100110', '0011', '111110', '10011', '10', '1110']",1,6,11,17,2,28,8.816106116106116,44,48
"['0101101', '0101', '10']",1,3,6,7,0,13,1.8383838383838382,10,11
"['1000011', '10101', '001101', '0001000']",1,4,15,10,2,25,3.5143190143190144,20,15
"['011111', '11011', '011']",1,3,3,11,0,14,1.962121212121212,7,14
"['0010', '001101', '0111011', '011', '0001010', '01001']",1,6,17,15,2,32,9.916167166167167,42,45
"['00010', '1110011', '111100', '00000']",1,4,13,10,2,23,3.12983682983683,21,20
"['0111010', '100000', '110111']",1,3,9,10,2,19,1.4102564102564104,12,4
"['0010110', '1', '1001', '1100000', '0101']",1,5,13,10,4,23,4.66038961038961,41,20
"['0011', '0011010', '100010', '1000010', '1100']",1,5,17,11,4,28,6.3553446553446555,31,37
"['1000', '1', '010010', '0100']",1,4,10,5,2,15,3.435714285714286,17,14
"['1111100', '110000', '0110101', '0', '101000']",1,5,14,13,4,27,4.937728937728938,40,25
"['0', '110', '0110111', '100111']",1,4,6,11,0,17,2.8493894993894995,23,15
"['01', '00', '01110']",1,3,5,4,2,9,1.6428571428571428,7,9
"['0101', '000001', '000000']",1,3,13,3,2,16,1.6333333333333333,8,15
"['0011', '00', '0110', '01010']",1,4,9,6,2,15,4.2103174603174605,12,22
"['01', '000', '1101', '11100', '001011']",1,5,10,10,0,20,4.9350649350649345,30,27
"['01', '100110', '11000', '1']",1,4,7,7,0,14,2.7987012987012987,21,12
"['0110101', '10001', '1100100']",1,3,10,9,2,19,1.7142857142857142,9,7
"['0111000', '1000000', '0011']",1,3,12,6,2,18,1.4805194805194803,13,10
"['00110', '110010', '1', '111101']",1,4,7,11,2,18,2.844155844155844,23,12
"['11', '0011001', '0001', '0110001', '1110']",1,5,12,12,4,24,5.359668109668109,35,30
"['1', '0100', '101101']",1,3,5,6,0,11,1.2857142857142856,11,4
"['1111010', '00', '1100']",1,3,6,7,0,13,1.8383838383838382,10,9
"['1100111', '1011', '001', '1010011']",1,4,8,13,2,21,4.083116883116883,18,26
"['001110', '1010100', '110', '10']",1,4,9,9,0,18,3.118803418803419,20,18
"['101110', '00110', '1', '001011']",1,4,8,10,2,18,3.0259740259740258,21,14
"['001101', '00000', '010101', '10010', '1011100', '10', '0011100']",1,7,22,16,6,38,11.848862248862249,67,69
"['110', '111', '10']",1,3,2,6,2,8,1.8666666666666667,4,9
"['010111', '1', '1010011']",1,3,5,9,0,14,1.304945054945055,13,9
"['1001110', '1011', '10', '01010']",1,4,8,10,0,18,3.743145743145743,18,16
"['101000', '111', '000', '1111011']",1,4,8,11,2,19,2.3726495726495727,24,20
"['0110010', '100111', '001111']",1,3,8,11,2,19,2.0641025641025643,10,6
"['0', '101100', '010', '1000111']",1,4,9,8,0,17,2.4955433455433456,25,11
"['1000', '00', '010']",1,3,7,2,0,9,2.038095238095238,5,10
"['001', '0011', '010010', '00', '0100']",1,5,13,6,2,19,6.628571428571428,23,39
"['101011', '1100', '000', '11']",1,4,7,8,0,15,2.7825396825396824,18,17
"['101', '01', '110101']",1,3,4,7,0,11,1.9666666666666668,8,12
"['001', '01101', '1']",1,3,4,5,0,9,1.3333333333333333,8,7
"['01001', '110111', '000', '11111']",1,4,7,12,2,19,2.213131313131313,19,16
"['1', '0011001', '10000', '11101', '000']",1,5,12,9,2,21,4.083333333333333,37,26
"['11110', '0010', '0101']",1,3,6,7,2,13,1.6388888888888888,8,7
"['110110', '11', '001010', '000', '0111']",1,5,10,11,2,21,4.93015873015873,32,26
"['00111', '11', '100111', '1010011']",1,4,7,13,0,20,3.8608613608613607,18,31
"['0', '1001', '1100', '000001']",1,4,10,5,2,15,2.835714285714286,20,13
"['010001', '101', '0001111', '11111', '01110']",1,5,10,16,2,26,5.302253302253302,33,26
"['1', '001101', '0011000', '1011', '00010']",1,5,13,10,0,23,5.022116772116772,35,25
"['101', '010001', '0100']",1,3,8,5,0,13,2.038095238095238,7,8
"['0001110', '011', '1111001', '010111', '1010000']",1,5,14,16,3,30,5.473260073260073,40,25
"['1', '1001010', '0000']",1,3,8,4,0,12,0.9772727272727273,13,4
"['0010110', '000101', '1111', '00110', '1110']",1,5,12,14,2,26,6.081857031857032,28,33
"['0010', '010', '0001', '011010', '01110']",1,5,13,9,2,22,6.815440115440115,21,46
"['0', '001', '011110']",1,3,5,5,0,10,1.2301587301587302,11,8
"['010', '0100111', '00011', '1001', '01110']",1,5,12,12,2,24,6.35981240981241,29,24
"['011101', '10', '01011', '00001']",1,4,9,9,2,18,2.6662337662337663,18,14
"['1101110', '0110011', '11']",1,3,5,11,2,16,1.6031746031746033,13,11
"['0', '1010001', '0100']",1,3,8,4,0,12,1.3772727272727274,12,4
"['0110111', '0011001', '0001', '10110', '000000']",1,5,17,12,2,29,5.287867687867688,34,29
"['11110', '10000', '1110101', '010111', '1100']",1,5,11,16,2,27,5.5517482517482515,30,30
"['11001', '100', '001110']",1,3,7,7,0,14,1.7398989898989898,10,5
"['0010', '010', '111100', '001000', '1111', '1010', '1100']",1,7,16,15,6,31,12.232539682539683,54,70
"['110110', '0101111', '101', '10101', '1110011', '1100001', '0001100']",1,7,18,24,4,42,12.745038295038295,73,63
"['11', '00011', '00100', '100', '00110', '100011', '10']",1,7,16,12,5,28,12.355627705627706,57,62
"['111', '011', '00000', '101101', '0011', '1000111', '10010', '01010', '01110', '01000']",1,10,25,23,7,48,26.654872904872903,123,119
"['001', '0101110', '10']",1,3,6,6,0,12,1.2444444444444445,11,7
"['0001', '0110', '111']",1,3,5,6,2,11,1.3571428571428572,8,4
"['0000100', '000000', '01110', '01001', '01011', '101111']",1,6,20,14,5,34,8.155011655011656,46,43
"['11110', '00011', '10', '001100', '0010010']",1,5,14,11,2,25,5.243545343545343,35,32
"['1110010', '0110', '1111', '000', '0100100']",1,5,13,12,4,25,5.349350649350649,34,28
"['011101', '0001', '1100', '1']",1,4,7,8,2,15,2.585714285714286,20,14
"['110000', '01101', '011', '0010100', '1111', '111110']",1,6,13,18,2,31,8.221273171273172,50,45
"['101', '100111', '1000011', '1011011', '01110']",1,5,11,17,2,28,6.37049617049617,31,36
"['0100001', '001100', '001001']",1,3,13,6,2,19,2.217948717948718,8,11
"['101011', '10110', '1110101', '1010', '0001011']",1,5,12,17,2,29,7.132112332112332,27,36
"['1101000', '1000', '11010']",1,3,9,7,0,16,2.2272727272727275,7,13
"['001111', '111', '0000']",1,3,6,7,0,13,1.0666666666666667,11,10
"['11100', '011', '101111', '11']",1,4,4,12,0,16,3.5835497835497834,17,24
"['101', '1111', '100110', '11101', '1011']",1,5,6,16,2,22,6.828066378066378,20,45
"['1011', '00101', '1111']",1,3,4,9,2,13,1.6111111111111112,6,10
"['1101', '11101', '10101', '001111']",1,4,6,14,2,20,4.028282828282828,12,29
"['1111', '10100', '000100', '1111011']",1,4,9,13,0,22,2.906682206682207,22,22
"['010', '1001', '10110', '1110100', '1011', '0100']",1,6,13,14,3,27,10.057070707070707,37,38
"['0101', '010000', '1000101', '10110', '00', '100000', '011001', '001001', '110']",1,9,28,17,4,45,21.584620934620936,110,102
"['0001', '11100', '100001', '000']",1,4,12,6,0,18,3.8137085137085136,16,20
"['0011', '10100', '01110']",1,3,7,7,2,14,1.511111111111111,8,7
"['1', '10011', '010110']",1,3,5,7,0,12,1.3463203463203464,12,4
"['0110101', '1110001', '110']",1,3,7,10,2,17,1.9142857142857141,10,8
"['010', '000', '01110']",1,3,7,4,2,11,1.9166666666666665,6,14
"['1100', '1110', '11']",1,3,3,7,2,10,2.083333333333333,5,11
"['0101', '1', '10000']",1,3,6,4,0,10,1.1777777777777778,10,6
"['01', '0100101', '1111011']",1,3,6,10,2,16,1.4603174603174602,14,8
"['001', '10', '01011', '011100']",1,4,8,8,0,16,2.961327561327561,18,14
"['010', '011', '111', '10111', '1101110', '100111']",1,6,8,19,3,27,9.756099456099456,38,53
"['0110010', '00', '11']",1,3,6,5,2,11,0.8888888888888888,12,4
"['01', '01001', '0001', '111110']",1,4,8,9,0,17,2.9406204906204905,20,17
"['110000', '1000101', '0110111', '0011001', '1000', '101111']",1,6,18,19,5,37,8.71914751914752,53,46
"['0010', '01101', '10', '0111', '110']",1,5,8,10,2,18,6.31984126984127,20,26
"['010', '0011', '110100', '0001101', '000']",1,5,14,9,2,23,5.863292263292263,30,34
"['010110', '01100', '00000']",1,3,11,5,2,16,1.6727272727272728,7,15
"['011011', '0010', '0000']",1,3,9,5,2,14,1.75,8,10
"['1000101', '01110', '11']",1,3,6,8,0,14,1.349206349206349,12,4
"['000110', '1', '00100', '1011101', '10001', '1111110', '000000']",1,7,20,17,6,37,9.532400932400932,84,50
"['0101000', '00101', '111', '011', '10001', '10101', '0000', '110', '01000']",1,9,23,17,7,40,20.494660894660896,94,97
"['01000', '010010', '0111']",1,3,9,6,0,15,1.9535353535353535,7,13
"['11110', '00011', '1101', '10100', '1000', '010011', '1110']",1,7,15,18,6,33,11.683333333333334,55,63
"['00', '1', '01011']",1,3,4,4,0,8,0.9047619047619047,9,4
"['11011', '001111', '00100', '0011', '0110', '101001']",1,6,14,16,6,30,9.462121212121211,39,41
"['1111', '0001100', '1010', '00', '1000', '1011000', '0000110']",1,7,21,14,6,35,10.854978354978355,75,73
"['111010', '011', '00100', '1110011', '01111', '0011010']",1,6,14,19,4,33,9.343728493728493,46,51
"['00100', '10111', '0010101', '1111']",1,4,9,12,2,21,3.334343434343434,17,18
"['111101', '00', '1011011', '01110']",1,4,7,13,0,20,3.429043179043179,20,9
"['101011', '010', '10011']",1,3,6,8,0,14,2.0757575757575757,7,7
"['00', '100000', '0110010', '01110', '011000']",1,5,17,9,2,26,6.145243645243645,31,47
"['01', '0011101', '100001', '1110011', '110011', '10', '000000', '0100']",1,8,22,18,7,40,14.242912642912643,102,70
"['0', '0111001', '100', '1010101', '010111']",1,5,11,13,2,24,5.029059829059829,39,21
"['110011', '010', '11101', '0']",1,4,6,9,0,15,2.790764790764791,20,10
"['111', '101', '10101', '00', '001110']",1,5,8,11,2,19,5.1128427128427125,27,22
"['011001', '011', '101', '10000', '010111', '100101', '0000', '110']",1,8,19,17,6,36,15.365728715728714,82,75
"['1110', '0001', '01100', '101101']",1,4,9,10,2,19,3.2883838383838384,16,12
"['110000', '0010', '011', '11', '0101101', '100', '00110', '01010', '00010']",1,9,23,17,5,40,21.47993672993673,97,108
"['01', '1010', '01111']",1,3,4,7,0,11,1.6825396825396823,8,7
"['0', '1000100', '10100', '0111100']",1,4,12,8,2,20,2.761904761904762,25,22
"['101000', '1101', '1']",1,3,5,6,0,11,1.2857142857142856,11,8
"['110111', '1011111', '11']",1,3,2,13,0,15,1.7136752136752138,11,21
"['11011', '00110', '10100', '1010', '000']",1,5,12,10,3,22,5.893650793650793,23,27
"['011111', '1', '0110']",1,3,3,8,0,11,1.2857142857142856,11,6
"['101100', '11', '100', '0101010', '010111', '01011']",1,6,13,16,2,29,9.301809301809302,46,46
"['0011101', '11011', '0011', '1111', '1100', '01110']",1,6,10,19,5,29,9.822222222222223,38,48
"['10000', '10010', '10', '1011']",1,4,9,7,2,16,3.7206349206349207,14,20
"['11011', '0101', '1100', '000']",1,4,8,8,2,16,3.2261904761904763,14,15
"['0010', '11011', '0001', '111110', '000', '111001']",1,6,13,15,4,28,8.009235209235209,46,42
"['0011001', '010', '11']",1,3,6,6,0,12,1.4444444444444444,11,4
"['1101001', '11001', '100', '1000111', '0001100', '110']",1,6,16,16,5,32,9.59047619047619,50,47
"['00100', '1', '10', '00000']",1,4,10,3,2,13,2.657142857142857,18,14
"['110110', '111', '001000', '100', '1000011']",1,5,13,12,4,25,5.286324786324786,36,27
"['101100', '1', '100101', '100111', '000000']",1,5,14,11,4,25,4.023809523809524,37,27
"['1101', '11101', '101001']",1,3,5,10,0,15,2.0343434343434343,5,18
"['100100', '111110', '0000', '1100', '1110']",1,5,12,12,5,24,5.233333333333333,26,33
"['00011', '11100', '011', '1111']",1,4,6,11,2,17,3.3325396825396822,17,25
"['001100', '00100', '000100']",1,3,13,4,2,17,2.6515151515151514,3,30
"['00', '100', '110101']",1,3,6,5,0,11,1.9666666666666668,8,6
"['11001', '0001010', '010', '11']",1,4,9,8,0,17,3.015873015873016,21,12
"['000110', '0110010', '01001']",1,3,11,7,0,18,2.175990675990676,8,10
"['01', '111', '11100', '001110', '000', '01010', '0000110']",1,7,17,14,4,31,11.425363525363526,66,66
"['1000110', '110101', '1000', '00001']",1,4,13,9,0,22,3.4857808857808856,18,18
"['11', '001000', '101101', '1101000', '1101110', '100010', '1001100']",1,7,21,20,6,41,12.427655677655677,67,60
"['01', '100', '1100']",1,3,5,4,0,9,1.5904761904761904,6,8
"['101', '001110', '11']",1,3,4,7,0,11,1.7444444444444445,9,4
"['100000', '001010', '0111']",1,3,10,6,2,16,1.3,11,7
"['1', '010111', '00001']",1,3,6,6,0,12,0.9826839826839826,12,6
"['0011', '10101', '100', '10']",1,4,7,7,0,14,3.6928571428571426,14,16
"['101011', '01', '100', '1111']",1,4,5,10,0,15,2.585714285714286,17,17
"['0', '0011', '0010010']",1,3,8,4,0,12,1.3772727272727274,12,10
"['0101', '110', '111', '10011']",1,4,5,10,2,15,3.4761904761904763,13,19
"['11001', '0001001', '0011111']",1,3,9,10,2,19,1.7380952380952381,10,11
"['11110', '001', '0110', '0000']",1,4,9,7,2,16,2.7817460317460316,16,18
"['01', '001', '101', '0011111', '011110']",1,5,8,13,2,21,5.86923076923077,31,24
"['0', '110001', '000101', '1111']",1,4,8,9,2,17,2.238095238095238,24,13
"['0110101', '01', '11110', '101000', '10010', '10']",1,6,13,14,4,27,7.6618492618492615,50,38
"['0', '1110101', '01010']",1,3,6,7,0,13,1.25,13,4
"['11011', '1', '000']",1,3,4,5,0,9,0.5833333333333333,11,4
"['00111', '10010', '011']",1,3,6,7,2,13,1.85,8,7
"['001', '11100', '000010']",1,3,9,5,0,14,1.5303030303030303,11,9
"['000110', '01', '00010', '11']",1,4,9,6,2,15,3.266233766233766,17,14
"['0011100', '011', '011110', '0100']",1,4,10,10,0,20,3.9345987345987345,17,25
"['0110000', '01', '110', '01011']",1,4,9,8,0,17,3.015873015873016,21,16
"['1010111', '0000101', '10101', '10']",1,4,10,11,2,21,3.5317460317460316,21,23
"['1111', '010101', '10', '0111', '0100001']",1,5,10,13,2,23,5.439432789432789,32,29
"['00', '1', '001110']",1,3,5,4,0,9,0.7857142857142857,11,6
"['0', '001', '100111', '1000111']",1,4,8,9,0,17,3.2254578754578755,21,16
"['0', '0011', '0111101', '100011']",1,4,8,10,0,18,2.742707292707293,25,13
"['0', '01011', '1000010', '11']",1,4,8,7,0,15,2.0992063492063493,24,12
"['0', '1000', '1111101', '011101']",1,4,7,11,0,18,2.4685814185814188,25,14
"['0001001', '0101000', '10']",1,3,11,5,2,16,1.6031746031746033,12,8
"['01101', '11010', '1001', '110']",1,4,7,10,2,17,3.9825396825396826,12,16
"['111100', '100', '10110', '00', '000010', '01011', '01100']",1,7,18,14,5,32,12.24963924963925,61,70
"['0010', '001', '0000', '110', '001011']",1,5,13,7,4,20,5.88015873015873,24,37
"['0000111', '010', '1100', '1110']",1,4,9,9,2,18,3.201948051948052,20,18
"['0111000', '100110', '0100111', '000000']",1,4,16,10,4,26,3.2252747252747254,21,19
"['101', '100000', '00101']",1,3,9,5,0,14,1.558080808080808,9,10
"['01', '00101', '1010', '11101', '1011000', '1101', '000111']",1,7,15,18,4,33,12.833183483183483,63,64
"['101', '1110100', '11']",1,3,4,8,0,12,1.8444444444444446,10,10
"['1000110', '10010', '1011111']",1,3,8,11,2,19,1.9047619047619047,9,11
"['011111', '0111010', '010010', '0000']",1,4,12,11,2,23,3.076223776223776,18,25
"['01', '110100', '1001101']",1,3,7,8,0,15,1.5598290598290598,12,7
"['110110', '100', '1011000', '111011']",1,4,9,13,2,22,3.9290598290598293,19,16
"['0011110', '000100', '10', '001101']",1,4,12,9,2,21,3.4957264957264957,20,22
"['101100', '111100', '111', '1001', '01110']",1,5,9,15,2,24,6.364862914862915,26,26
"['10111', '00100', '111', '1110']",1,4,6,11,2,17,3.3682539682539683,15,20
"['10', '10000', '1110', '0100']",1,4,9,6,2,15,3.515873015873016,14,15
"['00010', '0101', '110']",1,3,7,5,0,12,1.7380952380952381,7,7
"['001111', '1', '1000', '1101', '0101']",1,5,8,11,3,19,4.635714285714286,31,26
"['00111', '01', '00001', '11']",1,4,7,7,4,14,3.0999999999999996,16,16
"['0', '10100', '011']",1,3,5,4,0,9,1.3333333333333333,9,6
"['01', '100001', '11', '10100', '00']",1,5,10,7,3,17,4.759740259740259,27,22
"['0101101', '00', '1101111', '101110']",1,4,8,14,2,22,3.4194139194139197,22,10
"['11001', '011', '111', '011100', '0001', '01001']",1,6,12,14,4,26,9.567243867243867,36,45
"['0101000', '001', '1110000']",1,3,11,6,2,17,1.5142857142857142,12,10
"['0101010', '00', '011110']",1,3,8,7,0,15,1.5598290598290598,11,14
"['1111', '001', '10', '110101']",1,4,5,10,0,15,2.7634920634920634,17,17
"['1111100', '11000', '1001', '110111', '000000']",1,5,14,14,2,28,4.905594405594406,36,32
"['11011', '0011', '0110', '011110', '1101', '0101']",1,6,10,17,4,27,10.284343434343434,34,42
"['01', '00100', '101', '1110011', '0001111', '111011', '011001', '01110']",1,8,17,24,6,41,16.46937506937507,92,74
"['0001', '011', '10011', '111101']",1,4,7,11,0,18,3.377994227994228,17,19
"['0011101', '00011', '11000', '100010', '0111', '1110']",1,6,15,16,4,31,9.063364413364413,46,42
"['101', '00', '0111']",1,3,4,5,0,9,1.3047619047619048,7,4
"['0101111', '101', '0001111', '0000', '110']",1,5,11,13,4,24,4.804329004329004,37,28
"['0', '1001', '1111010', '11101', '010110', '11111', '011010']",1,7,12,22,4,34,11.292912642912643,66,56
"['01', '11010', '0001', '10010', '110']",1,5,10,9,2,19,5.656349206349207,23,27
"['01', '00101', '011011', '0001000', '00110', '001110', '111000', '101110', '01100']",1,9,26,22,7,48,22.426212676212675,106,126
"['101100', '1000', '100010', '1101110']",1,4,12,11,2,23,3.8300699300699304,16,19
"['0110111', '111010', '00111', '01111', '00', '10010', '10', '001100']",1,8,17,21,7,38,15.475935175935176,91,88
"['0110111', '111', '011000', '00', '10', '1011111']",1,6,10,17,4,27,6.891208791208792,56,42
"['01101', '1001', '10000', '0001100', '111101']",1,5,14,13,2,27,5.375679875679875,31,28
"['110000', '11011', '111010', '101', '111111', '00', '01100']",1,7,13,20,5,33,11.147546897546897,66,59
"['0', '010001', '1110', '11']",1,4,6,7,0,13,2.2523809523809524,20,12
"['011', '1', '01011', '0000']",1,4,7,6,0,13,2.3134920634920633,18,13
"['1000001', '00101', '11000', '10001', '101', '01010']",1,6,18,12,4,30,9.85,40,45
"['0010', '0101110', '10']",1,3,7,6,0,13,1.6565656565656566,10,11
"['0111000', '111100', '01011', '1111']",1,4,8,14,0,22,3.422766122766123,18,21
"['01', '1', '00000', '01000', '1100', '101001']",1,6,15,8,2,23,6.978210678210678,45,35
"['1111100', '000110', '010100', '0110', '0111', '01110']",1,6,15,17,4,32,9.950155400155401,37,65
"['11110', '101', '00110', '10', '011111']",1,5,7,14,2,21,5.51002886002886,29,26
"['110', '111', '0011', '0000', '1100', '0100']",1,6,12,10,6,22,7.6309523809523805,34,48
"['011', '111010', '00100', '000101', '1111', '10']",1,6,12,14,2,26,7.682251082251082,47,38
"['11101', '100011', '10000', '0100100']",1,4,13,10,2,23,3.4396270396270396,18,15
"['00111', '101', '0001000', '11']",1,4,9,8,0,17,2.9936507936507937,22,14
"['01101', '10110', '000', '010011', '110', '001011']",1,6,14,14,6,28,9.012121212121212,40,39
"['01', '0111011', '10111', '1001', '10110']",1,5,8,15,2,23,6.084271284271284,29,30
"['0100010', '001010', '0110100', '1']",1,4,13,8,2,21,2.741758241758242,24,16
"['110000', '110110', '001111', '010111', '0110010']",1,5,14,17,4,31,5.641025641025641,31,31
"['0101101', '1', '111100']",1,3,5,9,0,14,1.151098901098901,14,6
"['01101', '111100', '111', '1000111', '11100']",1,5,9,17,2,26,6.449417249417249,31,44
"['011001', '1', '0000', '01001', '110']",1,5,11,8,0,19,4.3249639249639245,30,22
"['1100', '110', '00001']",1,3,7,5,0,12,1.5515873015873014,8,9
"['1', '0011', '1000110', '01111', '001010', '001001']",1,6,15,14,2,29,8.357559107559108,51,37
"['0010', '101000', '10101', '1111', '000']",1,5,12,10,2,22,5.334415584415584,27,26
"['1000010', '0011', '00', '101101']",1,4,11,8,0,19,3.371950271950272,21,13
"['110110', '000110', '001', '0101101', '100', '000']",1,6,16,12,5,28,9.138461538461538,43,47
"['00100', '0011110', '110', '010111']",1,4,10,11,0,21,3.525796425796426,20,20
"['01', '111010', '011', '1001000', '000']",1,5,12,9,2,21,4.982051282051282,34,26
"['1010', '100101', '10011', '1']",1,4,7,9,0,16,3.1948051948051948,17,23
"['01001', '010001', '110']",1,3,8,6,0,14,1.8535353535353534,8,11
"['1000011', '00', '0000011']",1,3,11,5,2,16,1.746031746031746,11,11
"['010000', '0100010', '1111', '11100', '101001']",1,5,15,13,2,28,5.962004662004662,31,25
"['11011', '011010', '1100', '00000']",1,4,11,9,2,20,3.3838383838383836,16,15
"['000110', '100', '110100']",1,3,9,6,2,15,1.6111111111111112,10,10
"['10111', '101100', '0010000']",1,3,10,8,0,18,1.675990675990676,10,9
"['010', '111000', '0111']",1,3,6,7,0,13,1.615873015873016,10,9
"['00111', '00100', '10111']",1,3,7,8,3,15,1.8,6,10
"['1001', '100000', '0010100', '11']",1,4,12,7,0,19,2.968104118104118,22,14
"['11010', '0101111', '00', '010']",1,4,8,9,0,17,3.6658730158730157,19,19
"['11011', '00101', '0111', '1100110', '0100']",1,5,11,14,4,25,6.135353535353535,28,26
"['1011110', '01', '01000', '11']",1,4,7,9,2,16,2.746031746031746,22,11
"['011', '00111', '1000111', '100111', '1011']",1,5,9,16,0,25,7.733250083250083,21,50
"['0', '101011', '001', '011111']",1,4,6,10,2,16,2.4603174603174605,22,11
"['0', '1110010', '0010000', '1010', '0001011']",1,5,16,10,3,26,4.682467532467532,44,28
"['01', '011', '111', '00', '001100', '1001111']",1,6,10,13,4,23,7.582051282051282,46,38
"['11001', '1000', '110']",1,3,6,6,0,12,1.9880952380952381,6,8
"['001', '101101', '001010', '1011', '111101']",1,5,10,15,3,25,6.1269841269841265,28,31
"['0', '11001', '010000', '010001', '0101000', '011100', '110101', '011000']",1,8,26,17,5,43,17.32775557775558,79,90
"['1100111', '110', '1', '10000']",1,4,7,9,0,16,2.683333333333333,23,17
"['0', '00111', '101', '0001', '0100011', '0111110']",1,6,13,14,2,27,7.324242424242424,55,32
"['0', '00110', '0101']",1,3,6,4,0,10,1.4,10,8
"['11110', '00010', '0000110', '0000000']",1,4,17,7,4,24,3.280952380952381,20,34
"['0010110', '011', '100', '1111', '1000', '10011']",1,6,12,14,4,26,7.77020202020202,42,43
"['0001', '100', '0010100', '0010011', '1000', '001001']",1,6,21,10,4,31,9.833649683649684,40,64
"['00111', '10', '011000']",1,3,7,6,0,13,1.331168831168831,12,7
"['11001', '0010010', '00111', '100']",1,4,11,9,2,20,3.783333333333333,20,15
"['0101110', '1', '10111', '0011010', '000']",1,5,11,12,2,23,4.045238095238095,38,19
"['100', '0110', '111111', '1011', '101110']",1,5,7,16,4,23,5.681746031746032,27,27
"['111111', '10', '1101100']",1,3,4,11,0,15,1.3098290598290598,13,8
"['010', '111', '1110000', '0101011', '1010', '1110110', '11100']",1,7,15,21,5,36,12.75952380952381,65,74
"['100110', '0010010', '001', '1']",1,4,10,7,0,17,3.0716117216117214,23,13
"['01', '110010', '0011', '0011110', '10', '0010010']",1,6,15,13,4,28,8.277378177378177,52,49
"['0001', '10101', '110', '101110']",1,4,8,10,0,18,3.024098124098124,16,17
"['00010', '0101011', '1', '0010']",1,4,10,7,0,17,2.9176767676767676,20,14
"['101', '00', '001110', '001010', '110']",1,5,11,9,4,20,5.522222222222222,28,30
"['00011', '101010', '1010000', '010011', '0100']",1,5,17,11,2,28,6.777544677544678,26,33
"['0', '01101', '010000']",1,3,8,4,0,12,1.1645021645021645,12,9
"['000110', '0010', '010', '1011']",1,4,10,7,2,17,3.9952380952380953,13,17
"['010', '0010101', '00', '110', '0100']",1,5,12,7,2,19,6.133621933621933,25,34
"['1001110', '00100', '0100100', '01011', '110101']",1,5,16,14,4,30,6.330602730602731,29,26
"['010', '10', '111']",1,3,3,5,2,8,1.5333333333333334,5,5
"['01111', '010001', '1', '111100']",1,4,7,11,2,18,2.6774891774891776,24,16
"['0000010', '0001110', '10', '110101']",1,4,13,9,2,22,3.026251526251526,24,15
"['110', '0100110', '010111', '000000', '1100']",1,5,15,11,2,26,5.033366633366633,35,32
"['1', '111010', '0000100', '01010', '1110', '111001']",1,6,14,15,2,29,7.476828726828727,54,40
"['1010110', '1110010', '011', '1001010', '1111000', '00']",1,6,16,17,4,33,8.177777777777777,56,41
"['0010', '01101', '00101', '0001', '10110', '1110101', '10100', '101110']",1,8,20,21,6,41,17.93912198912199,69,83
"['0001101', '1101', '0100100', '11']",1,4,10,10,2,20,3.5425685425685423,22,16
"['0011', '01010', '11']",1,3,5,6,0,11,1.9047619047619047,7,6
"['1010', '00', '000111', '11']",1,4,7,7,2,14,2.7333333333333334,18,14
"['010', '111010', '011', '01111', '1100100', '1011', '101111', '01110', '1110']",1,9,15,28,8,43,22.92997557997558,94,121
"['110010', '0011101', '1', '000101']",1,4,10,10,2,20,2.8727106227106227,25,15
"['0010000', '00', '1000', '101110', '101111']",1,5,14,11,2,25,5.190947940947941,36,33
"['0110111', '1', '0001000']",1,3,8,7,2,15,0.9285714285714286,17,4
"['1', '001010', '111001']",1,3,6,7,2,13,1.0714285714285714,14,4
"['110010', '0101111', '1101011', '0000', '01001', '0111110']",1,6,16,20,3,36,8.245410145410146,49,39
"['11001', '111', '100', '1011', '010011', '0110110']",1,6,11,17,2,28,9.114496614496614,37,42
"['100', '1', '101110']",1,3,4,6,0,10,1.4523809523809523,10,7
"['0010', '0111010', '1', '10111', '11000', '10000']",1,6,14,13,3,27,7.588383838383838,51,34
"['0001011', '01', '111110', '001']",1,4,8,10,0,18,2.6243589743589744,25,15
"['0100010', '100', '000011', '11']",1,4,11,7,0,18,3.158119658119658,21,13
"['0011001', '01001', '110', '001000']",1,4,13,8,0,21,3.8742812742812744,17,18
"['0111001', '111010', '01111', '110011', '00', '0000010', '1001111']",1,7,18,22,5,40,12.118881118881118,77,59
"['0100000', '0110100', '1101000', '1001', '00', '001110']",1,6,21,12,3,33,8.571528471528472,54,50
"['1000011', '00', '1100110', '0100']",1,4,12,8,2,20,3.3607503607503606,23,13
"['0', '10111', '1111']",1,3,2,8,0,10,1.0,9,8
"['00101', '0010000', '00011', '0110', '0110000', '0100']",1,6,22,10,6,32,9.745526695526696,42,68
"['01', '1000110', '1110101', '00', '1010']",1,5,11,11,4,22,5.637085137085137,35,21
"['1001', '001', '0011010']",1,3,8,6,0,14,2.0025974025974023,9,8
"['101', '0101000', '001000']",1,3,11,5,0,16,1.9675213675213676,9,9
"['111', '0001', '1101', '01010', '00010']",1,5,11,10,4,21,5.437301587301587,22,24
"['1110010', '00111', '1111', '00', '0101100', '011001', '011111', '1100']",1,8,17,24,6,41,16.06928071928072,91,94
"['1011010', '100', '1111110', '1000', '01010']",1,5,12,14,2,26,6.102813852813853,30,30
"['110', '111', '001000']",1,3,6,6,2,12,1.3333333333333333,10,6
"['0011000', '10110', '10', '001001', '0000110']",1,5,17,10,2,27,5.938006438006438,35,35
"['0', '111', '1101110', '1000', '111101']",1,5,7,14,0,21,4.048934398934399,38,25
"['00', '1111000', '11']",1,3,5,6,2,11,0.8888888888888888,12,8
"['1110010', '001000', '0001', '1111010', '00']",1,5,15,11,2,26,5.4987123987123985,36,35
"['0011000', '011101', '1000', '1011100', '1100']",1,5,15,13,4,28,6.576173826173826,27,34
"['01', '0001', '10', '110111']",1,4,6,8,2,14,2.9,19,13
"['1010110', '1000', '10110']",1,3,8,8,0,16,2.2272727272727275,7,14
"['0', '1001', '011001']",1,3,6,5,0,11,1.4857142857142858,10,7
"['001111', '10100', '111110', '10010', '01011']",1,5,11,16,5,27,5.393939393939394,30,28
"['1001001', '0010010', '11']",1,3,9,7,2,16,1.746031746031746,12,4
"['100101', '1010101', '1', '01100']",1,4,9,10,0,19,2.6837329337329336,22,16
"['00110', '0101', '001010', '1000111']",1,4,12,10,0,22,4.203263403263403,17,13
"['1101001', '0110100', '1110']",1,3,8,10,2,18,1.948051948051948,8,5
"['01', '1110010', '100', '111111', '1110001', '000100']",1,6,14,17,4,31,7.613125763125763,59,44
"['101100', '11110', '100', '00110', '10', '110111']",1,6,11,16,4,27,8.866089466089466,42,42
"['010011', '1', '00101']",1,3,6,6,0,12,1.3463203463203464,12,6
"['0001011', '0000111', '1110']",1,3,9,9,2,18,1.7662337662337662,12,12
"['1111000', '0100', '11111']",1,3,6,10,0,16,1.4343434343434343,11,11
"['0011', '110001', '1']",1,3,5,6,0,11,1.2857142857142856,11,9
"['110000', '001', '101', '000000', '00010']",1,5,17,6,4,23,5.593434343434343,30,35
"['111000', '100', '0010100']",1,3,10,6,0,16,1.882051282051282,10,12
"['1011', '0000001', '0110110', '11']",1,4,10,10,2,20,2.70995670995671,26,12
"['010010', '01', '10000', '11111']",1,4,9,9,2,18,2.362337662337662,22,11
"['11110', '0010', '000011', '10', '000']",1,5,12,8,0,20,5.06998556998557,31,33
"['10001', '1111', '00', '1001100', '1011']",1,5,10,12,2,22,4.717893217893217,31,28
"['001', '1', '00101', '001000', '1000', '0000']",1,6,17,6,2,23,8.289177489177488,39,58
"['001010', '1001011', '11']",1,3,7,8,0,15,1.7136752136752138,11,6
"['110110', '1101', '010', '000000']",1,4,11,8,2,19,2.7936507936507935,20,14
"['1', '11100', '000']",1,3,5,4,0,9,0.8333333333333333,10,6
"['101', '0101111', '1001011']",1,3,6,11,2,17,1.9142857142857141,11,10
"['0001001', '010', '1101111', '11', '001110', '000000', '1101']",1,7,18,17,4,35,10.111421911421912,79,55
"['0010', '11011', '011', '00111', '1111', '0111', '01100']",1,7,11,19,6,30,13.327777777777778,44,74
"['110110', '000', '11']",1,3,5,6,0,11,0.9444444444444444,11,6
"['001', '10010', '0110111']",1,3,7,8,0,15,1.65,10,6
"['1', '001101', '1000', '011111', '01000']",1,5,11,11,2,22,4.569408369408369,36,24
"['01', '10010', '0100']",1,3,7,4,0,11,1.9047619047619047,8,7
"['001', '0011', '0110', '101110', '1111011']",1,5,9,15,2,24,6.129309579309579,30,25
"['1101', '0001', '0001000']",1,3,10,5,2,15,1.5909090909090908,10,10
"['101011', '01', '111000', '00010']",1,4,10,9,2,19,2.912337662337662,22,13
"['000110', '1000', '011', '1011111']",1,4,9,11,0,20,2.9775557775557777,22,14
"['011', '1110000', '10100', '0111', '01001', '1100']",1,6,14,14,4,28,9.484632034632034,42,45
"['101011', '1110110', '10101', '11']",1,4,6,14,0,20,3.8608613608613607,18,27
"['011', '10111', '101', '00', '10010']",1,5,8,10,4,18,5.673809523809524,24,23
"['010', '11000', '0010011', '00110', '10', '011000']",1,6,17,11,2,28,9.422383172383173,46,51
"['0101111', '110111', '110101']",1,3,5,14,2,19,2.217948717948718,6,16
"['11000', '101000', '1111']",1,3,7,8,0,15,1.7535353535353535,8,11
"['0010', '0111001', '0101110', '11', '1101', '00', '01001']",1,7,15,16,6,31,11.331890331890332,68,52
"['110', '111', '0100']",1,3,4,6,2,10,1.5238095238095237,6,6
"['0011011', '11000', '0010']",1,3,9,7,0,16,1.6717171717171717,10,11
"['001', '111', '101000', '0110', '10000', '01010', '111101']",1,7,16,16,6,32,11.023160173160173,59,50
"['00001', '00', '1001', '011000']",1,4,12,5,0,17,3.55021645021645,17,18
"['0', '0010', '111100', '111010', '100100']",1,5,12,11,3,23,5.057142857142857,34,30
"['0110101', '1000101', '0101101', '0011001', '1011100', '10', '0000110']",1,7,23,21,6,44,12.809523809523808,75,58
"['111', '10101', '1100100', '0000', '011010']",1,5,13,12,0,25,5.951554001554001,31,20
"['0', '011', '0111011']",1,3,4,7,0,11,1.35,12,10
"['011111', '101001', '111011']",1,3,5,13,3,18,1.6666666666666665,8,11
"['01', '1', '0011010']",1,3,5,5,0,10,1.3611111111111112,12,4
"['011100', '11', '00111', '00', '0111111', '0101']",1,6,10,16,2,26,7.964302364302364,49,44
"['0', '10000', '10011', '1011', '1101']",1,5,9,10,4,19,5.261111111111111,27,28
"['000011', '010', '1', '0100100']",1,4,11,6,0,17,2.6955433455433457,24,13
"['11010', '010', '110', '11100', '01100']",1,5,10,11,5,21,7.316666666666666,19,34
"['0000111', '111111', '111000', '001']",1,4,9,13,2,22,2.68974358974359,26,26
"['001', '111', '100', '11101', '110']",1,5,6,11,4,17,5.5,21,31
"['1010111', '110110', '010', '11101']",1,4,7,14,0,21,3.540947940947941,18,15
"['0', '001110', '01010']",1,3,7,5,0,12,1.3463203463203464,11,13
"['0', '101011', '001', '001100']",1,4,9,7,2,16,2.849206349206349,22,13
"['0', '1100', '10', '1110']",1,4,5,6,2,11,3.55,12,14
"['1000100', '101100', '10']",1,3,9,6,0,15,1.4059829059829059,11,11
"['1001', '010110', '110100', '111']",1,4,8,11,2,19,3.549206349206349,16,12
"['11000', '00', '1110']",1,3,6,5,0,11,1.5714285714285714,8,9
"['001101', '10101', '100100', '10110', '00', '0111111', '1010']",1,7,16,19,4,35,12.69017649017649,63,58
"['01', '10011', '1001010']",1,3,7,7,0,14,1.8492063492063493,10,9
"['1011', '0001', '10011']",1,3,6,7,2,13,2.0555555555555554,5,11
"['0010', '001', '101000', '110100', '000111', '101110']",1,6,17,14,4,31,8.923809523809524,47,46
"['1100011', '1010', '0010010', '01010']",1,4,13,10,2,23,3.8845598845598843,18,17
"['101100', '011', '101010', '01110', '110', '01100']",1,6,13,15,6,28,10.28989898989899,33,49
"['00111', '01', '001010', '1101']",1,4,8,9,0,17,3.50981240981241,17,14
"['1', '110100', '11101', '1100', '0110001']",1,5,10,13,0,23,5.626157176157176,33,29
"['0101', '10', '1110']",1,3,4,6,2,10,1.8333333333333333,7,7
"['01', '101', '10100']",1,3,5,5,0,10,2.1214285714285714,6,9
"['000111', '0111', '1001']",1,3,6,8,2,14,1.9,8,9
"['00111', '0011', '111']",1,3,4,8,0,12,2.2103174603174605,5,16
"['11110', '10110', '111011']",1,3,4,12,2,16,2.254545454545455,6,11
"['0101', '1', '0110011']",1,3,5,7,0,12,1.3772727272727274,12,7
"['00110', '10100', '00', '11']",1,4,8,6,4,14,2.6857142857142855,16,15
"['0001100', '001', '10110']",1,3,9,6,0,15,1.7666666666666666,10,8
"['11001', '010', '10']",1,3,5,5,0,10,1.8714285714285714,7,5
"['0001001', '11110', '001', '111010', '000011', '011', '000101', '10010']",1,8,22,19,7,41,16.097280497280497,86,83
"['11011', '10010', '001011', '1110']",1,4,8,12,2,20,3.5656565656565657,15,20
"['111', '00100', '1110011', '110100', '100000', '110111', '1011100', '1101']",1,8,19,25,5,44,15.981801531801532,86,110
"['0110101', '1100010', '11000', '1010', '011111']",1,5,13,16,2,29,6.32990342990343,31,30
"['100', '110', '101101']",1,3,5,7,2,12,2.0,7,7
"['01', '1101', '0100011', '0000']",1,4,10,7,2,17,2.6035353535353534,20,13
"['11', '101010', '100101', '0000', '110']",1,5,11,10,2,21,5.007936507936508,30,22
"['00111', '010', '1101110', '11']",1,4,6,11,0,17,3.1825396825396823,20,16
"['0111', '1', '000']",1,3,4,4,0,8,0.6857142857142857,9,4
"['0', '11010', '010', '011101', '101110']",1,5,9,12,2,21,5.594155844155844,31,27
"['0001', '010', '110101']",1,3,7,6,0,13,1.638095238095238,8,5
"['1001101', '1111010', '011001', '1011', '001001', '110']",1,6,14,19,4,33,9.21057831057831,46,42
"['010', '1', '1001010', '00011', '10111', '00110']",1,6,13,13,3,26,8.1,46,33
"['00111', '0110000', '10001']",1,3,10,7,2,17,1.7666666666666666,11,5
"['101', '111000', '00000']",1,3,9,5,0,14,1.2398989898989898,11,8
"['0', '01111', '010111', '111101', '011000']",1,5,9,15,3,24,4.690476190476191,35,29
"['10111', '001', '1']",1,3,3,6,0,9,1.3333333333333333,9,8
"['0100001', '000111', '10', '01110']",1,4,11,9,0,20,3.1085303585303583,23,14
"['001', '0110', '011', '1101100']",1,4,8,9,2,17,3.8225108225108224,16,16
"['11011', '111100', '110111', '0101', '01100']",1,5,9,17,4,26,6.16060606060606,27,34
"['001', '100111', '011', '10']",1,4,6,8,2,14,3.3,15,14
"['001', '10', '000001', '0111', '1100']",1,5,11,8,2,19,4.7595238095238095,31,26
"['1000100', '1010110', '11011', '0011000', '0011110', '1000', '0101']",1,7,22,19,6,41,13.035353535353535,68,60
"['0', '1000100', '11010']",1,3,8,5,0,13,1.25,13,6
"['11001', '100', '111', '0111']",1,4,5,10,2,15,3.642857142857143,13,21
"['010011', '011', '1110', '11']",1,4,5,10,0,15,3.604761904761905,16,23
"['100', '1111000', '1111']",1,3,5,9,0,14,1.612987012987013,10,13
"['1010110', '111', '0110', '10011', '0000']",1,5,11,12,2,23,5.188600288600289,29,22
"['01', '111', '00111', '100110', '000010']",1,5,11,11,2,22,5.327489177489177,30,24
"['1', '0011', '10010', '010110', '000000', '00010', '001001']",1,7,22,11,5,33,11.422943722943723,63,59
"['1011101', '001', '0111', '0000']",1,4,9,9,2,18,2.8837662337662335,19,13
"['1101', '010', '110111', '0010101']",1,4,8,12,0,20,3.5767121767121766,18,16
"['00', '010', '0100101']",1,3,8,4,0,12,1.8444444444444446,10,10
"['110000', '101', '10100', '000']",1,4,11,6,2,17,3.4217171717171717,15,19
"['1101001', '00000', '11']",1,3,8,6,0,14,0.7777777777777777,14,6
"['10000', '010001', '110001']",1,3,11,6,2,17,2.287878787878788,5,10
"['1000', '111010', '1010011']",1,3,8,9,0,17,1.760839160839161,9,8
"['0', '1011111', '111001']",1,3,4,10,0,14,1.151098901098901,14,6
"['0100010', '1', '010010']",1,3,9,5,0,14,1.458791208791209,12,10
"['0', '110', '0101110', '100010']",1,4,9,8,0,17,2.5416971916971915,23,18
"['0011', '1000', '1', '00001']",1,4,9,5,2,14,2.966666666666667,17,16
"['00101', '111010', '01000', '00000']",1,4,14,7,3,21,3.2545454545454544,16,21
"['100', '11011', '1', '000']",1,4,6,6,2,12,2.25,17,12
"['01101', '11', '100010', '011111', '111000', '1100', '0100101']",1,7,16,20,3,36,12.346176046176046,70,59
"['0110100', '011100', '111110', '000', '0010010', '1010010', '110', '0100']",1,8,24,19,7,43,16.04115884115884,85,110
"['0101', '011', '0000']",1,3,7,4,2,11,1.6428571428571428,6,7
"['1', '000', '01110']",1,3,5,4,0,9,0.8333333333333333,10,4
"['0', '0101', '111010']",1,3,5,6,0,11,1.2857142857142856,11,6
"['0', '111000', '111110']",1,3,5,8,2,13,1.2380952380952381,12,8
"['1111', '01', '0110011']",1,3,4,9,0,13,1.505050505050505,11,9
"['101100', '11011', '00111', '011011', '010010', '0000000', '0000010', '000010', '011110', '0100101']",1,10,36,25,10,61,26.397202797202798,134,159
"['11010', '110', '111', '001000', '11100', '000100', '1100', '01011']",1,8,19,18,7,37,16.756854256854258,74,98
"['1110010', '010', '1111']",1,3,5,9,0,14,1.612987012987013,10,10
"['11001', '001', '111', '1010101', '01111', '1000', '1010000', '1011']",1,8,17,21,8,38,15.758225108225108,80,97
"['1000', '10', '11']",1,3,4,4,2,8,1.5,6,7
"['01', '001000', '11', '11000', '100000', '01001', '111001']",1,7,19,13,7,32,11.19848484848485,64,60
"['11011', '00000', '101011', '100', '1010', '1010011']",1,6,15,15,2,30,9.157997557997557,40,53
"['11100', '000000', '010011', '111000', '1100']",1,5,16,11,3,27,5.8404040404040405,29,42
"['00', '10010', '011', '11']",1,4,6,6,2,12,2.842857142857143,14,12
"['01', '100010', '111110', '1100', '111001']",1,5,10,14,3,24,5.25,33,26
"['0000', '0001', '0110101', '11']",1,4,10,7,2,17,2.436868686868687,20,15
"['00', '010', '1', '110001']",1,4,7,5,0,12,2.53015873015873,18,8
"['11001', '11110', '101', '1100011', '1110']",1,5,8,16,2,24,6.455772005772006,27,42
"['10100', '110', '100111']",1,3,6,8,0,14,1.4898989898989898,9,8
"['0', '0101111', '0100101', '1111']",1,4,7,12,2,19,2.344155844155844,25,18
"['01001', '111', '000011']",1,3,7,7,0,14,1.6717171717171717,9,8
"['0011', '01', '011', '0100']",1,4,7,6,2,13,4.061904761904762,11,18
"['11', '101000', '1101100', '1010', '11101']",1,5,10,14,0,24,6.357831057831058,29,31
"['101000', '0011', '11101', '00001']",1,4,11,9,2,20,3.002020202020202,18,18
"['110', '1000000', '0111', '0000110', '1110']",1,5,14,11,4,25,5.529220779220779,36,33
"['00100', '1', '1011111', '1101010']",1,4,8,12,2,20,2.4047619047619047,28,11
"['101', '001101', '0000']",1,3,8,5,0,13,1.5523809523809522,9,8
"['0011', '01', '1000']",1,3,6,4,2,10,1.5,8,7
"['0', '101100', '010111', '011111']",1,4,7,12,3,19,2.6904761904761902,23,15
"['11010', '1000101', '0010011', '00', '110']",1,5,13,11,2,24,5.291269841269841,36,25
"['00011', '1011110', '11000', '00', '10', '10011']",1,6,13,13,5,26,8.198412698412698,49,43
"['0', '0010001', '1110010', '11', '1010100']",1,5,13,11,3,24,4.083333333333333,45,21
"['100', '10', '100010']",1,3,7,4,0,11,1.9666666666666668,8,11
"['11', '00111', '1010100', '1101', '0011100']",1,5,11,14,2,25,5.543290043290043,33,32
"['01', '1', '0110100']",1,3,5,5,0,10,1.3611111111111112,12,5
"['11110', '10', '0100']",1,3,5,6,0,11,1.6825396825396823,8,7
"['0101110', '0011110', '00', '10', '110']",1,5,10,11,4,21,5.534920634920635,34,38
"['0010', '01010', '11']",1,3,6,5,0,11,1.5714285714285714,7,6
"['101100', '100111', '10', '0010000']",1,4,12,9,2,21,3.1880341880341883,24,15
"['101', '00', '1111000', '1011000']",1,4,10,9,2,19,3.146031746031746,22,20
"['01', '11', '10001', '1010', '10011', '1011', '1100']",1,7,11,15,7,26,13.474603174603175,45,73
"['00111', '10000', '0100', '00110', '10', '01110', '1110']",1,7,16,14,6,30,12.544444444444444,52,70
"['00010', '111100', '01010']",1,3,9,7,2,16,1.509090909090909,8,11
"['00', '1101101', '00101']",1,3,7,7,0,14,1.5158730158730158,11,8
"['111010', '100', '110100', '110011', '10']",1,5,10,13,3,23,6.466666666666667,29,30
"['01', '0001110', '0100', '1111', '00110', '1011', '00010', '0110011']",1,8,19,19,7,38,16.02835497835498,83,75
"['01', '10101', '111100', '11']",1,4,5,10,2,15,2.938311688311688,19,17
"['1011', '11101', '00000']",1,3,7,7,2,14,1.0888888888888888,10,5
"['111', '00001', '0100010', '101', '0001', '100', '010111', '110']",1,8,18,16,4,34,14.731690531690532,78,74
"['0011', '01', '1011001', '1111000']",1,4,9,11,2,20,2.9567099567099566,24,15
"['010', '001111', '00000']",1,3,9,5,0,14,1.308080808080808,11,10
"['10100', '10000', '1111']",1,3,7,7,2,14,1.2666666666666666,8,8
"['11', '0010', '0100']",1,3,6,4,2,10,1.4166666666666665,8,5
"['0', '0011', '10001', '101', '100101', '100000']",1,6,15,10,2,25,8.406998556998557,43,45
"['110010', '011', '101101', '100', '0000', '011111', '00010', '0100']",1,8,20,17,7,37,15.095815295815296,83,79
"['010', '011', '00001', '01010', '0110010']",1,5,14,9,4,23,5.933333333333334,27,40
"['1', '100', '001110', '1100011', '101110']",1,5,10,13,2,23,4.942796092796093,38,24
"['01', '100', '000']",1,3,6,2,2,8,1.4666666666666668,5,8
"['0111000', '1010', '110101']",1,3,8,9,0,17,1.9608391608391609,10,4
"['01', '011', '10', '0101100']",1,4,7,7,2,14,3.188888888888889,19,15
"['00010', '0000011', '1111']",1,3,9,7,0,16,1.2525252525252526,12,8
"['011101', '010011', '110']",1,3,6,9,2,15,1.6111111111111112,10,8
"['1011011', '01', '1001']",1,3,5,8,0,13,1.8383838383838382,10,10
"['111100', '0000101', '10', '0100100', '0100011', '111101']",1,6,18,17,5,35,7.76007326007326,56,43
"['101', '01101', '100011', '001000']",1,4,11,9,2,20,3.6186868686868685,20,13
"['0', '0010011', '11']",1,3,5,5,0,10,0.6944444444444444,13,6
"['01', '101101', '000101', '0001000', '1110']",1,5,14,11,2,25,5.072183372183372,35,28
"['0010110', '100', '0101010', '1010', '1100111', '011010', '0100']",1,7,20,18,5,38,14.091991341991342,60,67
"['11', '101', '0111', '011001', '1001001']",1,5,9,13,0,22,6.21004551004551,29,36
"['010', '010000', '1111110']",1,3,8,8,0,16,1.3743589743589744,13,11
"['01', '1110', '0001111']",1,3,5,8,0,13,1.323232323232323,12,8
"['0101', '00', '10', '1100110', '1101', '001001']",1,6,13,12,4,25,8.76033411033411,45,37
"['0101', '01111', '000', '11']",1,4,6,8,0,14,2.7261904761904763,16,13
"['11010', '101011', '101', '1000000', '010111', '0000011', '100111']",1,7,20,20,5,40,12.492723942723943,69,73
"['0010', '100', '0011100', '0110001']",1,4,13,8,2,21,3.7584415584415583,20,21
"['001', '101101', '1001101', '0101100', '0000', '110']",1,6,16,14,4,30,8.217271617271617,47,38
"['0', '111', '00001']",1,3,5,4,0,9,0.5833333333333333,11,4
"['1110', '001001', '000', '111110']",1,4,9,10,2,19,2.707936507936508,22,19
"['11010', '001011', '111']",1,3,5,9,0,14,1.7398989898989898,8,11
"['11', '101010', '1111001', '1000', '100101', '001001', '110', '1101010']",1,8,19,22,5,41,17.134509934509936,87,89
"['0010', '000010', '11']",1,3,8,4,0,12,1.3833333333333333,10,8
"['011100', '100110', '1101', '0100101']",1,4,11,12,2,23,3.978554778554779,18,13
"['001', '1', '000011', '111110', '000010']",1,5,12,10,3,22,4.412698412698413,38,26
"['00001', '100', '1100', '011001']",1,4,11,7,0,18,3.9955266955266957,14,18
"['11001', '11110', '101011', '10110', '1101100']",1,5,10,18,3,28,6.223776223776224,24,33
"['1000100', '00101', '00001', '1011101', '0000']",1,5,18,10,4,28,5.984559884559884,28,36
"['11000', '0011110', '0000001', '10', '011010']",1,5,16,11,2,27,4.970862470862471,39,29
"['01', '11010', '111', '100', '1111110']",1,5,6,14,2,20,4.926984126984127,31,28
"['010', '00001', '00', '01001', '010011']",1,5,14,7,2,21,6.795887445887446,23,34
"['010', '1', '0111011', '00001', '11000', '00010']",1,6,15,11,3,26,7.433333333333334,52,38
"['0', '001', '101111']",1,3,4,6,0,10,1.2301587301587302,11,4
"['0', '00010', '0101001', '111001']",1,4,11,8,0,19,2.8503996003996,24,13
"['110000', '010', '011']",1,3,7,5,2,12,1.5555555555555554,10,8
"['1010000', '010001', '111']",1,3,9,7,0,16,1.6136752136752137,11,6
"['0101', '11110', '001', '1']",1,4,5,8,0,13,2.499206349206349,17,13
"['101100', '11010', '011', '1011100', '1011', '00010']",1,6,14,16,2,30,9.376179376179376,40,48
"['0001101', '0001', '010', '0110011']",1,4,12,9,2,21,3.9402597402597404,20,17
"['0', '0000001', '1100110']",1,3,10,5,2,15,0.9285714285714286,17,6
"['01', '0001', '0000011', '01010']",1,4,12,6,0,18,3.354256854256854,19,16
"['0', '010100', '0111', '1000010']",1,4,11,7,0,18,2.360889110889111,26,15
"['1011001', '11011', '001010']",1,3,8,10,0,18,1.8275058275058274,10,4
"['01', '010', '000']",1,3,6,2,2,8,1.8666666666666667,4,9
"['0001', '111', '1110']",1,3,4,7,2,11,1.3928571428571428,8,10
"['101', '1010010', '000']",1,3,8,5,2,13,1.5333333333333332,10,6
"['1110111', '01', '000']",1,3,5,7,0,12,1.0444444444444445,13,4
"['0', '0100000', '111']",1,3,7,4,0,11,0.45,15,4
"['01101', '0010111', '0011100']",1,3,9,10,2,19,2.0476190476190474,9,9
"['11110', '0100110', '00', '1100101', '0101']",1,5,12,13,2,25,5.621212121212121,34,26
"['1001100', '001', '1110', '0']",1,4,8,7,0,15,2.762987012987013,21,13
"['010100', '1000', '0010000']",1,3,13,4,0,17,2.0965034965034963,7,14
"['1010', '110', '01011', '11']",1,4,5,9,0,14,3.776190476190476,12,18
"['1011010', '0010111', '000001']",1,3,11,9,2,20,1.4835164835164836,11,7
"['001010', '111', '000']",1,3,7,5,2,12,1.1111111111111112,10,6
"['0010000', '11', '101', '0011', '1001100']",1,5,13,10,2,23,5.691774891774892,35,27
"['1100011', '100', '1', '0110110']",1,4,8,10,2,18,2.914285714285714,26,10
"['0011101', '111100', '0100101', '011111', '1101', '0110001']",1,6,15,22,5,37,9.540792540792541,44,50
"['11010', '11', '111011', '0001100', '00', '111001']",1,6,12,16,4,28,7.813214563214563,54,45
"['0100010', '01', '000']",1,3,9,3,0,12,1.4444444444444444,11,9
"['100', '100011', '111100']",1,3,7,8,2,15,1.8333333333333333,11,11
"['01', '1', '0010', '01000']",1,4,8,4,0,12,3.3047619047619046,15,12
"['0', '1000', '10011', '1101', '01110']",1,5,9,10,4,19,5.011111111111111,29,19
"['1010', '111010', '01010']",1,3,7,8,0,15,2.416161616161616,5,15
"['0', '0011', '0100110']",1,3,7,5,0,12,1.3772727272727274,12,8
"['0', '100', '01111']",1,3,4,5,0,9,1.0833333333333333,10,6
"['00110', '10110', '01010']",1,3,8,7,3,15,2.4000000000000004,5,13
"['110010', '10001', '1111', '100110', '1000', '1010', '011111', '1101']",1,8,16,23,7,39,17.21818181818182,70,91
"['11', '00', '0111010', '0100']",1,4,8,7,2,15,2.4343434343434343,20,15
"['1110010', '010101', '1', '01011']",1,4,8,11,0,19,2.7396769896769895,24,16
"['0', '11110', '0000111']",1,3,6,7,0,13,1.0833333333333333,15,8
"['0010', '001101', '111', '0001', '1111001', '00']",1,6,13,13,2,26,7.818320568320568,47,44
"['11', '1010', '0100']",1,3,5,5,2,10,1.75,7,4
"['110011', '11010', '1110', '11111']",1,4,5,15,2,20,3.987878787878788,12,31
"['0111000', '1101100', '0111', '11']",1,4,8,12,2,20,3.5425685425685423,22,19
"['01011', '0011', '10000', '11']",1,4,8,8,2,16,3.257142857142857,17,19
"['1010', '0100110', '1']",1,3,6,6,0,12,1.1954545454545453,12,5
"['01101', '01111', '111011', '00110', '10', '001001']",1,6,12,17,5,29,8.946753246753246,41,37
"['010011', '00', '111', '010']",1,4,7,7,2,14,2.7444444444444445,16,14
"['11', '101000', '110001', '0000', '01001', '1011111']",1,6,15,15,2,30,7.553091353091353,51,43
"['11000', '110', '011', '01110']",1,4,7,9,4,16,4.016666666666667,15,20
"['0000101', '1100001', '0010']",1,3,12,6,2,18,1.987012987012987,10,6
"['0010001', '1110011', '100', '110']",1,4,10,10,4,20,3.438095238095238,21,15
"['000110', '010000', '1', '00101', '0110011']",1,5,15,10,2,25,5.145437895437896,38,23
"['00000', '11', '10001', '10101', '00010']",1,5,14,8,4,22,5.428571428571429,27,22
"['00011', '00001', '101', '100', '0111']",1,5,11,9,4,20,5.434920634920635,24,27
"['101', '10001', '10', '0000', '1100']",1,5,11,7,2,18,5.811904761904762,22,24
"['00001', '00111', '11']",1,3,6,6,2,12,1.457142857142857,9,9
"['0', '100001', '0100110', '0111011', '101000', '1101110', '100010', '10010', '101111']",1,9,25,26,7,51,19.87887112887113,122,96
"['0011', '1', '1000111', '101101']",1,4,7,11,0,18,3.0322177822177823,23,20
"['101', '1011011', '11']",1,3,3,9,0,12,1.8444444444444446,10,16
"['0101', '010000', '111']",1,3,7,6,0,13,1.3936507936507936,10,6
"['010', '1', '10000', '11100', '0100']",1,5,11,7,2,18,5.357142857142857,26,24
"['01101', '011011', '100110', '00', '011111', '1100', '111101']",1,7,13,22,4,35,12.862337662337662,62,61
"['001', '11000', '0001', '0110', '101110']",1,5,12,10,2,22,5.951803751803752,28,28
"['111100', '11', '100110', '000010', '1111011']",1,5,11,16,3,27,5.053418803418803,39,31
"['101', '01001', '1001']",1,3,6,6,0,12,2.496031746031746,4,14
"['01111', '10', '110101']",1,3,4,9,0,13,1.331168831168831,11,7
"['111100', '101', '1001', '000101', '1000', '01110', '01000']",1,7,18,15,6,33,12.431096681096681,57,57
"['000110', '11', '101', '0001000', '100101', '01000']",1,6,18,11,2,29,8.476390276390276,50,40
"['10101', '001001', '00000']",1,3,11,5,2,16,1.8545454545454545,7,7
"['0', '0101101', '1010100', '10100', '1110100', '0100100']",1,6,19,15,4,34,8.476190476190476,51,58
"['1000', '10101', '1111000']",1,3,8,8,0,16,1.893939393939394,9,10
"['011111', '1', '1101010']",1,3,4,10,0,14,0.9972527472527473,15,7
"['01111', '110100', '10', '011001', '1100']",1,5,10,13,2,23,5.754401154401155,30,28
"['100110', '01', '100']",1,3,6,5,0,11,1.5666666666666667,9,8
"['1', '01110', '0000']",1,3,6,4,0,10,0.7777777777777777,11,4
"['101', '01', '000111']",1,3,5,6,0,11,1.7444444444444445,9,7
"['01011', '11110', '001011']",1,3,6,10,2,16,1.6727272727272728,8,12
"['0010', '1000101', '1101101', '1101', '0100']",1,5,13,13,5,26,6.1396103896103895,30,27
"['01', '0100101', '00011']",1,3,8,6,0,14,1.8492063492063493,10,8
"['0', '000011', '101101', '10101', '01000']",1,5,13,10,4,23,4.883549783549784,35,22
"['110010', '011', '00000', '00111', '10101', '10', '101001', '111001']",1,8,19,19,6,38,15.521139971139972,84,76
"['01', '111', '100', '100011', '000001', '0000010', '10', '1011']",1,8,19,14,6,33,14.094955044955045,88,78
"['010100', '1', '0001101', '110011', '010101']",1,5,13,13,3,26,5.11996336996337,38,25
"['1100', '1', '10000']",1,3,6,4,0,10,1.4,9,7
"['011011', '1100101', '1', '001000']",1,4,10,10,2,20,2.706043956043956,26,11
"['1101', '10010', '01000']",1,3,8,6,2,14,1.911111111111111,7,4
"['0011101', '1101111', '10101', '0111', '111101']",1,5,8,21,2,29,6.532234432234432,26,43
"['011', '00000', '10', '000010', '0100']",1,5,15,5,0,20,5.071789321789321,28,37
"['00110', '1110000', '10', '1101']",1,4,9,9,0,18,3.3946608946608947,22,13
"['0100011', '1', '1111011']",1,3,5,10,2,15,1.0714285714285714,15,11
"['001101', '0011001', '00100', '1010100', '011101']",1,5,17,14,4,31,7.102397602397603,22,41
"['10001', '001001', '1', '110111']",1,4,8,10,2,18,2.6774891774891776,23,20
"['011', '111', '101', '00', '0110001']",1,5,8,10,3,18,5.044444444444444,28,23
"['010001', '001101', '0110', '000', '0100']",1,5,15,8,4,23,6.326190476190476,23,37
"['01', '001', '1010100', '011101', '1100110', '11111', '010011']",1,7,15,21,4,36,11.126257076257076,72,54
"['101', '00', '00110']",1,3,6,4,0,10,1.4714285714285715,8,6
"['0011', '11100', '00', '110', '1101010']",1,5,10,11,0,21,5.6605339105339105,31,33
"['01', '001', '00']",1,3,5,2,2,7,2.1,3,9
"['00100', '01', '1001', '110']",1,4,8,6,0,14,3.376190476190476,15,11
"['11000', '00100', '001']",1,3,9,4,2,13,1.85,8,12
"['0', '001111', '0011', '100111', '01010', '0001011', '1010001']",1,7,18,18,4,36,11.788544788544788,72,52
"['110010', '110', '000101']",1,3,8,7,2,15,1.7777777777777777,10,9
"['000110', '11', '101010', '0001111', '1000', '1100']",1,6,15,14,4,29,8.60097125097125,49,46
"['1110011', '100', '011000']",1,3,8,8,0,16,1.882051282051282,10,5
"['1010', '1', '0111', '001010']",1,4,7,8,2,15,2.9857142857142858,19,13
"['00110', '10101', '11111']",1,3,5,10,3,15,1.6,8,4
"['010', '011100', '01000', '0000', '0101001']",1,5,17,8,0,25,6.181568431568431,24,48
"['01101', '10000', '000', '01010', '1101']",1,5,13,9,3,22,6.085714285714285,25,26
"['0010111', '111', '00001', '100000', '0011111']",1,5,14,14,2,28,4.883011433011433,38,39
"['1', '0100110', '1010100', '000100', '01110']",1,5,15,11,2,26,4.620546120546121,36,27
"['00100', '1010101', '11111']",1,3,7,10,2,17,1.5333333333333332,10,4
"['011101', '1000000', '0010111', '011110']",1,4,13,13,4,26,2.9652014652014653,23,16
"['0', '100', '111']",1,3,3,4,2,7,0.8333333333333333,7,4
"['011001', '101110', '0100', '11']",1,4,8,10,2,18,3.4,19,11
"['1010100', '1', '1111001']",1,3,6,9,2,15,1.2142857142857144,15,8
"['0111', '10010', '011110', '11']",1,4,6,11,0,17,3.346176046176046,17,16
"['01', '10010', '01110', '11']",1,4,6,8,4,14,3.1857142857142855,16,12
"['1101001', '11011', '010', '001', '1000', '010111']",1,6,13,15,2,28,8.686524586524586,43,40
"['01', '1100', '101111', '0000']",1,4,8,8,2,16,2.2666666666666666,21,13
"['001000', '111', '1011111']",1,3,6,10,0,16,1.12991452991453,14,8
"['0110', '100001', '10', '11']",1,4,7,7,2,14,3.2333333333333334,17,12
"['1100111', '111000', '01011']",1,3,7,11,0,18,1.6456876456876457,11,12
"['10010', '0111', '1011000']",1,3,8,8,0,16,1.6565656565656566,10,7
"['11101', '001011', '10']",1,3,5,8,0,13,1.6168831168831168,10,7
"['11011', '100001', '10']",1,3,6,7,0,13,1.6168831168831168,10,9
"['1000000', '1010', '110', '1111000']",1,4,12,9,2,21,3.2337662337662336,21,17
"['0', '110', '1110']",1,3,3,5,0,8,1.7571428571428571,6,9
"['010', '011', '11', '1000010', '011111', '0110010', '01100']",1,7,16,17,4,33,12.154245754245753,69,72
"['10111', '00', '010']",1,3,5,5,0,10,1.5857142857142859,8,4
"['00', '01101', '110100', '1110']",1,4,8,9,0,17,3.398701298701299,17,15
"['00111', '1110101', '010000', '10']",1,4,10,10,0,20,2.555333555333555,25,13
"['10001', '1001', '10', '0111110']",1,4,8,10,0,18,3.2683982683982684,21,17
"['10101', '1', '1110']",1,3,3,7,0,10,1.1777777777777778,9,8
"['1011', '01', '1100101', '110100']",1,4,8,11,0,19,3.525796425796426,19,19
"['1', '10100', '1000', '00', '01011']",1,5,10,7,2,17,4.587301587301587,28,24
"['00101', '011', '11', '0001', '00']",1,5,9,7,2,16,5.330952380952381,21,26
"['101', '0101', '0100100']",1,3,8,6,0,14,2.1844155844155844,8,8
"['1100', '100000', '10', '000000', '11100', '1110']",1,6,17,10,4,27,8.524963924963926,43,54
"['0', '100', '110', '1010101']",1,4,7,7,2,14,2.9166666666666665,19,11
"['1001001', '01100', '11']",1,3,7,7,0,14,1.5158730158730158,11,4
"['00111', '110001', '100010', '00110', '1110']",1,5,13,13,4,26,6.33030303030303,27,29
"['001101', '10001', '110001', '011']",1,4,10,10,2,20,3.5656565656565657,18,21
"['1100010', '01', '11110']",1,3,6,8,0,14,1.2301587301587302,12,8
"['000000', '00010', '000100', '01100']",1,4,18,4,4,22,3.960606060606061,12,45
"['1101111', '1111', '1111010', '00', '0101100']",1,5,9,18,3,27,4.786435786435787,39,36
"['010', '1000101', '111', '01100', '101111', '111001']",1,6,12,18,4,30,8.521872571872573,47,41
"['110', '10', '0110100']",1,3,6,6,0,12,1.8444444444444446,10,7
"['0', '11011', '1000', '111110']",1,4,6,10,0,16,2.408946608946609,21,12
"['11011', '01', '001', '000']",1,4,7,6,2,13,3.1880952380952383,14,13
"['0110', '101111', '00011']",1,3,6,9,0,15,1.812121212121212,9,5
"['0101111', '0000100', '001101', '00001', '0001', '0110', '0000011', '101110']",1,8,27,19,7,46,16.716383616383617,86,91
"['0001', '010', '1100', '0110111']",1,4,9,9,2,18,3.151948051948052,19,15
"['11100', '011', '11']",1,3,3,7,0,10,1.8714285714285714,7,11
"['0100010', '11000', '10101', '10', '1101', '1100', '0100']",1,7,17,14,5,31,13.379220779220779,51,56
"['101', '000111', '0110']",1,3,6,7,0,13,1.615873015873016,10,4
"['010101', '001', '1110000', '0000']",1,4,13,7,0,20,3.2046842046842046,20,22
"['010', '1', '0001', '110100', '1110']",1,5,9,9,2,18,4.645238095238096,30,21
"['10111', '010', '001', '110']",1,4,6,8,3,14,3.1666666666666665,15,12
"['010', '00111', '01010', '1101', '1100', '001011']",1,6,13,14,4,27,9.268109668109668,37,43
"['0001100', '1101', '1', '111100']",1,4,8,10,0,18,2.6965534465534464,24,15
"['0', '101', '111']",1,3,2,5,2,7,1.1666666666666665,6,4
"['100111', '1110000', '1110']",1,3,7,10,0,17,1.7888111888111888,11,13
"['000110', '00100', '00', '10011', '00010']",1,5,16,7,3,23,6.577922077922078,25,40
"['0010', '0111011', '10', '01010', '1100']",1,5,11,11,2,22,5.94011544011544,29,29
"['001', '011001', '00011', '100', '100101', '000', '11111']",1,7,16,15,7,31,11.708080808080808,59,59
"['1010000', '11010', '0100011', '10']",1,4,12,9,2,21,3.341269841269841,23,15
"['0010', '01111', '00', '00010', '0111110']",1,5,12,11,2,23,5.58037518037518,31,46
"['1000010', '1000100', '10']",1,3,11,5,2,16,1.746031746031746,12,12
"['01011', '01', '0000010']",1,3,9,5,0,14,1.5158730158730158,12,7
"['1100011', '01111', '11']",1,3,4,10,0,14,1.5158730158730158,12,16
"['1000010', '00111', '10']",1,3,8,6,0,14,1.2301587301587302,13,8
"['0', '111111', '010000', '1110']",1,4,7,10,2,17,1.8523809523809525,26,14
"['01', '0010', '111', '1001010', '101000', '100']",1,6,14,11,2,25,7.855355755355755,45,37
"['1111100', '00011', '100010', '0111', '0000', '110']",1,6,15,14,2,29,7.616156066156066,49,45
"['11', '011101', '100110', '1000', '010111', '01110']",1,6,12,17,3,29,8.812842712842713,44,40
"['1110100', '00', '111']",1,3,5,7,0,12,1.0444444444444443,12,10
"['001100', '01', '00', '110']",1,4,8,5,2,13,2.966666666666667,16,18
"['0110100', '00001', '101', '1110110', '1001', '0001010', '01001', '110', '01100']",1,9,25,21,8,46,21.46096681096681,108,97
"['0', '0110000', '1010010']",1,3,10,5,2,15,1.2142857142857144,15,8
"['01', '0011', '1010']",1,3,5,5,2,10,1.8333333333333333,6,6
"['01', '010001', '10', '0001111']",1,4,9,8,2,17,2.782051282051282,25,14
"['101010', '1110011', '10000', '0000111', '0101', '0011100']",1,6,19,17,3,36,8.813209013209013,53,39
"['1001110', '10010', '1']",1,3,6,7,0,13,1.4166666666666667,12,10
"['0', '01001', '1100', '0010111']",1,4,9,8,0,17,2.68030303030303,23,14
"['11110', '010', '10', '0110010', '110']",1,5,9,11,2,20,6.232539682539683,27,36
"['0101111', '00101', '110100', '1010', '00', '0101001']",1,6,16,15,2,31,9.19022089022089,46,40
"['110000', '1011001', '1000', '111111', '10', '0101100', '011110', '001100', '1110', '0100']",1,10,25,27,9,52,26.135775335775335,139,127
"['0101', '00', '111110']",1,3,5,7,0,12,1.3166666666666667,11,6
"['01101', '1001', '110111', '1001011', '01100']",1,5,11,16,2,27,6.28034188034188,28,29
"['00111', '10010', '000010', '01011', '101111']",1,5,13,14,5,27,6.151515151515151,27,27
"['010100', '00100', '1001', '10000', '010110', '0000011', '0000', '1100', '111101']",1,9,29,18,8,47,21.26996891996892,100,119
"['0011', '1010', '000011']",1,3,8,6,2,14,1.7000000000000002,8,10
"['01', '01101', '100100', '00', '101110', '01110']",1,6,13,13,6,26,8.797835497835498,43,44
"['01', '0101100', '001000']",1,3,10,5,0,15,1.7136752136752138,11,11
"['0101', '00', '001', '00011']",1,4,9,5,0,14,4.026190476190476,11,18
"['101110', '000101', '10']",1,3,7,7,2,14,1.5,12,8
"['001110', '1', '011001']",1,3,6,7,2,13,1.0714285714285714,13,4
"['0011', '010', '1111110']",1,3,5,9,0,14,1.335064935064935,12,8
"['001', '1110000', '001000']",1,3,11,5,0,16,1.682051282051282,11,13
"['0', '10111', '010', '11']",1,4,4,7,0,11,2.3047619047619046,16,10
"['0110010', '10001', '10110', '01']",1,4,10,9,2,19,3.5206349206349206,20,14
"['0000111', '0101', '11']",1,3,6,7,0,13,1.6565656565656566,11,8
"['01', '101110', '011001']",1,3,6,8,2,14,1.6666666666666665,11,8
"['11110', '1000', '1011101']",1,3,6,10,0,16,1.823232323232323,9,7
"['10001', '1100000', '100', '0001100', '100000', '0000']",1,6,24,8,2,32,10.433649683649683,42,71
"['0010001', '1000', '01101', '01011']",1,4,12,9,2,21,3.5494949494949495,17,15
"['1001110', '11011', '1', '00110', '1000', '001010']",1,6,14,14,2,28,8.364541014541015,48,36
"['11000', '1011', '1110', '0010011']",1,4,9,11,2,20,3.202020202020202,19,20
"['0001110', '11', '101', '010010', '00110', '110111', '01001']",1,7,16,18,4,34,13.082523032523032,63,50
"['110110', '1110', '1101110']",1,3,5,12,0,17,2.2503496503496505,6,19
"['0000111', '01', '1110100', '0111']",1,4,9,11,2,20,3.2568542568542567,24,21
"['11010', '100000', '01000', '1111']",1,4,11,9,2,20,2.9616161616161616,18,14
"['101010', '11000', '001010', '0010100']",1,4,15,9,2,24,4.465034965034965,12,27
"['11010', '0011101', '100', '100111', '1011', '010011']",1,6,13,18,2,31,9.842407592407593,44,44
"['1001000', '1100101', '0100']",1,3,11,7,2,18,1.987012987012987,10,5
"['001', '0111011', '11111']",1,3,4,11,0,15,1.4833333333333334,10,8
"['01', '111', '00001', '0011', '1000', '011010']",1,6,13,11,2,24,7.642207792207792,42,36
"['01', '0011101', '1100']",1,3,6,7,0,13,1.323232323232323,12,8
"['01', '1000101', '011', '1110']",1,4,7,9,0,16,3.112842712842713,19,15
"['1', '101101', '101010', '101000', '0000101']",1,5,14,12,3,26,4.978937728937729,36,33
"['011', '11', '10', '000', '0101']",1,5,7,7,4,14,5.195238095238095,18,21
"['001000', '100', '1001', '01111', '111110', '11101', '0011011', '000111', '1110']",1,9,19,27,7,46,20.725735375735375,111,114
"['01', '10001', '00010', '00001']",1,4,12,5,3,17,4.114285714285714,14,17
"['100110', '10', '10000']",1,3,8,5,0,13,1.7987012987012987,9,11
"['101000', '0010', '10001', '11010']",1,4,12,8,2,20,3.987878787878788,15,14
"['11', '110111', '0100']",1,3,4,8,0,12,1.2333333333333334,11,8
"['101011', '1110010', '100001', '1101110']",1,4,11,15,4,26,3.6996336996337,18,19
"['011', '110011', '00110', '000', '1110']",1,5,10,11,2,21,5.7955266955266955,26,28
"['11000', '1110110', '00', '0110']",1,4,9,9,0,18,3.743145743145743,19,20
"['1000010', '1100010', '1101', '001101']",1,4,13,11,2,24,4.160639360639361,18,21
"['100', '111010', '1111111', '00000']",1,4,9,12,0,21,2.345687645687646,26,16
"['010', '100', '1001010']",1,3,8,5,2,13,1.8666666666666667,10,10
"['1000101', '0001', '1111000', '00', '11111', '0101']",1,6,14,15,4,29,7.490620490620491,55,45
"['1011010', '100', '11100', '011']",1,4,8,10,2,18,3.6166666666666667,18,16
"['0001011', '1011', '00', '1']",1,4,7,7,0,14,2.155050505050505,22,15
"['11110', '100100', '0110', '1011000', '01110']",1,5,13,14,2,27,6.158818958818959,24,33
"['000011', '1001000', '1100101']",1,3,12,8,2,20,1.7912087912087913,10,9
"['0', '0101001', '1011111']",1,3,6,9,2,15,1.0714285714285714,16,4
"['110000', '00100', '1100']",1,3,10,5,0,15,2.012121212121212,7,15
"['00111', '1000', '1', '101110']",1,4,7,9,0,16,2.790764790764791,21,14
"['110110', '01101', '0010111', '0000100', '0011', '0101011', '1111', '1010001', '1100']",1,9,24,27,7,51,21.276257076257075,115,107
"['00', '0110100', '01100']",1,3,9,5,0,14,1.8492063492063493,10,21
"['0110101', '00100', '110', '01110']",1,4,10,10,2,20,3.95,16,18
"['11000', '10010', '010111', '10', '101001']",1,5,12,12,4,24,5.973160173160173,31,25
"['010100', '010', '111', '0011', '0001100', '001010', '0111', '000']",1,8,21,15,7,36,16.356426906426908,77,102
"['0110001', '00100', '110001', '10100', '000000', '0001010', '1001011']",1,7,28,15,7,43,13.377922077922078,61,62
"['00100', '11000', '01101', '11']",1,4,9,8,3,17,3.2285714285714286,18,14
"['1110111', '11001', '00001', '100', '0110110']",1,5,12,15,4,27,5.564285714285714,33,23
"['10111', '0001', '000', '00011']",1,4,10,7,2,17,3.7904761904761903,13,22
"['0000111', '101011', '1', '0100101']",1,4,10,11,2,21,2.8846153846153846,25,15
"['1010', '001110', '011110']",1,3,7,9,2,16,1.6333333333333333,7,13
"['11011', '001', '001101', '00101', '100', '01010', '1010000']",1,7,19,15,5,34,12.76961926961927,62,58
"['1010000', '11000', '1100', '000011']",1,4,14,8,0,22,4.01033411033411,18,27
"['0', '00010', '1000111']",1,3,8,5,0,13,1.25,13,4
"['011', '0111011', '101010', '100100', '0100']",1,5,13,13,2,26,6.3382506382506385,31,30
"['010001', '10', '110100']",1,3,8,6,2,14,1.6666666666666665,11,6
"['1101111', '00001', '1001000', '010101', '01001']",1,5,16,14,4,30,5.732067932067932,30,28
"['011101', '1', '0100001', '11001']",1,4,9,10,0,19,2.8783716283716285,23,19
"['0010', '1', '10']",1,3,4,3,0,7,1.7333333333333334,6,5
"['110011', '1100', '110']",1,3,5,8,0,13,2.3238095238095235,6,15
"['0011001', '1010', '1010110', '01010']",1,4,12,11,2,23,4.209235209235209,18,20
"['0001', '1001000', '01010', '110101']",1,4,13,9,0,22,3.3992229992229994,17,13
"['11111', '101', '0001', '0011110', '1001', '0000001', '00', '0111', '0101100', '001100']",1,10,26,23,6,49,23.149589299589298,154,132
"['01', '0110', '001110', '1110']",1,4,7,9,2,16,3.85,14,22
"['101000', '10111', '101111', '110', '01011', '111101']",1,6,10,21,5,31,8.84040404040404,40,58
"['0111001', '0011', '110100', '100110', '111111', '01010']",1,6,14,20,3,34,8.476456876456876,46,36
"['010', '000111', '11111']",1,3,5,9,0,14,1.2398989898989898,11,8
"['10001', '0111', '1111']",1,3,4,9,2,13,1.6388888888888888,7,12
"['1101', '00', '001010', '0101100']",1,4,11,8,0,19,3.1924630924630923,22,17
"['00100', '010', '1', '011']",1,4,7,5,2,12,3.25,14,11
"['0001100', '1100', '0110', '0111']",1,4,10,9,3,19,4.0,16,21
"['1000110', '1', '10']",1,3,5,5,0,10,1.3611111111111112,12,8
"['001', '10010', '0000']",1,3,9,3,0,12,1.9880952380952381,6,8
"['01', '1000', '00010']",1,3,8,3,0,11,1.5714285714285714,8,8
"['010001', '10000', '1111110', '0101', '111001']",1,5,13,15,2,28,5.203885003885004,33,28
"['001', '1110010', '011', '011101', '00', '0111101']",1,6,12,16,4,28,8.773260073260074,48,46
"['00111', '11011', '10', '101101']",1,4,6,12,2,18,3.4116883116883114,19,17
"['1000101', '01111', '00', '10', '0100101', '111001']",1,6,14,15,4,29,7.831057831057831,55,38
"['0', '1010110', '0011001', '000101', '1011111', '111001']",1,6,15,19,5,34,7.524725274725275,59,39
"['0', '101', '011101', '1000', '110101']",1,5,9,11,2,20,5.042857142857143,32,25
"['0010', '011', '111', '1011101', '1001', '10']",1,6,9,14,4,23,8.467171717171716,40,37
"['101', '00', '10010', '001100']",1,4,10,6,0,16,3.211327561327561,18,15
"['001', '11', '100', '0000010', '011111', '1101010']",1,6,14,14,4,28,6.497802197802198,59,38
"['0011', '1000', '10', '011']",1,4,7,6,2,13,3.0428571428571427,14,16
"['00100', '010', '100', '011']",1,4,9,5,3,14,3.6666666666666665,13,18
"['01', '11100', '111']",1,3,3,7,0,10,1.4357142857142857,8,10
"['0', '1000100', '0000001']",1,3,12,3,2,15,1.0714285714285714,15,7
"['110110', '1011101', '010000', '1101100']",1,4,12,14,4,26,3.82967032967033,17,16
"['10001', '1110001', '0101']",1,3,8,8,0,16,2.0454545454545454,8,14
"['11001', '010001', '00100', '01111', '110101', '111001']",1,6,15,18,6,33,9.94848484848485,37,50
"['01010', '011', '0011100']",1,3,8,7,0,15,2.0166666666666666,9,9
"['1', '00', '0101110', '01110']",1,4,7,8,0,15,2.4325396825396823,22,17
"['101', '1010', '10000']",1,3,7,5,0,12,2.0238095238095237,6,10
"['0111001', '111', '0110', '1101100', '0110000', '001100', '1100', '0101001']",1,8,23,22,6,45,19.153285603285603,80,91
"['110001', '1', '0111100']",1,3,6,8,0,14,1.151098901098901,15,4
"['010100', '01', '011', '0101010', '000']",1,5,13,8,2,21,5.711965811965812,29,37
"['00110', '100', '10', '101001']",1,4,9,7,0,16,3.5835497835497834,17,15
"['11011', '1001000', '1111000', '01100']",1,4,12,12,4,24,3.480952380952381,19,17
"['0', '011', '01011', '111']",1,4,4,8,2,12,2.75,14,17
"['0', '11', '00111', '000101', '001001']",1,5,11,9,2,20,4.764069264069264,33,25
"['101', '1100', '11']",1,3,3,6,0,9,2.038095238095238,5,10
"['11010', '010', '100110', '01001', '1101010']",1,5,13,13,2,26,6.6009324009324,26,36
"['01', '101110', '1010011']",1,3,6,9,0,15,1.7136752136752138,12,8
"['101001', '101', '0110', '01010']",1,4,9,9,0,18,4.004256854256854,15,13
"['01', '010000', '001101', '0100', '001110', '000', '001100', '000111', '0110011']",1,9,28,18,5,46,22.427761127761126,108,149
"['0000', '111011', '1111']",1,3,5,9,2,14,1.0,11,10
"['0', '0011100', '00001', '010111', '0011111', '1001011']",1,6,16,17,3,33,7.6832334332334336,58,40
"['111111', '100', '001001', '100010']",1,4,10,11,3,21,2.888888888888889,22,15
"['01', '0110', '01000', '01110']",1,4,9,7,2,16,3.9650793650793648,13,27
"['101', '0100110', '100110', '1111']",1,4,8,12,0,20,3.524808524808525,17,16
"['11110', '0010', '011', '10001', '111011', '0111']",1,6,10,17,4,27,8.49018759018759,41,44
"['11001', '100110', '00', '100111', '0000010', '1010000']",1,6,20,13,4,33,8.64013764013764,52,41
"['001111', '101101', '10101', '110100', '100110', '0100100', '0111']",1,7,18,22,4,40,13.716083916083916,57,56
"['110110', '110010', '110100', '10', '1100111', '01000']",1,6,15,17,3,32,9.66971916971917,42,50
"['001000', '100', '010101', '000', '0001010', '010011', '1011011']",1,7,23,15,7,38,13.536385836385836,63,65
"['101', '101000', '111111', '000000', '1110']",1,5,12,13,3,25,3.938095238095238,37,28
"['110000', '101', '01111', '0100']",1,4,9,9,0,18,2.923953823953824,20,13
"['0101000', '00101', '100011', '010110', '110']",1,5,15,12,2,27,6.183605283605283,32,25
"['01', '10', '00101', '01110']",1,4,7,7,4,14,3.3857142857142857,17,15
"['011011', '100', '10']",1,3,5,6,0,11,1.7444444444444445,9,7
"['0011000', '1010100', '0010100', '011101', '1111010', '110']",1,6,19,18,4,37,9.27106227106227,46,47
"['1111', '10', '110100', '0100']",1,4,7,9,2,16,3.15,17,15
"['1', '0100010', '00', '010110', '1110']",1,5,11,9,0,20,4.146359196359197,36,26
"['111', '10111', '0001101', '0000', '011000']",1,5,13,12,0,25,5.004778554778555,34,30
"['100', '111', '01000']",1,3,6,5,2,11,1.3333333333333333,8,5
"['0010', '001', '111', '101000', '1101101', '000101', '1100011', '0011011', '000100']",1,9,26,23,8,49,21.321722721722722,118,115
"['0110001', '100', '1', '01000']",1,4,10,6,0,16,3.2666666666666666,20,12
"['01', '0010', '1', '000']",1,4,7,3,0,10,2.9904761904761905,12,12
"['0000111', '10100', '0111', '00001']",1,4,12,9,2,21,3.182828282828283,19,21
"['110000', '001', '101101', '011011', '100011', '10010', '000001']",1,7,21,17,5,38,12.356060606060606,60,61
"['01', '0001', '101111']",1,3,5,7,0,12,1.5666666666666667,10,7
"['01', '011', '10111', '100', '1010', '110']",1,6,8,12,3,20,8.92142857142857,30,39
"['01101', '010001', '0000100', '11111', '0000', '110']",1,6,17,13,2,30,7.124836274836275,51,40
"['0', '11001', '0110100', '101', '010011']",1,5,11,11,0,22,5.395038295038295,34,19
"['1110010', '1', '000']",1,3,6,5,0,11,0.85,13,4
"['1001110', '1110111', '001111', '011010', '1010', '0101', '110', '01110']",1,8,16,26,6,42,18.315262515262514,78,83
"['0000', '010000', '1', '111001']",1,4,11,6,2,17,2.2714285714285714,23,14
"['0000011', '1101000', '011', '1000111']",1,4,13,11,3,24,3.314285714285714,25,21
"['1001100', '100', '0']",1,3,7,4,0,11,1.35,12,10
"['0', '101', '1000000', '10011', '110', '1110']",1,6,12,11,2,23,7.436652236652237,49,37
"['101100', '1101', '0111001', '101000']",1,4,11,12,2,23,4.145221445221445,16,16
"['0110101', '100110', '111010', '11']",1,4,8,13,2,21,3.4957264957264957,22,15
"['0110010', '1000', '1', '0100']",1,4,10,6,2,16,3.254545454545455,20,12
"['0', '0111001', '001111', '10']",1,4,7,9,0,16,2.666056166056166,25,12
"['11001', '10100', '0111011', '0000']",1,4,11,10,2,21,3.2191919191919194,19,13
"['01', '00011', '100100', '1111', '10']",1,5,9,10,2,19,4.413708513708514,33,24
"['0111011', '01010', '1111101']",1,3,6,13,2,19,1.880952380952381,10,6
"['01', '111', '100100', '0000', '0110011']",1,5,12,10,0,22,4.501243201243201,36,23
"['010', '00001', '0011', '00100', '100100', '100110', '0101010', '0111101']",1,8,25,18,6,43,17.205910755910757,79,87
"['01', '000011', '00', '10100', '001110', '110111', '01100']",1,7,17,15,7,32,11.25995670995671,69,60
"['11', '0110', '01011', '00001']",1,4,8,8,2,16,3.034920634920635,16,13
"['1110000', '0001100', '00', '10011', '0111100']",1,5,16,12,3,28,5.571428571428571,40,37
"['1111101', '10111', '0001100', '1000', '100000', '11111', '1011', '0100']",1,8,19,23,7,42,14.125191475191475,94,95
"['0', '011011', '1001', '11101', '0111']",1,5,7,13,2,20,5.17965367965368,29,25
"['00100', '01', '0011000']",1,3,10,4,0,14,1.8492063492063493,10,13
"['110010', '001', '11', '10101', '0110', '11100']",1,6,11,14,2,25,8.713275613275613,40,36
"['0010010', '1', '00011']",1,3,8,5,0,13,1.25,13,5
"['010', '11', '1100011', '110', '01100']",1,5,9,11,2,20,6.049206349206349,29,27
"['000100', '001', '11']",1,3,7,4,0,11,1.3166666666666667,10,6
"['0', '100', '1010', '010011', '01110']",1,5,10,9,0,19,5.132756132756133,29,25
"['1010', '011', '0110100']",1,3,7,7,0,14,1.8987012987012988,9,8
"['01101', '100001', '11', '100', '011101', '100110', '100000']",1,7,18,16,4,34,11.696176046176046,67,66
"['00', '0010011', '11']",1,3,6,5,2,11,0.8888888888888888,12,8
"['1100011', '1101', '010', '1']",1,4,6,9,0,15,2.8487012987012985,21,15
"['0010', '10', '000']",1,3,7,2,0,9,1.9238095238095236,5,11
"['0', '1011011', '010011', '00111']",1,4,8,11,0,19,2.8783716283716285,22,14
"['10111', '0010', '111110', '10']",1,4,6,11,0,17,3.127994227994228,18,16
"['0010001', '00010', '100', '011']",1,4,12,6,2,18,3.1999999999999997,20,15
"['1101', '111001', '11']",1,3,3,9,0,12,1.9666666666666668,8,18
"['1001001', '111110', '00011']",1,3,8,10,0,18,1.337995337995338,11,7
"['01', '1101', '00111', '0101011']",1,4,7,11,0,18,3.5613275613275612,18,17
"['1111100', '1011110', '101', '0111', '0000', '0100101']",1,6,14,18,5,32,7.694155844155844,54,37
"['0000001', '1111', '00', '100101', '0101']",1,5,13,10,2,23,4.518104118104118,35,25
"['0001101', '00', '01100']",1,3,9,5,0,14,1.6825396825396823,11,13
"['10100', '1000', '1', '001']",1,4,8,5,0,13,2.9714285714285715,15,16
"['1000001', '0', '10101', '10001', '110100']",1,5,14,10,2,24,5.2366466866466865,33,30
"['01', '001', '00001', '11101', '110101']",1,5,10,11,2,21,5.628210678210678,26,36
"['010100', '0110010', '110']",1,3,9,7,0,16,1.505982905982906,10,10
"['11', '100', '10000', '100000', '0111']",1,5,12,8,0,20,4.636075036075036,31,35
"['10001', '1011011', '0100']",1,3,8,8,0,16,1.8787878787878787,10,5
"['0110', '000001', '01100', '11']",1,4,10,7,0,17,3.1406204906204906,18,14
"['101100', '0101', '0110', '1101010']",1,4,10,11,2,21,4.191958041958042,16,14
"['101', '10001', '10', '011']",1,4,6,7,2,13,3.6880952380952383,13,18
"['01', '01111', '1011111', '001100', '1100', '011000']",1,6,13,17,2,30,8.437939837939838,49,44
"['011100', '101', '0001', '011111', '110']",1,5,9,13,4,22,4.9904761904761905,32,24
"['11110', '011', '00', '10', '111000', '1100', '01011']",1,7,12,15,4,27,11.30122655122655,58,61
"['11000', '01', '1101111', '011']",1,4,6,11,0,17,3.13015873015873,22,19
"['10010', '11100', '0010100']",1,3,10,7,2,17,1.9333333333333331,9,9
"['010', '100', '110011', '10011', '0000']",1,5,12,9,2,21,5.924170274170274,26,25
"['1001010', '11', '1001', '0110', '0000111', '0101', '0000110', '1111011']",1,8,20,22,7,42,16.258297258297258,98,76
"['11', '0001', '1101000', '1101011', '01100']",1,5,12,13,2,25,5.194805194805195,36,33
"['110010', '000101', '0110', '0000111', '11100']",1,5,15,13,2,28,5.900466200466201,33,29
"['11011', '010111', '111110']",1,3,4,13,2,17,1.7727272727272727,7,12
"['1', '00101', '0110']",1,3,5,5,0,10,1.4,9,4
"['110011', '10101', '0']",1,3,5,7,0,12,1.3463203463203464,12,4
"['00', '01101', '11']",1,3,4,5,2,9,1.1428571428571428,8,4
"['101010', '1100', '0']",1,3,6,5,0,11,1.2857142857142856,10,6
"['11110', '101011', '00100', '111000', '111001']",1,5,12,16,5,28,5.8545454545454545,25,31
"['100', '1010', '00', '10010', '1110']",1,5,10,8,2,18,6.383333333333333,18,30
"['01101', '0111010', '11', '1100010', '100']",1,5,11,13,2,24,5.7746031746031745,35,24
"['10101', '110001', '111']",1,3,5,9,0,14,2.143939393939394,7,15
"['11010', '0100111', '0101110']",1,3,8,11,2,19,1.8571428571428572,9,10
"['11', '00000', '000010', '1101', '1011011']",1,5,13,11,0,24,4.414568764568765,38,27
"['1010101', '1001000', '1000', '1110100', '1011']",1,5,15,14,5,29,6.461038961038961,30,36
"['01', '0001', '010110']",1,3,7,5,0,12,1.5666666666666667,9,8
"['0', '11011', '11101', '11111']",1,4,3,13,3,16,3.066666666666667,17,22
"['00', '1001', '0110001', '11']",1,4,8,7,2,15,2.9494949494949494,19,12
"['01', '1011001', '10111', '1101011', '00110', '10010', '000100']",1,7,18,19,5,37,12.569708069708069,64,49
"['0010', '101011', '10', '0111', '1010001']",1,5,11,12,2,23,5.504584304584305,31,25
"['101100', '110110', '00101', '1001', '1110011', '10', '0000', '1010010']",1,8,21,20,6,41,16.706071706071707,87,72
"['100011', '1000', '100101', '1110']",1,4,10,10,4,20,3.7333333333333334,15,22
"['0', '11010', '111', '1001010']",1,4,7,9,0,16,2.7666666666666666,21,15
"['00', '1', '001101', '011000']",1,4,9,6,2,15,2.238095238095238,23,15
"['110110', '111', '111010', '11000', '1000', '00']",1,6,12,14,2,26,8.733910533910533,41,48
"['101000', '000', '1011', '1100', '01100']",1,5,13,9,2,22,6.206637806637806,24,34
"['10111', '01001', '10', '1001010']",1,4,9,10,2,19,3.3539682539682536,21,16
"['1010100', '10', '000', '1101', '111101']",1,5,10,12,0,22,4.726040626040626,33,25
"['0101110', '00011', '1011110', '11000', '0110', '0000011', '10', '1110110', '111000']",1,9,24,26,6,50,21.137007437007437,130,123
"['010', '0111011', '01111', '0000101', '00', '01010', '110']",1,7,16,16,6,32,11.90079365079365,66,66
"['011', '1101101', '1010', '000000', '1001011', '001001', '1110']",1,7,19,18,6,37,10.894516594516594,69,52
"['101011', '101', '1101110', '1111', '110', '01100']",1,6,9,19,2,28,8.741885891885891,43,44
"['0010', '0110', '101101']",1,3,7,7,2,14,2.15,6,5
"['101010', '01', '0110', '100001']",1,4,10,8,2,18,3.1333333333333333,19,14
"['110010', '01', '00', '10010', '1100111']",1,5,11,11,2,22,5.876734376734377,31,27
"['011100', '11', '00100', '1110101', '10']",1,5,10,12,2,22,5.242535242535243,35,21
"['0', '0011110', '10', '11111']",1,4,5,10,0,15,2.3134920634920633,24,11
"['000110', '0101111', '1011111', '1110101', '1000', '0100']",1,6,15,20,5,35,8.015734265734265,56,40
"['0101', '10001', '1111', '00110', '100111', '01001', '000100']",1,7,18,17,7,35,12.696969696969697,56,52
"['11010', '111000', '0111']",1,3,6,9,0,15,1.993939393939394,9,10
"['1010', '01101', '0010100']",1,3,9,7,0,16,2.0606060606060606,9,6
"['00', '1100', '10000']",1,3,8,3,0,11,1.9047619047619047,7,11
"['1011001', '111', '011011', '1101101', '1001000', '1101011', '0110', '1010111', '10100', '000']",1,10,24,32,7,56,27.226462426462426,142,138
"['1100', '0111111', '110', '10']",1,4,5,11,0,16,3.3096681096681095,20,17
"['100000', '00', '01111', '000011']",1,4,12,7,2,19,2.6796536796536796,23,20
"['0011001', '110001', '10110', '100010', '1010', '000010', '0111', '0100011', '110']",1,9,26,22,7,48,22.4497557997558,105,101
"['101', '00', '010110', '11']",1,4,6,7,2,13,2.8666666666666667,16,8
"['101', '1001', '11']",1,3,3,6,0,9,2.3238095238095235,4,14
"['0111', '1100010', '000010']",1,3,10,7,0,17,1.5328671328671328,11,11
"['01', '110010', '100001', '111', '0000', '1100']",1,6,14,11,4,25,7.715873015873016,44,38
"['0110', '0110011', '0100']",1,3,8,7,2,15,2.2045454545454546,7,13
"['11', '00', '010111', '00011']",1,4,7,8,2,15,2.87012987012987,18,17
"['11011', '000011', '100', '0000000', '1011']",1,5,15,10,0,25,4.914085914085914,36,37
"['100000', '11011', '001110', '1']",1,4,9,9,2,18,2.1471861471861473,26,11
"['1001110', '10101', '10001', '1101110', '10010', '000', '1101']",1,7,17,19,5,36,13.815584415584416,55,65
"['0', '0010', '1110010', '011']",1,4,8,7,0,15,2.8487012987012985,21,18
"['11001', '101', '1001000']",1,3,8,7,0,15,2.0166666666666666,9,10
"['110011', '010', '011101']",1,3,6,9,2,15,1.7777777777777777,10,5
"['0', '1001110', '001', '00101', '110011', '11111']",1,6,11,16,2,27,7.426157176157176,52,35
"['11010', '1110011', '1000111', '00110', '0010010', '01011']",1,6,17,19,6,36,9.69047619047619,45,43
"['1110010', '011', '10111', '111011', '010011']",1,5,9,18,2,27,6.4891608391608395,28,44
"['10001', '100', '1']",1,3,5,4,0,9,1.5833333333333333,8,10
"['11010', '010', '001']",1,3,6,5,2,11,1.9166666666666665,7,8
"['001', '000101', '00110', '100011', '0101']",1,5,14,10,2,24,7.00930735930736,24,27
"['11011', '100', '010110', '1100', '0111110', '0100']",1,6,13,16,2,29,9.475629925629926,39,45
"['0110100', '011', '1111', '100000', '10011', '011110']",1,6,14,17,2,31,7.955228105228105,50,41
"['1000100', '11010', '0010000', '011000']",1,4,17,8,2,25,3.992840492840493,18,20
"['1111101', '00011', '1011110', '0110', '100110']",1,5,11,18,2,29,6.541758241758242,30,27
"['0001000', '001010', '0000010', '110', '1001011']",1,5,20,10,3,30,5.655433455433456,31,32
"['010000', '100', '0110', '001011', '1110']",1,5,13,10,4,23,5.503968253968254,30,29
"['001', '000', '11']",1,3,5,3,2,8,1.0666666666666667,6,6
"['0', '0010', '1101011', '011']",1,4,7,8,0,15,2.866883116883117,21,13
"['1011', '110', '10011', '1111']",1,4,4,12,2,16,3.4761904761904763,11,29
"['1110111', '01', '11011', '001', '010001', '1100010', '1101000', '100', '101']",1,9,20,23,6,43,21.301803751803753,115,107
"['01', '11011', '0111']",1,3,3,8,0,11,1.9047619047619047,7,9
"['01', '0110', '0100']",1,3,6,4,2,10,2.083333333333333,5,11
"['0', '101', '0111100']",1,3,5,6,0,11,1.15,13,4
"['001', '101', '10000', '10100', '011010']",1,5,13,9,4,22,5.900505050505051,25,26
"['0', '00100', '1100', '0111110']",1,4,9,8,0,17,2.6954545454545453,23,21
"['110000', '101', '11']",1,3,5,6,0,11,1.7444444444444445,9,10
"['1110010', '10', '0011100']",1,3,8,8,2,16,1.6031746031746033,14,7
"['11110', '01', '101001', '10010', '111101']",1,5,9,15,4,24,5.302597402597403,29,31
"['101', '110', '10000', '11']",1,4,6,7,2,13,3.552380952380952,14,17
"['01101', '0001', '1010', '0000', '01001', '01000']",1,6,18,9,6,27,9.505555555555555,29,51
"['101', '10111', '1001', '1101011', '1110110', '1000', '000001', '010011', '000111']",1,9,22,26,7,48,22.068265068265067,105,121
"['10001', '10010', '10', '0000000']",1,4,14,5,2,19,3.165079365079365,22,15
"['1', '0001110', '101010', '110001', '1110']",1,5,11,13,2,24,4.846137196137196,38,24
"['1001010', '101', '1110']",1,3,6,8,0,14,1.535064935064935,9,8
"['01', '110', '01010', '0000']",1,4,9,5,0,14,2.757142857142857,15,16
"['0', '01', '110', '0111100']",1,4,6,7,0,13,2.861111111111111,20,15
"['1011010', '11000', '0001', '00110', '100011', '011001', '1011011']",1,7,20,20,6,40,13.962737262737264,59,58
"['0011', '0110010', '100', '0100100']",1,4,13,8,2,21,3.7194805194805194,21,19
"['11110', '1010101', '1', '001101']",1,4,7,12,0,19,2.209373959373959,23,16
"['0010110', '1000110', '1001100']",1,3,12,9,3,21,2.4285714285714284,7,12
"['011011', '01', '1110', '0000']",1,4,8,8,2,16,2.4166666666666665,20,14
"['111110', '11100', '1010101', '100010']",1,4,10,14,2,24,3.0291375291375293,16,16
"['000110', '01', '100', '100011']",1,4,10,7,2,17,3.3444444444444446,19,13
"['110010', '001011', '10', '000', '1001111']",1,5,12,12,2,24,5.629059829059829,36,25
"['1010110', '100001', '00', '1010011', '0100']",1,5,15,11,2,26,6.198013098013098,32,23
"['001', '11', '11000', '100011', '0000', '101111']",1,6,13,13,2,26,7.378210678210678,48,47
"['001', '011', '00110', '011110', '0110010']",1,5,12,12,2,24,6.640947940947941,27,38
"['00110', '000', '101111', '11']",1,4,7,9,0,16,2.589105339105339,20,12
"['01', '0110111', '011']",1,3,4,8,0,12,1.8444444444444446,10,11
"['0011', '111000', '01111', '010110']",1,4,9,12,2,21,3.624242424242424,19,18
"['11', '100', '0010101', '110100', '1010', '10010']",1,6,14,13,0,27,9.881834831834832,40,42
"['00110', '01111', '111']",1,3,4,9,2,13,1.85,7,8
"['1000', '1110', '11']",1,3,4,6,2,10,1.5,7,8
"['1000011', '00', '110', '1101']",1,4,8,8,0,16,2.98037518037518,20,14
"['1010000', '1000101', '0100100', '11111']",1,4,14,12,3,26,3.4523809523809526,22,12
"['0011001', '01', '0100100']",1,3,10,6,2,16,1.6031746031746033,13,9
"['00110', '1001', '11']",1,3,5,6,0,11,1.9047619047619047,8,4
"['011', '0110011', '00111', '111111', '000', '1110', '0100']",1,7,13,19,4,32,10.53912198912199,65,69
"['0001', '0011110', '011010', '110', '01110', '1110']",1,6,13,16,2,29,9.527239427239428,38,59
"['0', '100010', '11']",1,3,5,4,0,9,0.7857142857142857,11,4
"['100', '010001', '10']",1,3,7,4,0,11,1.9666666666666668,8,7
"['00', '001', '0100']",1,3,7,2,0,9,2.038095238095238,5,13
"['1100111', '1', '100001', '01010']",1,4,9,10,0,19,2.52988677988678,26,12
"['110011', '101000', '0100101', '000010']",1,4,15,10,3,25,3.9743589743589745,16,12
"['11110', '1000', '1111011']",1,3,5,11,0,16,1.6414141414141414,10,11
"['11010', '010000', '11', '0000', '0100']",1,5,14,7,2,21,4.911327561327561,28,34
"['01', '00101', '11111']",1,3,4,8,2,12,1.2571428571428571,10,7
"['11010', '100', '1']",1,3,4,5,0,9,1.5833333333333333,8,6
"['1101', '111100', '01011', '1111']",1,4,5,14,2,19,3.624747474747475,14,27
"['1010', '01101', '10011', '1111110']",1,4,7,14,2,21,3.1303030303030304,20,15
"['001', '1', '011', '000', '0101']",1,5,8,6,3,14,5.066666666666666,18,22
"['00', '111010', '11']",1,3,4,6,2,10,1.0,10,6
"['01', '0110100', '011101', '10010', '01001', '01000']",1,6,17,13,3,30,9.646142746142747,42,49
"['11110', '0101111', '100', '1111010', '00', '0100101']",1,6,13,18,3,31,8.066666666666666,55,45
"['01101', '100', '0011010', '0001111', '0001100']",1,5,16,13,3,29,6.552380952380952,31,35
"['001', '01101', '11', '001010', '0000']",1,5,12,8,0,20,5.181240981240981,27,25
"['11110', '010', '11010', '111', '00', '0001010', '000100']",1,7,17,14,4,31,11.005977355977356,64,74
"['000110', '11', '00011', '10', '110']",1,5,9,9,2,18,6.0329004329004325,26,31
"['110110', '101', '100101', '01001', '001011']",1,5,12,14,3,26,6.916666666666666,27,28
"['1101001', '101', '10000', '1000000', '1110001', '1011', '110', '01000']",1,8,23,18,7,41,16.295815295815295,88,88
"['110110', '01', '10', '110101']",1,4,6,10,4,16,3.3333333333333335,20,17
"['101011', '1001', '0110', '0111']",1,4,7,11,3,18,3.75,14,14
"['0', '111', '10100', '00010', '110']",1,5,9,8,4,17,4.183333333333334,29,22
"['011100', '10101', '0110', '000101', '0100']",1,5,14,11,4,25,6.433838383838384,24,31
"['0010', '1111001', '0111011']",1,3,7,11,2,18,1.8051948051948052,11,5
"['0101101', '00', '1']",1,3,5,5,0,10,0.6944444444444444,13,4
"['1101', '1011001', '0011010']",1,3,8,10,2,18,2.168831168831169,9,5
"['01100', '001', '0111', '00011']",1,4,9,8,2,17,3.7547619047619047,15,18
"['001', '0011010', '0111']",1,3,7,7,0,14,1.8987012987012988,9,8
"['011101', '1011', '0001']",1,3,6,8,2,14,1.5,8,7
"['011011', '00', '000101', '111101']",1,4,9,11,3,20,3.083333333333333,22,15
"['00001', '1', '01000', '111100']",1,4,10,7,2,17,2.4614718614718614,23,14
"['01', '1001', '011', '000']",1,4,7,5,2,12,3.342857142857143,11,12
"['0001011', '0000101', '00']",1,3,11,5,2,16,1.746031746031746,12,12
"['0', '110111', '01001', '10011']",1,4,7,10,2,17,3.025108225108225,20,12
"['0', '1111', '100101', '1101', '110']",1,5,6,12,2,18,5.208730158730159,26,28
"['1000', '100001', '001111']",1,3,9,7,2,16,1.7000000000000002,11,10
"['01', '0000100', '1101', '0000']",1,4,12,5,2,17,2.7853535353535355,21,19
"['0', '10100', '0110', '111001']",1,4,8,8,0,16,2.790764790764791,19,10
"['0', '1011', '0000010']",1,3,8,4,0,12,1.0136363636363637,14,4
"['11101', '011', '0100100']",1,3,7,8,0,15,1.6,11,6
"['1001001', '110', '001110']",1,3,8,8,0,16,1.682051282051282,11,6
"['00', '10010', '01000']",1,3,9,3,2,12,1.9428571428571428,8,10
"['0', '1000101', '10000', '11']",1,4,9,6,0,15,2.1468253968253967,23,13
"['0111000', '01', '10', '0100']",1,4,9,6,2,15,3.4494949494949494,19,18
"['1101001', '00', '0101', '00010']",1,4,11,7,0,18,3.3946608946608947,19,13
"['0011', '1001', '00', '00010', '110']",1,5,11,7,2,18,6.030952380952381,23,25
"['111100', '01110', '100010']",1,3,8,9,2,17,1.7727272727272727,9,7
"['001', '0110', '000111', '0100']",1,4,10,7,2,17,3.5595238095238093,15,18
"['10100', '101100', '11000']",1,3,9,7,2,16,2.4363636363636365,5,12
"['11001', '101011', '01']",1,3,5,8,0,13,1.435064935064935,9,10
"['01111', '001', '100', '110100']",1,4,8,9,2,17,2.8914141414141414,20,17
"['00111', '0010110', '0001110', '1']",1,4,10,10,2,20,3.357142857142857,22,16
"['00111', '000110', '1']",1,3,6,6,0,12,1.3463203463203464,11,5
"['11010', '011010', '01000', '0000']",1,4,13,7,2,20,3.7656565656565655,12,27
"['011011', '0110', '0010101', '11101', '01011']",1,5,11,16,2,27,7.1995337995338,22,30
"['1100011', '100011', '000', '000010']",1,4,14,8,2,22,4.138461538461538,16,18
"['0010', '01', '1100001', '100', '000', '0011011']",1,6,16,10,4,26,8.494949494949495,49,40
"['100', '1', '010000']",1,3,7,3,0,10,1.4523809523809523,10,5
"['1001110', '01', '11010', '1101000', '110111']",1,5,11,16,2,27,5.976967476967477,32,33
"['0000', '1', '10011', '0100']",1,4,9,5,2,14,2.3444444444444446,18,10
"['0001011', '001', '100011', '1111011']",1,4,10,13,2,23,3.6227106227106227,20,24
"['1011', '1011101', '010000', '1111']",1,4,8,13,2,21,3.0160839160839163,20,17
"['0', '110', '0011111']",1,3,4,7,0,11,1.15,13,7
"['00001', '110001', '1100', '110']",1,4,10,8,0,18,3.7455266955266957,15,23
"['11010', '100111', '1']",1,3,4,8,0,12,1.1645021645021645,12,9
"['1011', '10110', '0100']",1,3,6,7,2,13,2.0555555555555554,6,7
"['1011010', '00101', '011100', '0100010', '100101', '1100110']",1,6,20,18,5,38,9.463203463203463,44,39
"['01', '100000', '11111']",1,3,6,7,0,13,0.7175324675324675,14,6
"['0010', '011', '101101', '0000001', '0010101', '111111', '1010001', '111000']",1,8,23,23,6,46,15.084360084360084,95,83
"['0110101', '001', '111', '10111', '1110']",1,5,7,15,2,22,5.604978354978355,27,33
"['010001', '00000', '10001', '0010101', '1111', '101110']",1,6,18,15,4,33,8.004817404817405,45,37
"['0', '10111', '0011', '110101']",1,4,6,10,0,16,3.012987012987013,19,13
"['11011', '01101', '0011001', '101011', '011101', '01010']",1,6,14,20,5,34,10.796736596736597,35,41
"['0101111', '1011110', '10110', '010101', '10', '10011', '0000']",1,7,16,20,4,36,12.229059829059828,69,56
"['0010110', '0011', '1110101', '0010010', '0101']",1,5,15,14,5,29,6.931818181818182,30,30
"['0', '00101', '101101', '11', '1001']",1,5,8,10,0,18,4.769264069264069,29,25
"['1011001', '1', '10010', '000', '110', '101001', '110101']",1,7,15,16,4,31,10.884948384948386,66,58
"['1111001', '10100', '0111001', '0000011']",1,4,13,13,3,26,3.380952380952381,20,19
"['11001', '101', '1011000']",1,3,7,8,0,15,2.0166666666666666,9,11
"['00010', '010000', '1111']",1,3,9,6,0,15,1.1494949494949496,11,6
"['0101', '010', '100', '1001101']",1,4,9,8,2,17,4.022510822510823,16,16
"['010', '00101', '0011', '10001', '1011']",1,5,11,10,4,21,6.631746031746031,19,24
"['101', '0101011', '1', '0100101']",1,4,8,10,2,18,2.7714285714285714,24,18
"['101100', '010', '1100001', '111111', '0000', '1100', '1001111', '1110']",1,8,18,23,7,41,14.347952047952049,94,84
"['101', '00', '010']",1,3,5,3,2,8,1.8666666666666667,5,4
"['101', '1010', '000000', '011001']",1,4,12,7,2,19,3.079365079365079,20,13
"['11010', '001101', '11']",1,3,5,8,0,13,1.7987012987012987,10,8
"['00110', '1100', '1']",1,3,5,5,0,10,1.4,10,5
"['11011', '0011', '010010', '10', '000']",1,5,11,9,0,20,5.104978354978355,29,24
"['0', '01', '1111101', '0111']",1,4,4,10,0,14,2.973232323232323,21,14
"['11010', '110', '1', '0000', '11100']",1,5,9,9,2,18,4.641269841269841,29,25
"['01', '11', '0000011', '001011', '1110']",1,5,10,11,2,21,4.767909867909868,36,31
"['1011001', '1100001', '110111', '0111', '111101']",1,5,10,20,4,30,6.515218115218115,29,50
"['1101', '001', '100011', '1001101']",1,4,9,11,0,20,3.734598734598735,17,26
"['01', '001101', '110011', '1010', '0011111']",1,5,10,15,2,25,5.726029526029526,36,26
"['1101', '000000', '0100']",1,3,10,4,2,14,1.1,10,6
"['1000011', '001000', '0100']",1,3,12,5,0,17,1.9608391608391609,10,6
"['01', '00000', '10000', '10100', '1000', '01110']",1,6,18,8,4,26,7.714285714285714,38,54
"['00100', '11101', '1', '101011']",1,4,7,10,2,17,2.4432900432900433,21,13
"['0', '0110101', '0100001', '0111']",1,4,10,9,2,19,2.744155844155844,24,17
"['110011', '00110', '001', '000']",1,4,10,7,2,17,4.005050505050505,15,16
"['1111100', '0000110', '0110']",1,3,9,9,2,18,1.7012987012987013,12,12
"['1000', '1110100', '000']",1,3,9,5,0,14,1.8025974025974025,8,13
"['100', '011', '10']",1,3,4,4,2,8,1.5333333333333334,6,7
"['0111000', '10', '1001010']",1,3,9,7,2,16,1.4603174603174602,14,8
"['10101', '0000', '11111', '110', '1110']",1,5,8,13,4,21,4.548412698412698,26,27
"['101100', '010', '00110', '011110', '01000']",1,5,14,11,4,25,6.605050505050505,25,43
"['1100', '110001', '1']",1,3,5,6,0,11,1.4857142857142858,10,11
"['010101', '111', '00000']",1,3,8,6,0,14,1.212121212121212,11,4
"['010001', '00101', '00001', '0100010', '1111001', '1101', '011010']",1,7,22,18,6,40,12.916106116106116,56,64
"['1110111', '010', '100']",1,3,5,8,2,13,1.4666666666666668,12,4
"['010', '0010111', '00001', '111011', '1111']",1,5,10,15,0,25,4.876856476856477,33,32
"['011101', '1010101', '11100', '111101']",1,4,8,16,2,24,3.710955710955711,12,24
"['0111000', '0010111', '100010', '1100101', '01010', '11111', '0000110']",1,7,22,22,6,44,12.316416916416916,72,54
"['0', '101', '10111']",1,3,3,6,0,9,1.5833333333333333,8,6
"['11111', '0010', '111110', '111011']",1,4,5,16,2,21,3.507070707070707,16,28
"['0100111', '100001', '11', '100', '1101011']",1,5,11,14,2,25,5.6006105006105,36,36
"['0111001', '001111', '1']",1,3,5,9,0,14,1.304945054945055,14,6
"['111', '001000', '100', '1001000', '1100101', '1100011', '111000']",1,7,21,18,7,39,13.36947496947497,69,78
"['011011', '0001000', '100010']",1,3,12,7,2,19,1.7307692307692308,11,6
"['1010001', '1010', '1', '101001']",1,4,9,9,0,18,3.386063936063936,20,30
"['100', '1001011', '0100']",1,3,8,6,0,14,2.0025974025974023,9,8
"['01', '1', '110001', '10010', '000001']",1,5,12,8,2,20,5.082251082251082,34,27
"['0', '011', '1101101', '001010', '00010', '101001']",1,6,15,13,2,28,7.927256077256077,52,31
"['011110', '1111110', '000']",1,3,6,10,0,16,1.4136752136752138,12,12
"['110010', '0111001', '1', '10101', '100100', '00110', '1000', '001100', '000100']",1,9,27,19,6,46,21.428754578754578,109,102
"['0', '010', '101010', '01110']",1,4,8,7,0,15,2.8993506493506493,18,23
"['1111100', '01', '111', '011100', '010010', '00']",1,6,12,14,4,26,7.1752136752136755,53,45
"['11', '1010', '000001', '0100']",1,4,10,6,2,16,2.8,19,11
"['11110', '010', '011', '00111', '10']",1,5,7,11,4,18,5.5738095238095235,25,28
"['00101', '101', '00110', '100101', '1001001']",1,5,14,12,2,26,7.3761072261072265,24,39
"['111111', '01001', '01111', '01011']",1,4,6,15,3,21,3.4545454545454546,13,25
"['110011', '10', '11']",1,3,3,7,2,10,1.5,9,12
"['101100', '01', '0001110', '10', '0111']",1,5,10,11,2,21,5.331546231546231,34,24
"['1010110', '111110', '001']",1,3,6,10,0,16,1.3914529914529914,11,8
"['1111010', '0010', '010', '0111']",1,4,8,10,2,18,3.6194805194805193,17,23
"['101001', '000', '11']",1,3,6,5,0,11,0.9444444444444444,10,4
"['01', '0100110', '101010', '011111', '111000', '0000110', '101111', '110101']",1,8,20,26,7,46,15.56013431013431,99,76
"['0101', '0111001', '100']",1,3,7,7,0,14,1.8987012987012988,9,8
"['0', '000110', '1101000', '1011']",1,4,10,8,0,18,2.5427072927072927,25,13
"['1000010', '001100', '00']",1,3,11,4,0,15,1.4059829059829059,13,12
"['1', '10', '1001101']",1,3,4,6,0,10,1.3611111111111112,12,9
"['0010', '000111', '0000011', '1100000']",1,4,16,8,2,24,3.6359640359640357,22,26
"['100', '111011', '1000', '10', '000']",1,5,10,8,2,18,5.814285714285714,25,29
"['0', '10', '110111']",1,3,3,6,0,9,1.4523809523809523,10,4
"['0000101', '1100', '110100', '111100']",1,4,12,11,2,23,3.3995337995337995,19,26
"['10101', '100000', '0101001', '00011']",1,4,14,9,2,23,3.652447552447552,17,16
"['110000', '101011', '00010', '0111']",1,4,11,10,2,21,3.0505050505050506,20,15
"['01', '10110', '011110', '11']",1,4,5,10,2,15,3.37012987012987,17,13
"['100', '111010', '101111']",1,3,5,10,2,15,1.7777777777777777,10,9
"['010', '10', '011000']",1,3,7,4,0,11,1.9666666666666668,8,10
"['11110', '010', '1111010', '00', '1011100']",1,5,10,14,2,24,6.198412698412699,32,32
"['0', '101011', '1101000', '1000', '01011']",1,5,12,11,0,23,5.065240315240315,35,28
"['010', '1111101', '001000', '0110', '011111', '000111', '110', '1011111']",1,8,16,26,7,42,15.559651459651459,94,86
"['11001', '11', '0001', '100', '10', '1100011']",1,6,11,12,2,23,8.547113997113996,41,50
"['11001', '10', '0111', '1011', '0110001']",1,5,9,13,2,22,5.983044733044733,29,30
"['0010', '110', '1011111']",1,3,5,9,0,14,1.335064935064935,12,6
"['101', '0110010', '1101000', '111']",1,4,9,11,4,20,3.780952380952381,20,12
"['101100', '00101', '0011', '1001', '1000', '111110', '0000', '101110']",1,8,20,19,7,39,16.226767676767675,74,85
"['101', '0100111', '10000', '1101100']",1,4,11,11,2,22,3.2714285714285714,22,15
"['1001110', '001', '011']",1,3,6,7,2,13,1.8666666666666667,9,6
"['10101', '100', '00101']",1,3,7,6,2,13,2.05,6,11
"['101', '111111', '10', '0000']",1,4,6,9,0,15,2.1134920634920635,22,11
"['00010', '0111101', '1100', '0000']",1,4,12,8,2,20,3.242424242424242,19,21
"['00010', '1', '000', '1101010']",1,4,10,6,0,16,2.433333333333333,22,16
"['101100', '001', '110', '001010']",1,4,10,8,4,18,3.222222222222222,19,17
"['101010', '100', '110111', '000', '1011', '110', '1111111']",1,7,11,21,5,32,10.35972915972916,67,65
"['101', '10100', '100', '000']",1,4,9,5,3,14,3.6666666666666665,10,20
"['101011', '00', '01111', '000001']",1,4,10,9,2,19,2.5281385281385282,21,13
"['001', '110', '1100100', '000', '1100']",1,5,12,8,3,20,5.86060606060606,27,37
"['1110101', '101', '11000', '0110']",1,4,8,11,0,19,3.55021645021645,20,13
"['01', '11010', '0010000', '00110', '1100', '1101010']",1,6,17,13,4,30,8.864790764790765,49,51
"['101010', '1011101', '010', '01010']",1,4,10,11,0,21,4.161655011655012,15,22
"['10100', '1000110', '000100']",1,3,12,6,0,18,1.9965034965034967,7,11
"['010', '1001000', '10']",1,3,8,4,0,12,1.8444444444444446,10,8
"['111100', '11', '101000', '0101011', '100010', '100011', '110101']",1,7,18,21,5,39,12.367521367521368,67,70
"['001100', '1010', '01010']",1,3,9,6,0,15,2.216161616161616,7,11
"['010', '111110', '001010', '1']",1,4,7,9,2,16,2.515873015873016,22,14
"['0100010', '1010101', '00', '01001', '000111']",1,5,16,11,2,27,6.299311799311799,33,24
"['001', '0011100', '11000', '10110', '1111', '00', '011110', '01000']",1,8,19,18,3,37,15.332867132867133,84,87
"['0011001', '0011', '1000110', '11000', '1111']",1,5,13,14,4,27,5.8001443001443,33,30
"['1010', '011', '11']",1,3,3,6,0,9,2.038095238095238,5,8
"['100', '00110', '1010010', '1100', '01110']",1,5,13,11,2,24,6.317748917748918,26,31
"['11', '1010', '010', '1001']",1,4,6,7,2,13,3.9119047619047618,12,13
"['110000', '110', '10']",1,3,6,5,0,11,1.9666666666666668,8,9
"['100110', '010', '1', '011110']",1,4,7,9,2,16,2.849206349206349,21,15
"['110110', '01', '011', '00001', '101010', '1100']",1,6,13,13,2,26,8.514574314574315,43,38
"['100110', '01001', '11']",1,3,6,7,0,13,1.7987012987012987,10,6
"['0101010', '0010010', '1101101', '111']",1,4,11,13,3,24,3.742857142857143,22,12
"['0111001', '0000001', '00011']",1,3,12,7,2,19,1.7380952380952381,10,10
"['0001010', '0001', '11101', '110100']",1,4,12,10,0,22,3.4143745143745146,19,17
"['11010', '0010111', '011', '110100', '00110', '000', '01010', '1001100', '1110']",1,9,23,22,7,45,22.16003996003996,99,118
"['1100001', '000101', '1111', '00', '000001', '10']",1,6,16,11,4,27,6.668958818958819,54,42
"['101011', '10011', '01100', '1111']",1,4,7,13,2,20,3.3434343434343434,16,19
"['00', '100100', '10']",1,3,7,3,2,10,1.5,9,9
"['00111', '100', '0']",1,3,5,4,0,9,1.3333333333333333,10,7
"['01', '11011', '01010']",1,3,5,7,2,12,1.7428571428571429,8,5
"['01', '011', '0010011', '0111', '101110']",1,5,9,13,0,22,6.4957597957597955,29,28
"['0011001', '1', '1001010', '100010']",1,4,12,9,2,21,2.741758241758242,26,16
"['0010000', '11101', '0110', '01010']",1,4,12,9,2,21,3.701010101010101,18,14
"['01', '110111', '011110', '0101001', '101001']",1,5,11,16,3,27,5.931623931623932,34,28
"['001', '01101', '1', '00101']",1,4,7,7,2,14,3.216666666666667,15,18
"['0111000', '00', '011010', '111000']",1,4,12,9,2,21,3.8034188034188032,18,29
"['010001', '0110111', '100110', '10', '0111', '0100100', '1001111']",1,7,18,21,5,39,12.544322344322344,71,63
"['1000001', '01', '110', '00001']",1,4,11,6,0,17,2.899206349206349,21,18
"['0001001', '0001', '010']",1,3,10,4,0,14,1.8987012987012988,9,11
"['0110101', '00110', '000', '11']",1,4,9,8,0,17,3.0325396825396824,20,12
"['1010110', '010', '10010', '000', '001100', '01100']",1,6,18,11,4,29,10.107109557109556,38,59
"['1011', '01', '011001']",1,3,5,7,0,12,1.7666666666666666,9,8
"['011011', '101', '00000']",1,3,8,6,0,14,1.2803030303030303,11,4
"['101000', '00110', '0001110', '0110']",1,4,13,9,0,22,3.6746697746697747,16,29
"['11001', '01', '100100', '10']",1,4,8,7,2,15,3.37012987012987,19,14
"['0010', '1000110', '0011110', '10', '1100111', '1110']",1,6,14,17,5,31,9.30952380952381,50,48
"['0', '1100011', '011001']",1,3,7,7,0,14,1.304945054945055,14,4
"['1011', '10111', '0011']",1,3,4,9,2,13,2.3055555555555554,4,15
"['0', '10101', '110001', '00001']",1,4,10,7,2,17,2.806926406926407,19,15
"['010011', '1100', '01111', '100011']",1,4,9,12,2,21,3.5686868686868687,16,21
"['1100010', '10111', '1']",1,3,5,8,0,13,1.0833333333333333,14,9
"['00', '110', '100010']",1,3,7,4,0,11,1.3444444444444446,9,7
"['1111101', '011', '1100010', '1001', '1000000', '1010', '110111', '10011', '01001', '101111']",1,10,23,31,9,54,26.713625263625264,141,159
"['11001', '01', '011', '00000', '11', '1000']",1,6,12,9,4,21,6.964285714285714,41,39
"['011101', '111111', '010011', '0100']",1,4,8,14,3,22,3.1,18,17
"['01', '010', '111011', '11101', '000', '1100011']",1,6,11,15,2,26,8.144194694194693,47,40
"['1111100', '010000', '011', '00100', '110001', '0000', '001011']",1,7,22,15,3,37,11.545077145077144,71,76
"['0010', '110', '10']",1,3,5,4,0,9,2.038095238095238,5,9
"['11', '10111', '100', '1001000', '1011000', '0001010', '01100']",1,7,20,16,5,36,12.002380952380951,68,64
"['1101101', '0101', '1100', '010000']",1,4,11,10,2,21,3.4342657342657343,18,17
"['010', '010110', '11']",1,3,5,6,0,11,1.5666666666666667,9,7
"['01', '0011', '1100000', '1010', '010111', '1100', '1111111']",1,7,14,20,5,34,9.943328893328893,80,64
"['11001', '010100', '11', '0001', '100', '1001000', '11101', '01001']",1,8,20,17,3,37,16.978177378177378,77,83
"['101', '100', '011100']",1,3,6,6,2,12,1.7777777777777777,8,7
"['1', '00000', '1010', '11101', '001100']",1,5,12,9,2,21,4.202886002886003,34,20
"['0', '11000', '00010', '101001']",1,4,11,6,2,17,3.006926406926407,21,12
"['01', '11', '10110', '0010011', '00110', '1100', '1110']",1,7,13,16,6,29,12.355916305916306,59,60
"['0001', '10001', '10100', '010110', '01010']",1,5,15,10,3,25,6.35959595959596,23,27
"['1000', '100', '0111', '111110']",1,4,7,10,2,17,2.837301587301587,19,17
"['110001', '100010', '1001101', '10', '1100110', '110']",1,6,15,16,4,31,9.613553113553113,46,51
"['0001', '00', '1', '101101']",1,4,7,6,0,13,2.2523809523809524,19,13
"['0010', '111', '111010', '01111', '10000', '0100001', '1011011', '001011']",1,8,20,23,6,43,15.58029748029748,89,84
"['011', '10101', '000101', '100111', '1011', '1111111']",1,6,10,21,2,31,9.383444333444334,42,61
"['0110111', '0110', '01110']",1,3,6,10,0,16,2.282828282828283,7,17
"['0', '101010', '0011110', '100110', '0111', '1101', '1111111']",1,7,12,23,6,35,9.96931401931402,76,50
"['0000101', '10010', '100010']",1,3,12,6,0,18,2.344988344988345,6,11
"['0110111', '00011', '101', '110001', '010111', '011110', '0100001', '1010000', '0110110']",1,9,26,28,7,54,22.368253968253967,110,105
"['010', '011101', '10', '1100', '0110011']",1,5,10,12,0,22,6.3457098457098455,29,26
"['010', '0010100', '0010000', '11']",1,4,13,6,2,19,3.123809523809524,22,18
"['010', '101', '100', '1000', '001100', '110']",1,6,13,9,4,22,9.615873015873015,32,39
"['0', '0100000', '01111', '10011']",1,4,10,8,2,18,2.35,26,12
"['0010111', '0011110', '110111', '10', '11100']",1,5,10,17,2,27,5.771339771339771,36,33
"['1100011', '010', '00000']",1,3,10,5,0,15,1.4,12,4
"['0011101', '01111', '1001000', '10', '1101', '01100']",1,6,14,16,4,30,8.301298701298702,49,38
"['0111001', '010', '010111', '011']",1,4,8,11,2,19,3.815384615384615,18,21
"['0010', '1001', '001101']",1,3,8,6,2,14,2.15,7,7
"['11', '1000101', '01011', '00000']",1,4,11,8,2,19,2.749206349206349,22,12
"['010100', '1', '10101', '11101', '0101100']",1,5,11,13,2,24,5.331518481518481,32,23
"['0100011', '10', '000011']",1,3,9,6,0,15,1.6175213675213675,11,10
"['0', '10100', '1011110', '111011']",1,4,7,12,0,19,2.6965534465534464,24,12
"['00', '10', '01011', '0111']",1,4,6,7,2,13,2.9761904761904763,14,14
"['1011101', '100001', '110', '10']",1,4,8,10,0,18,3.404273504273504,21,19
"['0110100', '0010010', '1001111']",1,3,11,10,3,21,1.8571428571428572,12,5
"['1011', '010011', '011']",1,3,5,8,0,13,2.3238095238095235,6,13
"['01', '0101000', '11100']",1,3,8,6,0,14,1.3968253968253967,12,8
"['100010', '10010', '01001', '0101', '01000']",1,5,16,9,3,25,7.585858585858586,21,33
"['0001110', '1', '1011100', '1110']",1,4,8,11,2,19,3.068831168831169,24,14
"['0011', '01111', '1000010', '10', '111001']",1,5,11,13,0,24,5.051603951603951,37,26
"['0100111', '0101110', '11', '1011110', '0110']",1,5,10,17,3,27,6.428571428571429,34,31
"['00101', '00011', '1001', '1100', '1110', '111001']",1,6,13,15,5,28,9.402020202020202,39,48
"['10111', '11000', '0000100']",1,3,10,7,2,17,1.2333333333333334,13,8
"['11001', '010', '111', '100110', '01011']",1,5,9,13,4,22,5.798989898989899,25,26
"['010100', '1', '010010']",1,3,8,5,2,13,1.2380952380952381,12,6
"['11011', '1110000', '1000111', '110011', '1010', '1011']",1,6,13,20,4,33,9.91917526917527,43,71
"['11010', '011', '11000', '010101', '1010000', '00010']",1,6,18,13,3,31,9.0002331002331,42,43
"['011', '100', '1100111', '101110', '0001000', '1110']",1,6,14,16,4,30,8.377955377955377,53,40
"['101100', '10110', '1', '1111011']",1,4,6,13,0,19,3.06018981018981,22,18
"['11001', '1101', '0111010', '0101001']",1,4,10,13,2,23,4.375901875901876,15,18
"['11001', '110010', '1', '0001', '01001', '00010']",1,6,15,11,3,26,9.093795093795094,38,45
"['0011', '10100', '110']",1,3,6,6,0,12,1.5158730158730158,8,8
"['1011010', '1', '101101', '1010111', '00010']",1,5,11,15,2,26,5.055944055944056,37,31
"['11100', '11010', '110']",1,3,5,8,2,13,2.3,6,11
"['001', '1100', '000']",1,3,7,3,2,10,1.8095238095238093,6,11
"['00', '010', '000010']",1,3,9,2,0,11,1.9666666666666668,8,16
"['11110', '001', '1101111', '0010', '10', '000111']",1,6,11,16,0,27,7.741935841935842,51,44
"['1000110', '00000', '001000']",1,3,14,4,0,18,1.8275058275058274,8,14
"['01', '111', '1001', '10100', '110111']",1,5,7,13,0,20,5.688311688311688,27,34
"['00111', '00', '1110']",1,3,5,6,0,11,1.5714285714285714,9,10
"['100101', '01111', '111', '101001']",1,4,7,13,2,20,3.840909090909091,16,24
"['00111', '011010', '1110']",1,3,6,9,0,15,1.993939393939394,8,9
"['101100', '01', '100', '0001101', '111111', '000']",1,6,13,14,4,27,6.404700854700855,55,42
"['0001001', '001', '01011']",1,3,9,6,0,15,1.7666666666666666,9,9
"['0110010', '01101', '100001', '100010']",1,4,14,10,2,24,3.9603729603729603,17,20
"['0011', '11010', '00']",1,3,6,5,0,11,1.6825396825396823,8,9
"['1101001', '00110', '1100101', '10']",1,4,10,11,2,21,3.341269841269841,23,14
"['110001', '100', '0101001']",1,3,9,7,0,16,2.0358974358974358,9,8
"['010', '00100', '0001', '000', '01110']",1,5,14,6,4,20,6.556349206349206,20,44
"['0', '1101110', '11001']",1,3,5,8,0,13,1.25,13,6
"['001', '1001000', '111101', '1001101']",1,4,11,12,2,23,3.5894993894993896,20,23
"['100000', '0110011', '01100', '0000']",1,4,15,7,0,22,3.4484071484071483,17,27
"['001', '0100110', '00', '0111', '1011', '111101', '0100']",1,7,14,16,3,30,11.551892551892552,63,53
"['0011', '000', '11111']",1,3,5,7,0,12,1.0158730158730158,10,8
"['01', '001101', '1001010', '101', '11100']",1,5,11,12,0,23,5.611510711510712,33,26
"['00110', '1', '1100100', '00000']",1,4,12,6,2,18,2.5166666666666666,23,15
"['01', '11101', '1111000', '0000']",1,4,9,9,0,18,2.5613275613275612,23,17
"['0011', '010111', '11']",1,3,4,8,0,12,1.9666666666666668,8,11
"['1101', '100', '111101']",1,3,4,9,0,13,1.8158730158730159,8,12
"['11001', '1', '011']",1,3,3,6,0,9,1.3333333333333333,9,9
"['101100', '101', '111100']",1,3,6,9,2,15,1.9444444444444444,8,11
"['11110', '110', '000']",1,3,5,6,2,11,1.3333333333333333,8,9
"['11001', '00', '10']",1,3,5,4,2,9,1.6428571428571428,7,4
"['110000', '11001', '001000', '0110', '0101']",1,5,15,10,4,25,6.222727272727273,29,26
"['0', '1111', '1010', '11101', '00010']",1,5,8,11,4,19,4.411111111111111,30,22
"['0010110', '101010', '100', '111010']",1,4,11,11,2,22,3.6307692307692307,16,19
"['0010110', '1111100', '111', '00', '0111']",1,5,9,14,2,23,4.741702741702741,36,33
"['0001011', '001010', '1111101', '0000']",1,4,13,11,2,24,3.3684315684315687,22,18
"['001', '010', '0001110', '00000', '1010101']",1,5,16,9,4,25,5.604761904761904,35,29
"['11000', '110', '111', '10']",1,4,5,8,2,13,3.6880952380952383,12,19
"['1010111', '111', '00011']",1,3,5,10,0,15,1.7666666666666666,10,15
"['1110101', '001001', '10011', '0']",1,4,9,10,0,19,2.545038295038295,24,12
"['10110', '10', '11']",1,3,3,6,2,9,1.6428571428571428,7,8
"['1011', '1000', '10', '00000']",1,4,10,5,2,15,3.007936507936508,16,17
"['011101', '10011', '0000']",1,3,8,7,0,15,1.38989898989899,11,4
"['00011', '01001', '010010', '011000']",1,4,14,8,4,22,4.542424242424243,13,22
"['01101', '0110100', '11', '100100', '1010', '0111', '0000']",1,7,17,15,3,32,12.065406815406815,59,58
"['101', '1001', '11111', '110', '01000', '1110']",1,6,9,15,6,24,8.446031746031746,37,41
"['1001', '100101', '0110110', '1']",1,4,8,10,0,18,2.8965534465534466,24,16
"['0001100', '11101', '1', '0011100']",1,4,10,10,2,20,2.857142857142857,24,14
"['0', '00100', '11011']",1,3,6,5,2,11,1.0666666666666667,12,4
"['101', '1000110', '0101010']",1,3,9,8,2,17,1.9142857142857141,11,6
"['0001', '0000000', '00001']",1,3,14,2,0,16,2.1010101010101008,8,21
"['101100', '10011', '100010']",1,3,9,8,2,17,1.9545454545454546,8,10
"['1011001', '111', '1110011', '10000', '000000', '1101010']",1,6,18,17,3,35,7.8065767565767565,56,47
"['00111', '0011', '0110010', '0110011']",1,4,11,12,2,23,4.1854256854256855,16,25
"['01', '1000101', '0110111', '11', '1001000']",1,5,12,13,5,25,4.738095238095238,43,28
"['00000', '00101', '01110', '111']",1,4,10,8,3,18,2.85,18,12
"['0', '0110101', '0010', '1011', '000111']",1,5,11,11,2,22,4.923826173826174,34,20
"['0000100', '00100', '1001000', '011001', '011010', '110']",1,6,22,12,4,34,9.581884781884781,44,52
"['0001', '0111', '11']",1,3,4,6,2,10,1.5,7,8
"['01', '00', '0110001']",1,3,7,4,2,11,1.3888888888888888,11,8
"['000001', '01111', '10', '1111111']",1,4,7,13,0,20,1.942085692085692,28,18
"['010011', '10001', '1110', '11']",1,4,7,10,0,17,3.3098124098124098,18,19
"['101', '1000', '000', '0011011', '1101', '0111101']",1,6,13,15,6,28,8.500865800865801,47,44
"['0110101', '00000', '100100', '1111000', '1111', '1000', '01100', '0100']",1,8,24,18,7,42,16.154218004218006,80,99
"['00100', '111000', '000', '01000']",1,4,14,5,2,19,4.239393939393939,14,37
"['0', '1011110', '10', '10011']",1,4,6,9,0,15,2.9325396825396823,22,14
"['111111', '010110', '0100']",1,3,6,10,2,16,1.3333333333333335,10,6
"['1000', '10', '0111', '11']",1,4,5,7,4,12,2.75,15,15
"['000001', '00100', '110010', '011']",1,4,13,7,2,20,3.1616161616161618,20,15
"['0110101', '0001001', '110010', '0110111', '01111', '1101110', '100011']",1,7,19,26,6,45,13.644022644022645,63,64
"['11110', '01', '1101011', '0110', '011101', '000']",1,6,11,16,0,27,7.817476967476967,48,37
"['01', '11110', '111', '101000', '0110000', '01011']",1,6,13,15,2,28,7.374353424353425,51,40
"['010', '110001', '1001000', '0011110', '0001101', '10', '101110']",1,7,20,18,5,38,12.247741147741149,77,56
"['0111', '1001001', '01100', '000']",1,4,11,8,0,19,3.0978354978354976,18,14
"['0', '1010000', '100', '1100']",1,4,10,5,0,15,3.3344155844155843,19,17
"['101100', '1000', '010111', '000', '0101', '01100']",1,6,16,12,4,28,9.172005772005772,37,52
"['100100', '1100010', '001', '011110']",1,4,12,10,2,22,3.275213675213675,22,14
"['010', '0001110', '0010111']",1,3,9,8,2,17,2.057142857142857,10,10
"['110000', '010', '010001', '0011', '0001100', '0100001']",1,6,22,11,4,33,9.316439116439117,48,50
"['110000', '100111', '10', '1011', '0101']",1,5,10,12,4,22,5.783333333333333,31,28
"['01', '0011000', '11', '10', '000']",1,5,10,6,3,16,4.233333333333333,30,24
"['011', '110100', '11']",1,3,4,7,0,11,1.7444444444444445,9,11
"['110000', '10000', '11010', '0110100']",1,4,14,9,2,23,4.3389277389277385,12,20
"['0', '1001', '111001']",1,3,5,6,0,11,1.4857142857142858,10,7
"['110110', '01', '00101', '000001', '1110']",1,5,12,11,2,23,4.573448773448773,35,27
"['1110000', '0110', '011']",1,3,7,7,0,14,1.8025974025974025,10,9
"['0111000', '000110', '0100000', '11010', '111', '1000111', '01010']",1,7,22,18,5,40,12.524314574314575,71,62
"['01111', '1100001', '1001000']",1,3,10,9,2,19,1.380952380952381,13,7
"['001', '0110', '000001']",1,3,9,4,0,13,1.638095238095238,9,9
"['1100', '0110', '1111010', '00010', '0000110']",1,5,15,12,4,27,6.168470418470418,33,40
"['1', '0011010', '0110011']",1,3,7,8,2,15,1.0714285714285714,15,4
"['0100001', '1000100', '001', '1']",1,4,12,6,2,18,2.7714285714285714,25,15
"['1', '1001', '01111', '000101', '01011']",1,5,9,12,2,21,4.936219336219336,30,25
"['11001', '11100', '00011']",1,3,7,8,3,15,1.8,10,10
"['010', '011', '111']",1,3,3,6,3,9,1.6666666666666665,4,7
"['0010', '001', '0111010', '0011', '1010101']",1,5,13,12,4,25,6.199350649350649,27,27
"['00001', '1001000', '1', '101101']",1,4,11,8,0,19,2.3480685980685982,24,18
"['01', '10101', '010010', '11101', '0000', '1011']",1,6,13,13,4,26,8.005988455988456,40,34
"['0', '1101110', '11']",1,3,3,7,0,10,0.6944444444444444,13,6
"['0110', '100111', '11111', '11100', '1011111']",1,5,7,20,2,27,6.05003885003885,28,43
"['01', '11111', '0111', '0100']",1,4,5,10,2,15,3.007936507936508,16,17
"['101101', '0001', '000101', '11101', '000']",1,5,13,11,2,24,5.817243867243867,26,39
"['0011', '1101010', '11']",1,3,5,8,0,13,1.6565656565656566,11,11
"['0', '100', '11001']",1,3,5,4,0,9,1.5833333333333333,8,4
"['1110101', '0101', '1101101']",1,3,6,12,2,18,2.1298701298701297,8,16
"['1110001', '00', '01011']",1,3,7,7,0,14,1.349206349206349,12,5
"['00001', '111110', '01111', '00000']",1,4,11,10,3,21,2.490909090909091,20,21
"['1101011', '1111', '000010', '110', '0111110']",1,5,10,17,2,27,5.222066822066822,37,29
"['0111000', '010', '111', '110100', '001110']",1,5,12,13,4,25,6.2384615384615385,32,27
"['0011001', '10001', '1101101', '00', '010111', '10', '100101']",1,7,17,18,6,35,12.192030192030192,69,57
"['110', '000', '0100']",1,3,7,3,2,10,1.476190476190476,5,10
"['1000100', '1001001', '010']",1,3,11,6,2,17,2.057142857142857,10,6
"['010100', '0100000', '11', '1000110', '10110']",1,5,16,11,2,27,5.58991008991009,34,25
"['0100110', '111100', '11', '10110', '111101', '0100101']",1,6,13,20,4,33,8.91070041070041,48,45
"['110010', '10101', '100', '000101', '1010', '1011', '111000', '1101010']",1,8,20,21,5,41,19.07969807969808,72,89
"['00', '0000100', '101110', '10011']",1,4,12,8,0,20,3.2046842046842046,22,15
"['1101', '1101011', '001111', '11']",1,4,5,14,0,19,3.5537684537684537,20,33
"['101010', '10110', '00', '0000110', '01011', '0100']",1,6,17,12,2,29,9.328327228327229,41,50
"['0', '111111', '011', '10011']",1,4,4,11,0,15,2.3914141414141414,21,16
"['010010', '1', '10', '0001000']",1,4,11,5,0,16,2.916056166056166,24,11
"['0', '011', '0111011', '10101', '100000']",1,5,11,11,0,22,4.461083361083361,39,23
"['101', '011', '111101']",1,3,3,9,2,12,1.7777777777777777,9,11
"['100001', '00111', '00', '0111', '1101', '001011']",1,6,13,14,4,27,8.225974025974025,42,43
"['10111', '011000', '0000']",1,3,9,6,0,15,1.3676767676767676,10,8
"['10100', '0010100', '0100']",1,3,11,5,0,16,2.4494949494949494,6,20
"['110101', '1111000', '11']",1,3,5,10,0,15,1.5598290598290598,12,13
"['101010', '01111', '0110', '0011010']",1,4,10,12,0,22,3.6214452214452213,15,21
"['11100', '11010', '0000110', '100011']",1,4,12,11,2,23,3.478321678321678,20,15
"['010', '1110101', '100000', '011010', '1110']",1,5,13,13,2,26,5.740581640581641,32,26
"['11000', '001', '00101', '000000']",1,4,14,5,2,19,3.1853535353535354,19,25
"['0011', '1001', '1110', '0100']",1,4,8,8,4,16,3.5,15,12
"['1011001', '0111', '11']",1,3,4,9,0,13,1.8383838383838382,10,10
"['1100010', '110', '0000']",1,3,9,5,0,14,1.612987012987013,10,9
"['101', '011', '01110', '001000']",1,4,9,8,2,17,3.3510101010101008,18,12
"['11000', '11100', '110100']",1,3,8,8,2,16,2.4363636363636365,3,14
"['110', '100001', '1111']",1,3,5,8,0,13,1.4158730158730157,10,10
"['010', '1011011', '0100']",1,3,7,7,0,14,2.0025974025974023,9,6
"['0', '0110000', '1010', '1000', '1001100']",1,5,15,8,4,23,5.491558441558442,36,30
"['0110010', '11011', '00', '1011111']",1,4,8,13,2,21,2.6904761904761902,25,10
"['0', '11010', '00101', '00001', '1111']",1,5,10,10,3,20,3.933333333333333,33,22
"['01', '00100', '10001', '1010', '1100101', '1011011']",1,6,15,15,4,30,9.285425685425686,46,38
"['01', '11', '110001', '1011100', '011010']",1,5,10,13,4,23,5.286324786324786,37,22
"['1101', '1', '0100110', '000']",1,4,8,7,0,15,2.081168831168831,23,8
"['000011', '00001', '00111', '100', '10', '10011']",1,6,15,11,3,26,8.750937950937951,41,48
"['11000', '1001', '100', '0000111', '1010001', '1101', '0101']",1,7,18,16,5,34,13.098124098124098,60,68
"['11101', '0010000', '101101']",1,3,9,9,0,18,1.7039627039627039,10,7
"['01', '010000', '11000', '1000010', '110']",1,5,15,8,0,23,5.3877733377733374,33,26
"['1111100', '0101111', '1', '001101', '11101', '1001001']",1,6,12,21,3,33,7.180569430569431,58,49
"['1100', '10', '0100']",1,3,6,4,2,10,2.083333333333333,5,8
"['011', '11', '10101', '10000', '10010', '000']",1,6,13,10,5,23,8.261904761904763,37,38
"['110110', '1001', '1']",1,3,4,7,0,11,1.2857142857142856,11,8
"['0110101', '00', '10']",1,3,6,5,2,11,1.3888888888888888,11,6
"['00', '1101011', '10']",1,3,5,6,2,11,1.3888888888888888,11,4
"['0010001', '01', '1111110', '001110', '0111', '11100']",1,6,13,18,2,31,8.087046287046286,56,45
"['10111', '010', '1001', '0100']",1,4,8,8,2,16,3.7896825396825395,14,11
"['01', '00100', '00']",1,3,7,2,2,9,1.6428571428571428,7,12
"['0100010', '011000', '110011', '100101', '010110', '1110', '0100']",1,7,21,18,6,39,13.713986013986014,58,57
"['0001010', '010', '1001000', '1']",1,4,12,6,2,18,2.914285714285714,24,14
"['100', '000101', '1111', '001001', '1110']",1,5,11,12,4,23,5.151587301587302,31,28
"['111111', '010', '100111']",1,3,4,11,2,15,1.1666666666666665,11,8
"['1', '1110', '011001']",1,3,4,7,0,11,1.2857142857142856,11,6
"['11011', '010', '1']",1,3,3,6,0,9,1.3333333333333333,9,4
"['0', '11010', '01111']",1,3,4,7,2,11,1.2666666666666666,11,7
"['101000', '01111', '00101']",1,3,8,8,2,16,1.509090909090909,9,7
"['1111101', '10101', '10', '000', '1011']",1,5,8,13,0,21,5.002597402597402,32,27
"['11110', '1101111', '10000', '0000', '0101', '1100']",1,6,14,15,5,29,7.506060606060606,46,45
"['01', '01001', '1110011', '0000']",1,4,10,8,0,18,2.8239538239538238,21,12
"['010000', '011', '0101', '1100', '01000']",1,5,14,8,2,22,6.315440115440115,24,38
"['10100', '100', '1', '01010']",1,4,8,6,2,14,3.466666666666667,16,13
"['11011', '11', '110001', '111011', '0011011']",1,5,8,18,2,26,6.536852036852037,29,67
"['0', '10111', '111010']",1,3,4,8,0,12,1.1645021645021645,12,6
"['001000', '000101', '0011111', '001100', '000100', '101111']",1,6,21,16,5,37,9.256410256410257,40,68
"['1111100', '00011', '11']",1,3,5,9,0,14,1.349206349206349,13,12
"['00011', '0110', '110011', '000', '1010010', '01011']",1,6,16,14,2,30,9.883588633588634,40,43
"['0101010', '001', '1001']",1,3,8,6,0,14,1.6207792207792209,8,6
"['0', '00110', '11011', '00001']",1,4,9,7,3,16,2.6,21,11
"['1011001', '01001', '0110', '111101']",1,4,9,13,0,22,3.6524475524475526,15,16
"['010011', '101110', '11']",1,3,5,9,2,14,1.6666666666666665,11,8
"['01', '0111011', '0111']",1,3,4,9,0,13,1.8383838383838382,10,12
"['0000', '01', '0011000', '100010']",1,4,14,5,0,19,3.238616938616939,21,20
"['111100', '000001', '11']",1,3,7,7,2,14,1.0833333333333333,14,9
"['0011101', '00001', '110001', '111111', '100011', '10', '000']",1,7,17,18,3,35,10.55883005883006,73,60
"['0110101', '010001', '1', '110']",1,4,8,9,0,17,2.6955433455433457,23,14
"['001', '1', '101011', '10110', '00110', '001110']",1,6,12,14,4,26,8.656782106782106,43,42
"['1101001', '11', '100', '110100', '1101100']",1,5,11,14,2,25,6.3588522588522585,31,45
"['01101', '11', '000101', '11100', '1000', '1100111', '110']",1,7,14,18,2,32,12.232700632700633,64,65
"['010010', '0010111', '0110', '11']",1,4,9,10,0,19,3.571950271950272,20,14
"['110110', '100001', '11', '1011100', '0000', '1011']",1,6,14,15,4,29,7.782789432789433,51,42
"['010', '0110', '011']",1,3,5,5,2,10,2.380952380952381,3,13
"['0000101', '0001', '01101', '000000']",1,4,16,6,0,22,3.5712509712509712,17,28
"['1010110', '1', '0100']",1,3,6,6,0,12,1.3772727272727274,12,4
"['01', '10101', '100011', '001000']",1,4,11,8,2,19,3.5108225108225106,20,12
"['0', '00010', '0001110']",1,3,9,4,0,13,1.4166666666666667,12,16
"['00', '1', '0010100']",1,3,7,3,0,10,0.6944444444444444,13,8
"['0011', '1101110', '11111', '110', '0110110']",1,5,8,18,2,26,5.8305916305916305,31,34
"['110000', '101', '10100', '10', '1011100']",1,5,12,11,0,23,6.286308136308136,30,33
"['1000100', '10', '11']",1,3,6,5,2,11,1.3888888888888888,11,7
"['01', '00101', '00011', '101', '1101', '0110001']",1,6,13,13,2,26,9.566161616161615,40,48
"['01', '011', '0010000']",1,3,8,4,0,12,1.6444444444444444,11,7
"['11', '10100', '10010', '0110001', '0100']",1,5,13,10,2,23,6.336796536796537,31,23
"['1000001', '0', '11011', '1111000', '101110', '111001']",1,6,14,18,4,32,7.712787212787213,58,39
"['11001', '111', '10', '001011', '0111100']",1,5,9,14,0,23,5.383977133977134,34,24
"['00110', '1010', '1']",1,3,5,5,0,10,1.4,9,5
"['010', '111', '01100', '10000', '1010', '00', '111101', '01110']",1,8,16,17,5,33,15.618109668109668,75,72
"['1110101', '0001', '0110', '1111']",1,4,7,12,3,19,2.8863636363636362,19,15
"['1000', '00', '01111']",1,3,6,5,0,11,1.1746031746031744,10,8
"['10001', '0101', '011110']",1,3,7,8,0,15,1.6303030303030304,10,6
"['0010110', '1101001', '0001', '1000', '1000011']",1,5,17,12,5,29,6.1396103896103895,31,28
"['1100111', '100', '010010']",1,3,8,8,0,16,1.882051282051282,10,4
"['100001', '10111', '01111', '1111110', '10', '1111111']",1,6,8,24,4,32,7.538761238761238,54,67
"['0', '0101010', '110']",1,3,6,5,0,11,1.15,12,9
"['010', '10', '01000']",1,3,7,3,0,10,2.1214285714285714,6,11
"['01', '101', '10001', '011110', '1000011']",1,5,11,12,0,23,5.768825618825619,35,29
"['000110', '0010', '010', '1', '0100111']",1,5,12,9,0,21,5.674209124209124,32,27
"['0100111', '011', '00110', '00', '001110', '1011']",1,6,13,14,0,27,9.461943611943612,42,44
"['0011111', '10', '101001']",1,3,6,9,0,15,1.1837606837606838,14,7
"['001', '001010', '10']",1,3,7,4,0,11,1.5666666666666667,9,9
"['0010', '1111011', '001101', '0001010', '1100', '0100']",1,6,17,15,5,32,8.704095904095905,47,46
"['010', '0011101', '1011100']",1,3,8,9,2,17,1.9142857142857141,10,7
"['010', '011010', '11', '10111', '10100', '000100']",1,6,14,13,4,27,8.688311688311689,45,37
"['1011', '1100001', '110', '1100110']",1,4,9,12,2,21,3.7584415584415583,20,26
"['011111', '010', '10011']",1,3,5,9,0,14,1.4898989898989898,10,6
"['0010', '00', '0010111']",1,3,8,5,0,13,1.8383838383838382,10,15
"['00', '01111', '0000100']",1,3,9,5,0,14,1.0634920634920635,14,12
"['0011001', '1101000', '0010']",1,3,11,7,2,18,1.844155844155844,11,10
"['00', '0101', '1', '1100110']",1,4,7,7,0,14,2.3065656565656565,22,10
"['01', '100001', '000', '0001111']",1,4,11,7,0,18,3.2264957264957266,22,15
"['0011', '010011', '001010']",1,3,9,7,2,16,2.2666666666666666,7,11
"['0', '0001010', '100']",1,3,8,3,0,11,1.15,12,9
"['0', '10', '0110011']",1,3,5,5,0,10,1.3611111111111112,12,6
"['011101', '1011', '11111']",1,3,3,12,0,15,1.7717171717171718,7,10
"['100', '1', '010110']",1,3,5,5,0,10,1.4523809523809523,10,4
"['1110111', '0110111', '0110', '11']",1,4,5,15,2,20,3.6854256854256855,20,26
"['1000010', '00', '1']",1,3,7,3,0,10,0.6944444444444444,13,4
"['1101111', '100001', '11', '100100', '1100']",1,5,11,14,2,25,5.612975912975913,34,39
"['01', '010', '10110', '11']",1,4,5,7,2,12,3.592857142857143,12,12
"['0100110', '0001', '1001', '010111', '1011011', '101110']",1,6,15,19,6,34,9.91999666999667,41,40
"['1111010', '0001010', '10', '110100']",1,4,11,11,2,22,3.344932844932845,22,19
"['111', '0011', '010010', '00', '000111']",1,5,11,10,2,21,5.415873015873016,30,30
"['111000', '001', '110']",1,3,6,6,2,12,1.4444444444444444,10,8
"['1100001', '00', '00010']",1,3,10,4,0,14,1.6825396825396823,12,6
"['00', '1111000', '010110']",1,3,8,7,0,15,1.5598290598290598,13,10
"['11010', '1100', '1111']",1,3,4,9,2,13,2.0555555555555554,5,12
"['00111', '110', '000', '11']",1,4,6,7,2,13,2.704761904761905,15,17
"['011101', '110', '0000011']",1,3,8,8,0,16,1.528205128205128,13,7
"['00011', '1100001', '1111000', '00', '10', '011001']",1,6,16,13,4,29,8.127761127761127,57,39
"['0', '0100111', '1010100', '1011100', '0101001']",1,5,15,14,4,29,5.428571428571429,41,26
"['0', '1000110', '11011', '10']",1,4,7,8,0,15,2.9325396825396823,22,12
"['0110', '1100100', '1', '01110']",1,4,8,9,0,17,2.9176767676767676,22,14
"['01', '01101', '001111', '0010']",1,4,8,9,0,17,3.732034632034632,16,16
"['11001', '01', '111000', '11']",1,4,6,9,2,15,3.12012987012987,18,20
"['11100', '110', '0010100']",1,3,8,7,0,15,1.8166666666666667,9,10
"['110000', '0011', '000', '0100']",1,4,12,5,2,17,3.3095238095238093,16,26
"['01101', '1', '10111', '0100100', '000']",1,5,11,10,2,21,4.233333333333333,37,19
"['0001010', '01', '10000']",1,3,10,4,0,14,1.3968253968253967,12,8
"['0110', '10011', '000000']",1,3,10,5,0,15,1.4303030303030302,11,4
"['100011', '0110', '10']",1,3,6,6,0,12,1.7666666666666666,10,6
"['0011111', '1100', '011', '10000']",1,4,9,10,0,19,2.785064935064935,24,18
"['11110', '01', '1010100', '100000']",1,4,11,9,0,20,2.1386668886668887,23,14
"['010', '1', '0110', '0010101', '0010010']",1,5,13,9,2,22,5.768831168831169,34,28
"['0', '0010100', '00011']",1,3,9,4,0,13,1.25,13,10
"['11010', '00100', '100111', '1011', '0100']",1,5,12,12,4,24,6.257575757575758,26,24
"['0', '100001', '111101']",1,3,6,7,2,13,1.0714285714285714,13,5
"['010', '010000', '0110111', '11101', '011111', '001011']",1,6,14,19,3,33,8.36029526029526,46,46
"['0010', '1101011', '01110', '0000']",1,4,11,9,2,20,3.27020202020202,19,15
"['1', '0011', '10101', '000101', '0000000', '010101', '110111']",1,7,19,16,3,35,10.381851481851482,72,61
"['0010', '10011', '000']",1,3,8,4,0,12,2.0238095238095237,6,6
"['11010', '00001', '011110', '1100110', '0101001', '0100']",1,6,18,16,4,34,9.071317571317572,45,45
"['1', '0111100', '0100']",1,3,6,6,0,12,1.3772727272727274,12,7
"['1100111', '1101011', '011', '0']",1,4,6,12,2,18,3.057142857142857,24,20
"['0011', '1001001', '01110']",1,3,8,8,0,16,1.7272727272727273,9,4
"['101010', '0001', '00010', '1101111']",1,4,11,11,0,22,3.146697746697747,19,15
"['01', '1100001', '100100', '0111', '1100']",1,5,12,11,2,23,5.486402486402486,34,29
"['00011', '10010', '1011', '1101', '0101']",1,5,10,12,5,22,6.627777777777777,21,29
"['100', '10110', '111', '1001']",1,4,6,9,2,15,3.6785714285714284,11,18
"['11001', '0011', '0100']",1,3,7,6,2,13,1.8333333333333333,8,6
"['010100', '0010', '0011001', '1101100', '1111', '1110']",1,6,15,17,5,32,8.607292707292707,44,44
"['01', '100', '10101', '0010011']",1,4,9,8,0,17,3.4325396825396823,19,15
"['00110', '001', '01100']",1,3,8,5,2,13,2.05,7,12
"['0', '10001', '1111101']",1,3,5,8,0,13,1.0833333333333333,14,5
"['0001', '10', '1011000']",1,3,8,5,0,13,1.323232323232323,12,9
"['0111000', '1101', '011011', '11']",1,4,7,12,0,19,3.571950271950272,20,17
"['11110', '100', '01001']",1,3,6,7,2,13,1.65,9,6
"['11011', '00001', '1101000', '100101', '000', '011000']",1,6,19,13,4,32,8.914918414918414,45,50
"['11', '0001', '100', '00', '11101']",1,5,8,8,2,16,4.573015873015873,25,26
"['110', '10', '11111']",1,3,2,8,0,10,1.5857142857142859,8,9
"['01', '011', '100000', '000', '0101001']",1,5,14,7,2,21,4.578205128205128,34,28
"['011011', '11000', '101', '1010010', '100000', '100101', '0000011', '0101', '0100']",1,9,28,20,7,48,21.966860916860917,106,104
"['0', '0100110', '111']",1,3,5,6,0,11,0.65,13,4
"['11000', '001111', '1', '011']",1,4,6,9,0,15,2.6493506493506493,23,16
"['00111', '011010', '10', '0']",1,4,7,7,0,14,2.7987012987012987,21,15
"['1111', '00', '011110', '01010', '01011', '1110']",1,6,10,16,4,26,8.176695526695527,37,47
"['0001110', '011011', '101', '10001', '1000']",1,5,13,12,0,25,5.868126318126318,32,26
"['1010110', '101101', '100', '0001101', '011110', '111000']",1,6,16,19,5,35,9.338217338217339,49,42
"['0', '101', '111011', '00011']",1,4,6,9,0,15,2.831168831168831,20,13
"['11001', '0010', '100', '0000110']",1,4,12,7,0,19,3.615367965367965,19,14
"['00100', '0000110', '011100']",1,3,12,6,0,18,2.0093240093240095,9,18
"['101', '01001', '001111', '000']",1,4,9,8,2,17,3.0176767676767677,17,13
"['01101', '1100100', '0110000', '10', '01011']",1,5,14,12,4,26,5.822222222222222,35,27
"['101', '0101000', '111']",1,3,6,7,2,13,1.6666666666666665,10,4
"['01', '00110', '010110']",1,3,7,6,0,13,1.9805194805194803,8,12
"['111100', '1001101', '1', '00000']",1,4,10,9,0,19,2.0147352647352648,27,12
"['1011110', '10011', '000']",1,3,7,8,0,15,1.5666666666666667,11,5
"['1001110', '110000', '101', '100101', '10', '111000']",1,6,15,15,3,30,9.066666666666666,51,46
"['00010', '10001', '0001111']",1,3,10,7,2,17,2.1333333333333333,9,7
"['01', '110010', '10111', '1000', '10011', '01010', '110']",1,7,14,16,3,30,12.081673881673881,54,56
"['100', '10', '01100', '11']",1,4,6,6,2,12,3.592857142857143,12,13
"['01', '001', '00001', '110111', '110']",1,5,9,10,2,19,5.079509379509379,30,28
"['0001001', '10100', '100100', '1111000']",1,4,15,10,2,25,4.055611055611055,16,22
"['1101', '0011110', '011']",1,3,5,9,0,14,1.7168831168831167,10,5
"['01', '010000', '001', '1100100', '1001001', '1001011']",1,6,19,13,3,32,8.998656898656899,51,41
"['10111', '1000', '11000', '11111']",1,4,7,12,3,19,2.9555555555555557,16,25
"['00', '100', '0111']",1,3,5,4,0,9,1.4190476190476191,7,8
"['0', '0101010', '0001', '11']",1,4,8,6,0,14,1.7914141414141413,22,10
"['001', '1000101', '011001', '00', '1011000']",1,5,15,10,2,25,5.811599511599511,37,28
"['0', '11010', '0100111', '111100', '00001', '0100010', '1001', '1001100']",1,8,23,19,5,42,15.21027306027306,100,73
"['0', '10101', '0100']",1,3,6,4,0,10,1.4,9,4
"['1', '10011', '0111']",1,3,3,7,0,10,1.4,9,9
"['00', '001', '0011101', '000111']",1,4,10,8,0,18,3.7803418803418802,19,23
"['0', '01', '1111101', '011']",1,4,4,9,0,13,3.061111111111111,20,13
"['101', '10101', '010010', '000']",1,4,10,7,2,17,3.643939393939394,16,12
"['101', '0010111', '000101']",1,3,8,8,0,16,2.0358974358974358,9,9
"['111', '0011', '00', '01001', '111001']",1,5,9,11,0,20,5.47012987012987,28,30
"['1000', '10011', '0100']",1,3,8,5,2,13,2.083333333333333,7,7
"['0111001', '1', '00011', '10110', '000101', '0000010', '000010', '0100']",1,8,26,15,6,41,15.361893661893662,94,83
"['1101', '001', '1']",1,3,3,5,0,8,1.4714285714285715,7,9
"['1011', '100', '0100']",1,3,6,5,2,11,1.9285714285714284,6,7
"['1010100', '1100000', '100', '1101', '1111111']",1,5,12,16,3,28,4.893506493506493,39,33
"['1000100', '0011101', '11000', '100', '0101', '1110', '011000']",1,7,20,16,4,36,12.612226662226663,65,62
"['1011011', '0011110', '10', '0111']",1,4,7,13,2,20,3.391053391053391,22,13
"['101', '11110', '000000']",1,3,8,6,0,14,0.904040404040404,13,4
"['1', '000', '0100']",1,3,6,2,0,8,0.9714285714285714,7,6
"['011', '000101', '10011', '01010', '01000']",1,5,14,10,3,24,6.666666666666667,24,26
"['101', '010101', '001']",1,3,6,6,2,12,1.7777777777777777,7,10
"['101100', '1111010', '1']",1,3,5,9,0,14,1.151098901098901,13,6
"['1011', '11000', '101', '0111']",1,4,6,10,2,16,3.567460317460317,15,19
"['010', '001111', '100', '000001', '000111']",1,5,14,10,5,24,5.333333333333333,33,29
"['000101', '1101011', '01000', '10010', '111101']",1,5,14,15,4,29,5.679254079254079,29,24
"['1000', '10000', '10011', '111011']",1,4,10,10,2,20,3.646464646464646,15,26
"['0', '1010000', '011']",1,3,7,4,0,11,1.15,13,6
"['110110', '11110', '0011', '100000', '10010', '0000110', '101111']",1,7,19,20,5,39,11.987567987567987,61,67
"['0101111', '0001', '0010100', '0111', '1101', '0100']",1,6,15,15,6,30,8.116883116883116,45,44
"['110000', '0111001', '010', '1010111', '1000']",1,5,14,13,2,27,5.601287601287601,35,23
"['100', '0110', '110111']",1,3,5,8,0,13,1.615873015873016,9,4
"['1001100', '0101011', '0', '11']",1,4,8,9,2,17,2.1031746031746033,28,12
"['0', '1101', '110', '1111']",1,4,3,9,2,12,3.0785714285714283,13,16
"['111', '00001', '1101000', '1100000', '000000', '001100', '0101', '110', '01011']",1,9,28,18,8,46,18.691408591408592,117,126
"['11010', '0101', '001011']",1,3,7,8,0,15,2.012121212121212,7,7
"['100', '1', '10110']",1,3,4,5,0,9,1.5833333333333333,8,7
"['111100', '1111000', '1110001', '1010', '00']",1,5,12,14,2,26,6.295915195915196,32,32
"['0', '111111', '0101']",1,3,3,8,0,11,0.8,13,4
"['0011011', '010', '1']",1,3,5,6,0,11,1.35,12,4
"['00111', '100', '0010010', '10011', '1101', '1101010']",1,6,15,16,4,31,9.237734487734487,46,44
"['110110', '001101', '0001', '00', '10010', '101001']",1,6,16,13,3,29,9.21991341991342,43,39
"['0', '111100', '000001']",1,3,8,5,2,13,0.9047619047619047,15,7
"['01011', '00010', '111010']",1,3,8,8,2,16,1.690909090909091,8,9
"['1010111', '1110011', '0111011']",1,3,6,15,3,21,2.2857142857142856,7,15
"['101110', '111010', '0100100']",1,3,9,10,2,19,1.7435897435897436,8,7
"['0001011', '1', '101110']",1,3,6,8,0,14,1.151098901098901,15,6
"['01101', '011', '0101011', '01001', '0111', '1101']",1,6,11,17,4,28,10.14170274170274,30,56
"['001101', '110100', '100010', '10', '1010000']",1,5,16,11,3,27,5.944444444444445,35,27
"['11011', '001', '0011100', '11']",1,4,7,10,0,17,3.015873015873016,22,17
"['101', '1100100', '10011', '001001', '1101010']",1,5,14,14,2,28,6.919030969030969,31,29
"['1101', '10', '000000']",1,3,8,4,0,12,1.1166666666666667,12,4
"['001', '0110111', '11011', '010010', '1010', '111111', '100111', '1011']",1,8,14,27,5,41,16.756182706182706,75,94
"['0', '1111001', '10']",1,3,4,6,0,10,1.3611111111111112,12,4
"['11001', '101101', '1101110', '100010', '1001111']",1,5,12,19,4,31,6.938061938061939,27,36
"['1101001', '0101', '110', '1111110']",1,4,7,14,2,21,3.109090909090909,22,19
"['010100', '0100001', '1', '10']",1,4,10,6,0,16,2.762210012210012,23,12
"['1001001', '011', '1100110', '1101100']",1,4,11,13,3,24,3.5142857142857142,20,16
"['11', '101010', '1001', '00', '0110010', '0111110']",1,6,13,15,4,28,7.639382839382839,52,33
"['0', '010000', '1000101', '11']",1,4,10,6,0,16,1.9993894993894994,26,8
"['0010', '111011', '110011', '1000', '001001', '110']",1,6,14,15,5,29,9.070634920634921,42,44
"['1010111', '010111', '01010', '111011']",1,4,8,16,2,24,4.298368298368298,14,24
"['1100101', '0100101', '1111']",1,3,7,11,2,18,2.1298701298701297,8,15
"['1000001', '011', '101011', '0010011', '00', '1101']",1,6,15,14,2,29,7.825452325452325,51,43
"['010100', '01', '010000', '00101', '11', '10001', '0001011']",1,7,20,13,6,33,11.813647463647463,65,54
"['11101', '1100101', '000010', '01110']",1,4,11,12,2,23,3.491142191142191,18,12
"['010', '10000', '111']",1,3,6,5,2,11,1.0833333333333333,9,4
"['01', '1000', '010', '10110']",1,4,8,6,0,14,3.6928571428571426,13,15
"['110000', '00', '01101', '0101100']",1,4,12,8,0,20,3.343378843378843,22,20
"['00', '000010', '10000', '01100']",1,4,14,4,2,18,3.3337662337662337,18,29
"['010', '01101', '0110']",1,3,6,6,0,12,2.496031746031746,4,14
"['11100', '010', '1011001', '11']",1,4,7,10,0,17,3.3492063492063493,19,12
"['01', '11110', '0001', '1111110', '0010010']",1,5,11,14,2,25,4.020923520923521,40,31
"['0010000', '110001', '111111', '0100101', '110101']",1,5,15,17,5,32,5.802197802197802,30,31
"['0110111', '1000', '10', '0111101', '111000']",1,5,11,15,2,26,5.374037074037074,37,28
"['0011011', '1010010', '1']",1,3,7,8,2,15,1.0714285714285714,15,6
"['1101001', '1100110', '011000']",1,3,10,10,2,20,2.2527472527472527,9,6
"['00100', '100', '110110']",1,3,8,6,0,14,1.962121212121212,8,9
"['010100', '11011', '111', '100010', '0101010']",1,5,13,14,2,27,5.881080031080031,29,26
"['1', '101000', '100100', '1000', '0000111']",1,5,15,9,2,24,5.123293373293373,38,34
"['000110', '0001', '100']",1,3,9,4,0,13,1.8158730158730159,8,11
"['0', '1110101', '10011', '001000']",1,4,10,9,0,19,2.209373959373959,26,9
"['00100', '001', '000000', '0001111']",1,4,15,6,0,21,3.4832556332556335,20,30
"['010', '011', '1101101', '001110', '10']",1,5,9,12,2,21,5.805982905982906,31,23
"['1100111', '1', '1111011']",1,3,3,12,2,15,1.2142857142857144,15,17
"['110010', '10', '011111', '011010', '001011', '01110', '0110011']",1,7,16,22,4,38,12.749555999556,61,72
"['010001', '1', '011100', '01100', '1110']",1,5,11,11,2,22,5.4744588744588745,31,25
"['001110', '1101111', '000', '0111']",1,4,8,12,0,20,3.295038295038295,20,15
"['1', '001011', '001010', '0011000']",1,4,12,8,2,20,3.0393772893772892,22,20
"['0001011', '001100', '1000110', '1100']",1,4,14,10,2,24,3.807992007992008,20,20
"['011101', '0000011', '0000', '1011', '1101']",1,5,13,12,3,25,5.147902097902098,33,31
"['11001', '0010', '1100010', '0011110', '100110']",1,5,15,14,2,29,6.641158841158841,31,32
"['0', '01', '1010110']",1,3,5,5,0,10,1.3611111111111112,12,6
"['10110', '000101', '0110', '00', '111110', '01110']",1,6,13,15,4,28,9.216089466089466,42,54
"['0001', '0101111', '00011']",1,3,8,8,0,16,1.9191919191919191,8,10
"['01', '011', '00000', '0111', '0110001']",1,5,12,9,0,21,5.353463203463203,31,31
"['00100', '10100', '1']",1,3,7,4,2,11,1.4666666666666668,9,8
"['101', '11110', '110001', '111100']",1,4,7,13,2,20,3.7323232323232323,17,21
"['10100', '10', '0000001']",1,3,10,4,0,14,1.126984126984127,13,8
"['0111000', '00011', '0100010', '11', '001000', '0110', '0000', '01001']",1,8,26,14,6,40,16.812271062271062,83,101
"['10110', '10', '000']",1,3,6,4,0,10,1.4714285714285715,8,8
"['00100', '0001', '10001', '1010', '001110']",1,5,15,9,4,24,6.261616161616161,25,29
"['11110', '00110', '10001', '0100']",1,4,10,9,3,19,3.1555555555555554,17,13
"['0', '010', '01010']",1,3,6,3,0,9,1.5833333333333333,8,16
"['00100', '1010111', '1110001', '00', '000111', '1111111']",1,6,14,20,3,34,6.947163947163947,60,53
"['11010', '0111010', '011', '00001', '1001', '101110']",1,6,14,16,2,30,8.38005328005328,45,40
"['111', '01111', '1000111', '011101', '111110', '000', '001001']",1,7,14,22,5,36,11.518570318570319,70,65
"['110', '0000110', '1']",1,3,6,5,0,11,1.35,12,6
"['000100', '100111', '10']",1,3,8,6,2,14,1.5,11,5
"['011011', '1001', '1011100', '1101100']",1,4,10,14,2,24,3.7326673326673325,20,17
"['010', '011100', '101', '0001', '011001']",1,5,12,10,4,22,6.287301587301587,27,27
"['100', '011', '10011']",1,3,5,6,2,11,1.8333333333333333,7,10
"['001100', '01001', '011110']",1,3,9,8,2,17,1.7575757575757573,8,9
"['011110', '00', '001010', '101001']",1,4,11,9,3,20,3.333333333333333,21,15
"['00', '0110001', '0100']",1,3,9,4,0,13,1.8383838383838382,10,11
"['001', '1111101', '110001', '0110', '0111']",1,5,9,15,2,24,5.865817515817516,32,28
"['000000', '0111', '00011']",1,3,10,5,0,15,1.412121212121212,10,11
"['11110', '00', '1000', '101']",1,4,7,7,0,14,2.8682539682539683,16,13
"['011100', '1101000', '01111', '010010', '1000', '1010', '010111', '0101']",1,8,21,21,6,42,17.47948717948718,78,86
"['111010', '011100', '000101', '10', '0101']",1,5,12,12,3,24,6.0,31,26
"['101000', '011', '110101']",1,3,7,8,2,15,1.7777777777777777,10,7
"['0110', '011', '011110']",1,3,5,8,0,13,2.3238095238095235,6,16
"['1010110', '11011', '1011101', '100100', '0010010', '0100']",1,6,18,18,3,36,9.943745143745144,43,36
"['1111100', '01', '101', '100011', '1101']",1,5,8,14,0,22,5.7196914196914195,34,34
"['0', '1101011', '10', '00011']",1,4,7,8,0,15,2.6468253968253967,23,13
"['011011', '11101', '10110']",1,3,5,11,2,16,2.254545454545455,7,7
"['01001', '1000', '11111']",1,3,6,8,2,14,1.2888888888888888,9,6
"['0', '0010', '10110']",1,3,6,4,0,10,1.4,9,9
"['00111', '011', '1111']",1,3,3,9,0,12,1.9880952380952381,6,13
"['11010', '01101', '010', '00', '110']",1,5,9,9,4,18,6.809523809523809,20,29
"['0', '00100', '11110']",1,3,6,5,2,11,1.0666666666666667,11,8
"['0111100', '1001', '1000010', '0001100', '010111', '0100']",1,6,20,15,5,35,9.317632367632367,50,45
"['0', '01101', '10100', '010']",1,4,8,6,2,14,3.2666666666666666,17,15
"['101000', '00', '1']",1,3,6,3,0,9,0.7857142857142857,11,6
"['11000', '10001', '0001', '1010', '00110', '100101']",1,6,17,12,5,29,10.063636363636363,35,42
"['0', '11110', '111000', '11101']",1,4,6,11,2,17,3.206926406926407,19,17
"['01', '111', '10111', '1001', '01011']",1,5,6,13,2,19,6.164285714285715,22,36
"['0011', '00', '010']",1,3,6,3,0,9,2.038095238095238,5,10
"['01', '00101', '1001', '00', '1110']",1,5,9,8,4,17,5.253968253968254,25,23
"['110010', '01101', '11', '10001', '1001', '1011', '000100']",1,7,16,16,6,32,12.636796536796536,57,59
"['011111', '10001', '10011', '1100111']",1,4,8,15,2,23,3.8244755244755244,16,26
"['01', '0001', '100001', '011']",1,4,9,6,0,15,3.7825396825396824,15,18
"['00101', '011', '00001', '00111', '1111000', '01011']",1,6,15,15,4,30,8.983333333333334,44,48
"['010000', '1', '011', '000000']",1,4,12,4,2,16,2.119047619047619,23,17
"['110', '10110', '010000']",1,3,8,6,0,14,1.7398989898989898,9,8
"['100101', '111110', '010101', '10']",1,4,8,12,3,20,2.833333333333333,22,17
"['0', '111110', '10010']",1,3,5,7,0,12,0.9826839826839826,12,7
"['00110', '100', '01010']",1,3,8,5,2,13,2.05,7,10
"['0', '001', '1101111', '011']",1,4,5,9,2,14,2.9166666666666665,20,12
"['1101011', '011101', '0111111', '000', '001100', '0011100']",1,6,16,20,5,36,8.703052503052502,52,51
"['0011', '010', '0000000', '01000']",1,4,15,4,0,19,3.0295093795093795,20,27
"['00000', '101000', '000101', '1110110', '1011011', '0100']",1,6,20,15,4,35,8.385736485736485,49,45
"['110000', '001001', '001110']",1,3,11,7,3,18,1.6666666666666665,12,10
"['0001001', '1', '001101', '1111101', '1000101', '10001', '1111001']",1,7,18,22,4,40,11.16083916083916,75,93
"['10101', '01001', '1111111', '1101100']",1,4,8,16,4,24,3.538095238095238,21,17
"['0001100', '0101', '1011', '1010011']",1,4,11,11,4,22,4.009740259740259,20,14
"['10001', '010', '110', '1']",1,4,6,6,2,12,3.0,15,11
"['111011', '11011', '10011', '1101100']",1,4,7,16,2,23,4.538927738927739,12,39
"['0010', '001', '00101', '110', '01000']",1,5,13,7,4,20,6.167460317460317,23,34
"['0010110', '0001', '000101', '111111', '000100']",1,5,16,13,3,29,5.524941724941725,31,35
"['11110', '010', '1']",1,3,3,6,0,9,1.3333333333333333,9,5
"['101000', '1101', '111', '11010']",1,4,7,11,0,18,4.267748917748918,13,21
"['00110', '0001', '1000']",1,3,9,4,2,13,2.083333333333333,7,10
"['101', '110101', '0111010', '0000']",1,4,10,10,0,20,3.267066267066267,21,10
"['11010', '111100', '1100100', '110100']",1,4,11,13,2,24,4.674825174825175,9,30
"['111011', '01011', '11111']",1,3,3,13,2,16,2.036363636363636,5,20
"['0101', '00', '100', '11101']",1,4,7,7,0,14,3.4904761904761905,14,14
"['1100011', '10101', '0']",1,3,6,7,0,13,1.25,13,4
"['1000001', '001', '011', '0101101', '10001', '000101', '11111', '001100', '1001111']",1,9,24,25,9,49,20.48278388278388,113,114
"['001100', '1', '1111110', '100000']",1,4,10,10,2,20,2.090659340659341,28,12
"['001', '010', '1010', '0111111', '00110', '1101', '1111011']",1,7,12,21,6,33,12.056349206349207,66,53
"['0110100', '100100', '10']",1,3,9,6,0,15,1.7136752136752138,11,10
"['010100', '101', '0001', '100', '1110']",1,5,11,9,4,20,5.335714285714285,25,24
"['00001', '1', '011000']",1,3,8,4,0,12,1.1645021645021645,12,6
"['11001', '001', '0011110', '10100', '100000', '011110', '01010', '01110']",1,8,22,20,6,42,16.335625485625485,83,89
"['101100', '0001110', '1']",1,3,7,7,0,14,1.151098901098901,14,5
"['01', '00000', '11000', '0001', '01111']",1,5,13,8,3,21,4.787301587301587,31,33
"['00111', '101', '011011', '1000', '1010001', '111001']",1,6,14,17,2,31,9.0004884004884,46,49
"['1011010', '110', '1001010', '101010', '1101', '1100', '01000']",1,7,18,18,4,36,13.736657786657787,49,64
"['010', '1', '001011', '100111']",1,4,7,9,2,16,3.015873015873016,21,11
"['1101', '0101000', '000']",1,3,9,5,0,14,1.431168831168831,11,8
"['111010', '10101', '1001', '0010100', '0101010', '00', '0111101']",1,7,19,19,3,38,13.105772005772005,65,51
"['11100', '10', '110100']",1,3,6,7,0,13,1.7987012987012987,8,9
"['1100', '100111', '1101010']",1,3,7,10,0,17,1.9426573426573426,10,10
"['1101000', '1001', '11100', '11']",1,4,8,10,0,18,3.5613275613275612,19,20
"['101', '00', '110101', '11']",1,4,5,8,2,13,2.8666666666666667,16,16
"['01', '000101', '1111']",1,3,5,7,0,12,1.2333333333333334,11,7
"['1000', '1100', '0110']",1,3,7,5,3,12,2.0,6,7
"['01', '0001', '010111', '110010']",1,4,9,9,2,18,3.1666666666666665,19,15
"['0001', '10000', '111110', '010110', '011001']",1,5,14,13,3,27,5.3545454545454545,31,27
"['11001', '0011101', '1100000', '10010', '0001010', '1100']",1,6,20,15,5,35,9.682395382395383,49,47
"['011011', '01', '00010', '10011']",1,4,9,9,2,18,3.3337662337662337,17,13
"['0111', '1101', '0101100']",1,3,6,9,2,15,1.5909090909090908,9,6
"['01', '11011', '001', '1000110', '0011011']",1,5,11,13,2,24,6.007936507936508,34,28
"['0', '110111', '01101', '011']",1,4,5,10,0,15,3.262987012987013,19,14
"['1110111', '01', '10010', '01100']",1,4,8,11,2,19,3.187301587301587,22,11
"['1011', '01101', '1110', '01110']",1,4,6,12,4,18,4.188888888888889,13,16
"['0101', '100011', '10', '1111']",1,4,6,10,2,16,3.0,17,17
"['0', '001110', '00011']",1,3,7,5,0,12,1.3463203463203464,11,9
"['0010', '11', '0011', '010010', '10100']",1,5,12,9,2,21,6.05981240981241,26,27
"['010', '0001110', '0101111', '00000', '10', '1011', '0110001', '0110011']",1,8,22,20,4,42,15.563636363636363,100,78
"['101', '01111', '011', '00000']",1,4,8,8,4,16,2.6166666666666667,19,13
"['01', '010000', '1']",1,3,6,3,0,9,1.4523809523809523,10,5
"['01', '11', '10001', '000', '110']",1,5,8,7,4,15,4.826190476190476,22,21
"['0110000', '1', '110100', '01000']",1,4,12,7,0,19,3.198884448884449,21,15
"['0010111', '000011', '00011', '101', '1010001']",1,5,15,13,2,28,6.2000555000555,29,35
"['110011', '101000', '101', '1101010']",1,4,10,12,2,22,4.138461538461538,17,19
"['0', '0110010', '1100']",1,3,7,5,0,12,1.3772727272727274,12,8
"['1', '10101', '0110000', '10011', '1011']",1,5,10,12,2,22,5.43989898989899,34,30
"['11', '1011101', '0001', '1010', '00', '001001']",1,6,13,12,4,25,7.628515928515928,47,39
"['110000', '111100', '1', '10', '1011000']",1,5,11,11,2,22,5.137667887667888,36,26
"['000100', '1110', '100010']",1,3,10,6,2,16,1.6333333333333333,9,7
"['100', '1', '01011', '000010']",1,4,9,6,0,15,2.6089466089466087,21,11
"['01', '100', '00101', '000']",1,4,9,4,2,13,3.288095238095238,13,18
"['10100', '1010', '1']",1,3,5,5,0,10,1.6222222222222222,8,9
"['01', '100011', '1111111']",1,3,4,11,0,15,1.0299145299145298,14,10
"['01', '00000', '11']",1,3,6,3,2,9,0.7857142857142857,10,4
"['101', '1100', '01011', '1']",1,4,5,8,0,13,2.999206349206349,16,15
"['11001', '1111', '00', '1010011', '1101']",1,5,8,14,2,22,5.397186147186147,27,35
"['0001101', '1100100', '0100101', '11']",1,4,12,11,3,23,3.4761904761904763,23,17
"['10110', '001111', '010111']",1,3,6,11,2,17,2.106060606060606,7,8
"['010100', '11110', '0000100', '0011000', '1010101', '111011', '1110']",1,7,21,21,5,42,11.382928182928183,67,61
"['100110', '1111001', '000']",1,3,8,8,0,16,1.682051282051282,12,4
"['0010001', '010100', '01', '0010', '10000', '1001011', '011000']",1,7,24,13,4,37,13.085392385392385,65,61
"['110010', '001', '011011', '1010', '011110']",1,5,11,14,3,25,5.926984126984127,28,27
"['010111', '001011', '10']",1,3,6,8,2,14,1.8333333333333335,10,7
"['001', '010001', '1011101', '10000', '0010011', '01010', '00010', '111000', '1011111']",1,9,27,24,8,51,20.812393162393164,115,100
"['0', '100', '01010']",1,3,6,3,0,9,1.5833333333333333,8,8
"['11001', '0', '011011', '10', '11100']",1,5,8,11,2,19,5.334632034632034,31,21
"['10010', '111', '011001']",1,3,6,8,0,14,1.893939393939394,9,6
"['0', '1101010', '01110', '00001']",1,4,10,8,2,18,2.15,25,15
"['00', '1110100', '0110011']",1,3,8,8,2,16,1.4603174603174602,14,9
"['11', '1001', '11101', '0100100', '0111', '0001011', '01010']",1,7,16,18,6,34,12.70966810966811,65,54
"['10001', '1101011', '111']",1,3,5,10,0,15,1.7666666666666666,10,16
"['010', '001', '1']",1,3,4,3,2,7,1.6666666666666665,6,4
"['0', '10000', '1001', '1001111']",1,4,9,8,0,17,2.8772727272727274,22,17
"['111111', '010', '00']",1,3,4,7,0,11,1.0222222222222221,12,4
"['1000100', '11011', '101000']",1,3,10,8,0,18,1.6608391608391608,9,8
"['0101101', '101', '110', '0100']",1,4,8,9,2,17,3.7367965367965366,17,14
"['011110', '001', '0111']",1,3,5,8,0,13,1.8158730158730159,8,9
"['011', '11', '110001', '10010', '010011']",1,5,10,12,2,22,6.103751803751804,29,33
"['0101', '00101', '10', '11111']",1,4,6,10,2,16,3.257142857142857,16,15
"['00111', '10100', '00']",1,3,7,5,2,12,1.5428571428571427,9,11
"['110000', '0011001', '01111', '010111', '10', '010110']",1,6,15,17,3,32,8.353701853701853,50,42
"['01001', '110001', '10', '011']",1,4,8,8,0,16,3.3931457431457432,17,16
"['01', '001000', '100001', '1011000']",1,4,14,7,2,21,3.4957264957264957,21,16
"['1110111', '0010010', '010', '10']",1,4,9,10,2,19,3.1174603174603175,24,14
"['1100111', '00', '0110', '10']",1,4,7,8,2,15,3.2676767676767673,19,11
"['00111', '01', '00', '1111']",1,4,5,8,2,13,2.642857142857143,16,16
"['001111', '11', '0000001', '1010', '001110', '01100']",1,6,16,14,2,30,7.653091353091353,52,40
"['10', '0000001', '0011100']",1,3,11,5,2,16,1.0952380952380951,15,8
"['1', '0100010', '010010', '1010', '10100', '0000']",1,6,18,9,2,27,7.892124542124542,44,45
"['10101', '0101011', '11']",1,3,5,9,0,14,1.8492063492063493,10,10
"['1001100', '01', '11']",1,3,5,6,2,11,1.3888888888888888,11,6
"['000110', '0001', '01101', '10101']",1,4,11,9,2,20,3.5616161616161617,15,17
"['100101', '11100', '111', '0000']",1,4,9,9,0,18,3.006565656565656,18,16
"['10', '111', '01000']",1,3,5,5,0,10,1.2214285714285715,9,4
"['0', '1000101', '10000']",1,3,9,4,0,13,1.4166666666666667,12,7
"['11001', '101011', '0101', '0100001']",1,4,11,11,0,22,3.8396270396270396,15,21
"['00111', '0001010', '1101']",1,3,8,8,0,16,1.6565656565656566,10,6
"['01', '1100', '001111', '0000']",1,4,9,7,2,16,2.466666666666667,20,18
"['010100', '01', '000']",1,3,8,3,0,11,1.3444444444444446,9,11
"['00001', '0001', '000001', '000', '101001']",1,5,18,6,2,24,7.51017316017316,19,53
"['11001', '1010110', '010000', '010', '10101', '100', '1100110']",1,7,19,17,6,36,13.962154512154513,60,57
"['010', '001', '00111', '01010', '0110001']",1,5,13,10,4,23,6.133333333333333,29,32
"['001', '100001', '1001000', '010010', '1111', '1111010', '01010']",1,7,20,18,4,38,11.788067488067488,68,58
"['10100', '011', '001101']",1,3,7,7,0,14,1.712121212121212,9,7
"['01', '000011', '0011', '10', '110']",1,5,9,8,2,17,5.265873015873016,29,27
"['0101', '0110111', '1111111']",1,3,4,14,2,18,1.5194805194805194,10,11
"['0111101', '1', '0100']",1,3,5,7,0,12,1.1954545454545453,13,5
"['010', '001111', '111', '110111', '01010']",1,5,8,15,4,23,5.563131313131313,30,33
"['0101', '10', '11']",1,3,3,5,2,8,1.8333333333333333,5,6
"['101011', '0111001', '110']",1,3,6,10,0,16,1.505982905982906,10,7
"['0010', '110010', '011000']",1,3,10,6,2,16,2.2333333333333334,7,12
"['0001', '000111', '10']",1,3,7,5,0,12,1.3833333333333333,10,9
"['0', '110', '100010']",1,3,6,4,0,10,1.2301587301587302,10,7
"['10001', '100100', '010']",1,3,9,5,0,14,1.893939393939394,8,6
"['0101110', '0110111', '100111', '11111', '0110010']",1,5,11,21,3,32,6.199300699300699,27,33
"['00110', '11011', '0110', '11101']",1,4,7,12,3,19,4.222222222222222,14,13
"['11011', '001111', '11', '11000', '11100']",1,5,8,15,3,23,5.6688311688311686,31,46
"['101010', '1011010', '01101', '111']",1,4,8,13,0,21,4.0108391608391605,15,17
"['0', '11', '011101', '1111010', '011001', '000111']",1,6,11,17,3,28,7.064407814407814,58,37
"['110000', '1', '10110']",1,3,6,6,0,12,1.1645021645021645,12,6
"['0', '0110110', '111011']",1,3,5,9,0,14,1.304945054945055,13,4
"['100', '1001', '100101', '0111', '1001011']",1,5,11,13,2,24,6.505328005328005,26,45
"['101100', '0100000', '001', '1', '010110']",1,5,14,9,2,23,4.674420024420025,38,23
"['001', '101011', '1010100', '110001', '10']",1,5,12,12,2,24,5.406837606837607,33,32
"['0010', '11011', '000']",1,3,7,5,0,12,1.5515873015873014,8,6
"['110000', '1011011', '1011001', '0111']",1,4,10,14,2,24,3.788611388611389,19,21
"['01', '1', '00100', '1100', '0100']",1,5,10,6,2,16,5.676984126984127,23,28
"['010010', '1111000', '10011', '000', '011111', '01011']",1,6,15,17,4,32,8.398445998445998,50,45
"['010100', '0011', '1000', '00', '10011', '0110001']",1,6,17,11,2,28,9.358841158841159,44,43
"['10101', '00', '1']",1,3,4,4,0,8,0.9047619047619047,9,4
"['01', '110010', '1100', '0110']",1,4,8,8,2,16,3.65,16,17
"['0', '100', '011001']",1,3,6,4,0,10,1.4523809523809523,10,6
"['1101', '110', '0100100']",1,3,7,7,0,14,1.8025974025974025,9,6
"['110000', '00110', '110']",1,3,8,6,0,14,1.962121212121212,9,11
"['1000100', '00000', '101010', '0110', '10000', '1110']",1,6,20,11,4,31,8.341452991452991,38,50
"['1011101', '001', '000101', '10000']",1,4,12,9,0,21,3.2554778554778556,20,21
"['101100', '100010', '000', '1010000', '01110']",1,5,17,10,2,27,5.673815073815073,29,34
"['1110111', '001101', '100111', '01010', '1011', '0111101']",1,6,12,23,4,35,10.095637695637695,45,43
"['10101', '100', '00', '1110110', '1001011', '1110']",1,6,12,16,2,28,8.864718614718615,46,41
"['01', '00', '10000']",1,3,7,2,2,9,1.3571428571428572,8,8
"['110011', '01000', '0111', '00000']",1,4,12,8,2,20,2.7757575757575754,18,17
"['000011', '10110', '0001101', '1000', '111101']",1,5,14,14,2,28,5.687645687645688,32,31
"['001100', '00110', '10000']",1,3,11,5,2,16,2.0545454545454547,7,16
"['110110', '0110100', '00000', '1101', '001011', '0110011']",1,6,18,17,4,35,8.495016095016094,45,45
"['0101101', '0001', '11111']",1,3,6,10,0,16,1.0858585858585859,10,7
"['00', '001', '111', '0110001']",1,4,8,7,2,15,2.7777777777777777,19,14
"['0', '11010', '1001']",1,3,5,5,0,10,1.4,9,4
"['0110', '1', '0000']",1,3,6,3,2,9,0.9,9,4
"['1110101', '110110', '10', '111']",1,4,5,13,0,18,3.3803418803418803,21,22
"['0001', '010', '000']",1,3,8,2,2,10,2.095238095238095,4,12
"['01', '001', '0011000', '1110100', '000111', '1110']",1,6,15,14,2,29,8.138539238539238,56,49
"['10111', '1010100', '1', '101110']",1,4,7,12,0,19,3.214035964035964,21,22
"['111', '101', '010111', '0101', '0101001']",1,5,9,14,2,23,6.925074925074925,25,39
"['110110', '1010110', '0111011', '0001111', '10', '010011', '01110']",1,7,16,24,5,40,12.76062826062826,68,67
"['00011', '111', '01110', '0111100']",1,4,8,12,2,20,3.783333333333333,18,16
"['10101', '1100000', '1111110', '10000', '100111', '01010', '0100']",1,7,20,19,5,39,11.734476634476634,68,54
"['0', '00100', '101110', '11']",1,4,7,7,0,14,1.95021645021645,22,10
"['00111', '11000', '1111', '1000', '1010', '1011', '011010', '0110011']",1,8,17,22,6,39,16.837412587412587,73,86
"['0', '01000', '01110']",1,3,7,4,2,11,1.2666666666666666,10,13
"['110110', '1', '0000']",1,3,6,5,0,11,0.6857142857142857,13,4
"['001', '100', '101110']",1,3,6,6,2,12,1.7777777777777777,9,8
"['11110', '001', '00100', '1011000', '1011', '0010010']",1,6,17,14,4,31,8.347330447330448,47,47
"['0', '1011', '00010', '1111010']",1,4,8,9,0,17,2.473232323232323,24,13
"['001', '101110', '000']",1,3,7,5,2,12,1.5555555555555554,9,8
"['01', '0100110', '1010000', '110', '1110']",1,5,12,11,2,23,5.284559884559885,34,28
"['010', '10001', '10000', '1101110', '1000', '1011']",1,6,15,13,4,28,9.204473304473304,39,44
"['00110', '011', '001101']",1,3,7,7,0,14,2.3257575757575757,6,10
"['101000', '10111', '1000', '00']",1,4,10,7,0,17,3.242279942279942,18,21
"['1101001', '101', '1111', '010101', '1100110', '1011000', '01110']",1,7,16,23,3,39,13.15974025974026,67,57
"['01101', '010', '010000', '101000', '1010100', '11111']",1,6,17,15,4,32,8.387645687645687,45,39
"['1000101', '111', '100', '0110', '1010100', '0000101', '10100', '100101', '000']",1,9,26,19,6,45,21.1504995004995,104,117
"['001', '111000', '010101']",1,3,8,7,2,15,1.3888888888888888,11,8
"['01', '010', '001011', '101101']",1,4,8,9,2,17,3.8,18,12
"['0101010', '1110', '11']",1,3,5,8,0,13,1.4747474747474747,10,7
"['010', '0000110', '000']",1,3,10,3,2,13,1.8666666666666667,9,17
"['0', '1011011', '001']",1,3,5,6,0,11,1.15,12,4
"['0110', '111010', '1110']",1,3,5,9,2,14,2.15,6,13
"['0111100', '1110', '1101100']",1,3,7,11,2,18,2.1298701298701297,8,10
"['101100', '0010', '1', '0111011', '10001']",1,5,11,12,0,23,4.375341325341325,39,20
"['0001', '10', '0111100']",1,3,7,6,0,13,1.1414141414141414,13,7
"['100000', '00100', '1', '1010011']",1,4,12,7,0,19,2.5427072927072927,23,13
"['10111', '11011', '0101']",1,3,4,10,2,14,2.1333333333333333,6,10
"['110010', '1000101', '1111', '1010', '0110010', '1100', '0100']",1,7,18,18,6,36,13.797502497502498,56,58
"['0010110', '010001', '1100000', '01111', '000', '11111', '1101']",1,7,18,19,4,37,9.718986568986569,76,61
"['0010', '0000000', '1010', '111110', '0100100']",1,5,18,10,4,28,4.764785214785215,35,35
"['10101', '100', '110', '1']",1,4,5,7,2,12,3.25,13,15
"['0011', '01000', '10100', '00', '1011', '110', '01110']",1,7,15,13,5,28,11.89047619047619,52,60
"['11', '100', '0000', '011001', '0001000']",1,5,15,7,0,22,4.702974802974803,34,30
"['0011', '01', '0010101']",1,3,7,6,0,13,1.8383838383838382,10,9
"['000110', '010011', '0011010', '111']",1,4,11,11,2,22,3.706837606837607,18,14
"['001', '10', '1111110']",1,3,4,8,0,12,1.0444444444444445,13,7
"['0111010', '0101110', '011', '0101001']",1,4,11,13,3,24,3.942857142857143,20,24
"['00100', '010', '1', '110']",1,4,7,5,2,12,3.25,14,11
"['00', '0101', '1']",1,3,4,3,0,7,1.0666666666666667,7,4
"['000110', '0101110', '1001010', '11', '1111001', '10', '1010001']",1,7,18,20,6,38,11.528083028083028,82,52
"['0', '000110', '001', '0101010', '1110']",1,5,12,9,0,21,4.367116217116217,34,31
"['010100', '111', '0000']",1,3,8,5,0,13,0.8444444444444444,10,6
"['011010', '010', '00001']",1,3,9,5,0,14,1.5303030303030303,9,11
"['1101', '010', '11100', '1110']",1,4,6,10,2,16,3.948412698412698,12,16
"['0111000', '0', '0101000', '01101', '0011', '0101001']",1,6,18,13,3,31,8.214935064935064,50,53
"['0', '0001010', '00011']",1,3,9,4,0,13,1.4166666666666667,12,11
"['1010', '1', '01000', '0100']",1,4,9,5,2,14,3.4388888888888887,15,14
"['0001100', '1010100', '011']",1,3,10,7,2,17,1.9142857142857141,11,9
"['1111010', '00', '00010']",1,3,8,6,0,14,1.5158730158730158,12,12
"['11001', '110000', '010', '1110010', '00000', '0110', '10011', '1101']",1,8,21,18,5,39,17.12052947052947,78,76
"['0', '100', '010111', '01010']",1,4,8,7,0,15,3.040764790764791,19,17
"['00111', '000', '11']",1,3,5,5,0,10,1.0714285714285714,9,8
"['11', '00110', '01010', '1011', '01001', '11100', '01011']",1,7,14,17,5,31,13.657142857142857,51,58
"['000', '10111', '10', '0011100']",1,4,9,8,0,17,2.9325396825396823,21,15
"['0110010', '11010', '1000', '1101']",1,4,10,10,2,20,4.343434343434343,13,15
"['01', '10001', '1001', '1000']",1,4,9,6,2,15,4.099206349206349,11,25
"['0000111', '0011011', '010', '0011100']",1,4,13,11,3,24,3.742857142857143,23,22
"['00', '01101', '10010', '011']",1,4,8,7,2,15,3.392857142857143,16,14
"['110001', '1', '0110001']",1,3,7,7,0,14,1.458791208791209,12,13
"['00', '011010', '1', '011']",1,4,6,6,0,12,2.3523809523809525,18,12
"['001', '1100', '111001']",1,3,6,7,0,13,2.038095238095238,8,10
"['0011000', '101000', '1000', '000', '001001']",1,5,19,7,2,26,7.122877122877123,25,55
"['1110111', '1100', '011000']",1,3,7,10,0,17,1.806993006993007,10,7
"['010010', '01000', '11']",1,3,8,5,0,13,1.6948051948051948,9,7
"['001001', '11100', '10']",1,3,7,6,0,13,1.6168831168831168,10,7
"['1000011', '001', '1', '0101011']",1,4,9,9,2,18,2.7142857142857144,25,16
"['0100100', '0110100', '000']",1,3,12,5,2,17,1.5714285714285714,9,20
"['0101101', '1100100', '00', '10', '11111', '01110']",1,6,12,16,6,28,7.044444444444444,54,34
"['0011', '110001', '1000111', '1010', '1110001', '111101']",1,6,14,20,6,34,9.367665667665667,46,63
"['110000', '010', '0101011', '001001']",1,4,13,9,2,22,3.288034188034188,21,16
"['110110', '01', '101010', '0011', '101000', '1100000', '1111', '100110', '100000']",1,9,25,22,7,47,20.284110334110334,109,108
"['0000101', '0010', '0110010', '111']",1,4,12,9,2,21,3.4545454545454546,21,14
"['0010', '11', '00', '000001', '110']",1,5,11,6,2,17,4.343650793650793,29,26
"['1011010', '11011', '1']",1,3,4,9,0,13,1.25,13,8
"['01', '001', '00001', '101000', '0000000', '0110011']",1,6,21,9,2,30,7.973964923964924,54,51
"['110011', '01', '11011']",1,3,4,9,0,13,1.9805194805194803,8,14
"['0111000', '01', '001', '00011', '000101', '000001', '1011', '1101', '011010']",1,9,24,19,5,43,21.112654012654012,109,105
"['00110', '110010', '011', '11']",1,4,7,9,0,16,3.793145743145743,17,16
"['0001', '110', '00101']",1,3,7,5,0,12,1.4523809523809523,7,8
"['11', '100', '0101', '110', '01110']",1,5,7,10,2,17,6.164285714285715,20,23
"['00111', '1000', '10011', '1011', '001100', '1100']",1,6,14,14,5,28,9.782323232323233,37,52
"['0011100', '00111', '100', '000101', '10110', '011101', '10', '000010', '01110']",1,9,24,21,6,45,21.844227994227992,105,113
"['10001', '0011101', '100101']",1,3,9,9,0,18,2.1783216783216783,8,14
"['010', '0111001', '1101111', '00001', '101', '1000']",1,6,14,15,4,29,8.0995670995671,52,36
"['0110000', '1010', '010']",1,3,9,5,0,14,2.0025974025974023,9,11
"['101010', '10110', '1111', '000', '001001', '1100']",1,6,14,14,4,28,8.337085137085136,40,38
"['0010110', '0011', '1001']",1,3,8,7,2,15,2.0227272727272725,9,6
"['1000101', '111', '010101', '01010', '00010']",1,5,14,12,2,26,6.186596736596736,25,25
"['11001', '000100', '010111', '1111']",1,4,9,12,2,21,3.0575757575757576,19,17
"['011', '10101', '1111001', '00', '10010', '1010000']",1,6,15,14,4,29,8.519841269841269,51,37
"['0001', '1000', '110', '01010']",1,4,10,6,2,16,3.2182539682539684,13,15
"['011', '0010100', '111']",1,3,6,7,2,13,1.6666666666666665,10,6
"['101010', '01111', '0101011']",1,3,7,11,0,18,1.8146853146853146,7,8
"['00', '10', '11111', '01011', '101111']",1,5,6,14,4,20,4.533116883116883,30,28
"['010', '000011', '101010', '1000110', '100']",1,5,15,10,4,25,5.973504273504274,31,29
"['0001100', '1010', '1000', '110']",1,4,11,7,2,18,3.5837662337662337,16,17
"['101011', '00010', '100', '01000']",1,4,12,7,2,19,3.6075757575757574,16,15
"['0101110', '1110000', '11', '101', '00']",1,5,10,11,4,21,4.549206349206349,39,20
"['11011', '001', '111100', '0000100', '010001', '101', '1010111', '010110', '111001']",1,9,23,26,8,49,21.117188367188366,116,101
"['111', '0001', '100', '1101100', '111110', '100011']",1,6,12,17,4,29,7.386591186591186,50,49
"['0', '110110', '10110', '001010', '01110']",1,5,11,12,4,23,5.613852813852814,30,37
"['1011110', '0111', '0101001', '0']",1,4,8,11,2,19,2.925974025974026,25,13
"['1110111', '01000', '0']",1,3,6,7,0,13,0.9166666666666666,15,4
"['0010110', '11110', '01101', '1110000', '1100000', '011101', '001010', '0000', '001100', '011000']",1,10,34,25,9,59,28.53732933732934,131,181
"['0', '1010000', '110010', '11100']",1,4,11,8,0,19,2.8783716283716285,22,14
"['0011', '11100', '1000011', '0101', '1100']",1,5,12,12,3,24,5.845959595959596,31,33
"['010', '11', '0011', '000010', '1101']",1,5,10,9,2,19,5.292857142857143,28,24
"['0010', '00000', '0110', '110111', '001100', '01001']",1,6,18,12,6,30,8.694444444444445,41,45
"['0111000', '11000', '1110']",1,3,8,8,0,16,2.2272727272727275,7,11
"['1', '011100', '010010', '10011', '01000']",1,5,13,10,4,23,5.413852813852814,33,22
"['00110', '1000110', '0110', '1101']",1,4,10,10,2,20,4.411616161616162,15,20
"['11001', '11011', '11', '1010111', '000', '1011']",1,6,9,17,2,26,7.883621933621933,43,64
"['01', '1101001', '00']",1,3,6,5,2,11,1.3888888888888888,11,5
"['0011', '10110', '00110', '1010011', '0011100', '110101']",1,6,16,18,4,34,10.472205572205572,44,47
"['0', '0011011', '000010']",1,3,9,5,0,14,1.151098901098901,14,9
"['011', '00101', '00001', '10', '111101']",1,5,10,11,2,21,4.960678210678211,30,26
"['1', '10110', '00101']",1,3,5,6,2,11,1.2666666666666666,11,6
"['10011', '000', '0110011']",1,3,8,7,0,15,1.7333333333333334,9,8
"['11010', '001', '1', '001110', '0001000']",1,5,13,9,0,22,4.796553446553446,37,25
"['100110', '01', '0010000', '111101']",1,4,11,10,2,21,3.034188034188034,25,11
"['10000', '0101', '10']",1,3,7,4,0,11,1.6825396825396823,8,7
"['01', '01001', '1']",1,3,4,4,0,8,1.5714285714285714,8,8
"['101010', '11000', '0000']",1,3,10,5,0,15,1.993939393939394,7,10
"['0101', '001', '111', '01110']",1,4,6,9,2,15,3.392857142857143,12,12
"['011', '1001010', '0100', '00', '0110011']",1,5,13,10,2,23,5.713997113997114,34,30
"['1010', '01', '1010100', '0000']",1,4,11,6,2,17,3.0353535353535355,18,17
"['1010111', '00110', '100111', '0100']",1,4,10,12,0,22,3.906915306915307,16,13
"['01101', '001', '00001', '011011', '1010101', '000']",1,6,16,13,4,29,8.177000777000776,39,47
"['1111100', '100', '0']",1,3,5,6,0,11,1.35,12,8
"['0', '011110', '1010000', '1010010', '01110', '0100']",1,6,17,13,2,30,7.75008325008325,51,57
"['1111010', '0010', '111100', '10']",1,4,8,11,0,19,3.4796425796425794,20,21
"['01', '00001', '100100', '1111', '0001100']",1,5,14,10,0,24,4.5087246087246085,36,26
"['0101111', '1001', '10010', '011110', '011001', '010011']",1,6,15,19,3,34,9.724553224553224,40,44
"['11000', '1100000', '100011', '10']",1,4,12,8,0,20,3.691863691863692,20,21
"['1000', '1011000', '11']",1,3,7,6,0,13,1.505050505050505,11,10
"['011101', '10111', '111101']",1,3,4,13,2,17,2.106060606060606,6,14
"['1010', '1101', '010110', '11']",1,4,6,10,2,16,3.9833333333333334,15,13
"['001', '011', '111', '1000', '1110']",1,5,7,10,5,17,5.023809523809524,20,28
"['0', '101000', '111011', '1110100', '01100']",1,5,12,13,2,25,5.132617382617383,35,27
"['01', '111', '001000', '110011', '00']",1,5,10,9,4,19,4.288888888888889,34,24
"['01', '010011', '00']",1,3,6,4,2,10,1.5,9,7
"['111111', '01001', '001110', '001010']",1,4,10,13,3,23,3.303030303030303,19,13
"['101', '0010', '0101', '100111']",1,4,8,9,2,17,4.045238095238095,14,13
"['01', '1010101', '11']",1,3,4,7,2,11,1.3888888888888888,11,9
"['0010', '11011', '01101', '0001110', '11111', '0101', '0111110']",1,7,14,23,7,37,13.027922077922078,59,54
"['1011', '1101000', '1110', '0100']",1,4,9,10,3,19,3.3181818181818183,17,14
"['0001010', '0111111', '111101']",1,3,7,13,2,20,1.6593406593406594,10,7
"['11000', '100', '1001000']",1,3,10,5,0,15,2.1833333333333336,8,13
"['11001', '101011', '10101', '0110', '1010001', '00010', '0111100']",1,7,19,20,5,39,13.104218004218003,62,55
"['00111', '1', '0000']",1,3,6,4,0,10,0.7777777777777777,11,6
"['0', '011', '10101', '1110100', '0111']",1,5,8,12,0,20,5.369264069264069,32,24
"['00', '111', '10011']",1,3,4,6,0,10,1.0714285714285714,8,6
"['010001', '10101', '0110', '110', '101001']",1,5,12,12,2,24,6.36017316017316,24,28
"['01', '010001', '01110']",1,3,7,6,0,13,1.6168831168831168,10,10
"['1000000', '00010', '001', '1']",1,4,12,4,0,16,2.9,22,14
"['101101', '11', '100010', '1100101', '1011', '0101']",1,6,12,17,4,29,9.297940947940948,42,59
"['00111', '1000', '011']",1,3,6,6,0,12,1.4801587301587302,9,8
"['100', '001111', '0100100']",1,3,9,7,0,16,1.505982905982906,13,10
"['1001110', '01', '11', '00011', '10000']",1,5,11,10,4,21,5.036507936507936,34,26
"['101100', '101101', '0011', '1001101', '1110100', '010110']",1,6,16,20,5,36,10.92057942057942,39,43
"['110011', '100000', '1000101', '0']",1,4,12,8,2,20,2.85989010989011,23,13
"['11010', '0010111', '1100100']",1,3,9,10,2,19,1.9047619047619047,11,11
"['11', '1001101', '00', '0111', '01100']",1,5,9,11,2,20,5.092352092352092,31,22
"['0011', '00', '000010']",1,3,9,3,0,12,1.7666666666666666,9,13
"['000110', '10001', '000', '1010']",1,4,12,6,0,18,3.982034632034632,15,16
"['0', '10111', '11101', '00011']",1,4,6,10,3,16,2.6,20,14
"['0111000', '01', '0001', '1010', '1100']",1,5,12,9,3,21,5.679292929292929,31,26
"['0', '0011001', '10111', '10000', '011000']",1,5,14,10,2,24,4.811005661005661,37,23
"['101', '00', '001001']",1,3,7,4,0,11,1.5666666666666667,9,7
"['1100111', '01', '00001']",1,3,7,7,0,14,1.5158730158730158,12,7
"['101', '01', '0001110']",1,3,6,6,0,12,1.6444444444444444,11,5
"['1', '00', '110', '0010101']",1,4,7,6,0,13,1.9944444444444445,21,12
"['010', '100001', '101000', '0000000', '11111']",1,5,17,10,2,27,4.231973581973582,39,21
"['111', '0011', '1000', '0111', '111001']",1,5,8,13,3,21,5.68095238095238,27,37
"['001010', '10110', '0100', '11']",1,4,9,8,0,17,3.5987012987012985,16,12
"['00111', '01', '11011']",1,3,4,8,2,12,1.7428571428571429,9,8
"['0010', '11', '0101101', '110', '0100']",1,5,10,10,2,20,5.676695526695527,28,24
"['11010', '00', '10010', '111110']",1,4,8,10,2,18,3.101948051948052,17,17
"['1011', '100', '11']",1,3,3,6,0,9,1.638095238095238,6,11
"['1', '0111011', '0100']",1,3,5,7,0,12,1.1954545454545453,13,5
"['01', '111100', '0011', '1010', '10011', '0111', '1011', '0000110']",1,8,16,20,4,36,16.89912864912865,77,78
"['11011', '1110101', '10', '0101', '111001']",1,5,8,16,0,24,6.460162060162061,27,38
"['0100000', '00011', '101', '1100011', '1111111']",1,5,13,16,3,29,4.852380952380952,40,33
"['1010', '1101101', '000101']",1,3,8,9,0,17,1.7888111888111888,9,8
"['0', '010', '0101', '11']",1,4,5,5,0,10,2.8238095238095235,12,12
"['111010', '1001', '10']",1,3,5,7,0,12,1.7666666666666666,9,8
"['1100111', '0010110', '01010', '001100']",1,4,13,12,2,25,3.873792873792874,19,16
"['1010', '001', '00']",1,3,6,3,0,9,2.038095238095238,5,8
"['0100000', '011', '0110', '0001111', '1010', '000']",1,6,17,11,6,28,8.283333333333333,50,52
"['11001', '000110', '10110', '110100', '010011', '1010010']",1,6,18,17,5,35,10.756177156177156,39,40
"['001', '00101', '1100001', '110100', '10']",1,5,13,10,0,23,5.525002775002775,32,30
"['1101000', '010011', '1', '011100']",1,4,10,10,2,20,2.718864468864469,27,13
"['001', '0111001', '0011', '10001', '0110010']",1,5,14,12,2,26,6.7551948051948045,29,28
"['0010001', '1', '1010', '11101', '000100', '01100']",1,6,16,12,2,28,7.541308691308691,52,33
"['1011', '1011011', '1', '001000']",1,4,8,10,0,18,2.5245254745254746,25,18
"['11000', '110010', '0101', '001']",1,4,10,8,0,18,3.6916305916305916,14,17
"['1', '0011', '101', '100110', '00010']",1,5,10,9,0,19,5.451082251082251,28,21
"['101', '10101', '10010', '111011']",1,4,7,12,2,19,4.239393939393939,14,24
"['0', '11110', '0001', '010111', '011010', '011000']",1,6,14,14,3,28,6.6823953823953826,51,46
"['0', '101', '001']",1,3,4,3,2,7,1.6666666666666665,5,5
"['11101', '10001', '000111', '1010110']",1,4,10,13,2,23,3.8214452214452215,18,18
"['01', '10', '0010101']",1,3,6,5,2,11,1.3888888888888888,12,7
"['001', '1100100', '1111', '111011', '011001']",1,5,10,16,2,26,5.993561993561993,31,35
"['0011', '101', '1001', '1000', '10010']",1,5,11,9,3,20,7.194444444444445,17,34
"['00001', '1101', '0011100', '00000']",1,4,14,7,2,21,3.1787878787878787,19,23
"['010100', '01', '00001', '000001', '010110']",1,5,17,8,3,25,5.207792207792208,30,38
"['00', '0001', '0110100', '1111']",1,4,9,8,2,17,2.27020202020202,22,15
"['0001001', '011', '00001', '0001', '100100', '001100', '110101']",1,7,23,14,3,37,12.773759573759573,58,70
"['011111', '1010', '11100', '1']",1,4,5,11,0,16,2.6311688311688313,21,14
"['0', '1110001', '0011101', '0001']",1,4,10,9,2,19,2.8870129870129873,25,16
"['0', '1010', '1010110']",1,3,6,6,0,12,1.3772727272727274,12,10
"['000110', '0010', '01', '0010111', '101000', '010110', '0000', '011010', '1010011']",1,9,28,20,8,48,22.176751026751027,106,120
"['101100', '10101', '01111', '10', '11111']",1,5,7,16,3,23,5.279220779220779,29,32
"['001', '011', '101011', '1101000', '0000110', '0110001']",1,6,18,15,5,33,8.527228327228327,55,40
"['11011', '10', '000']",1,3,5,5,0,10,1.2214285714285715,9,4
"['1010', '11010', '101']",1,3,5,7,0,12,2.496031746031746,4,11
"['0000110', '1', '000', '0110001']",1,4,12,6,2,18,2.414285714285714,27,14
"['01', '01111', '101111']",1,3,3,10,0,13,1.9805194805194803,8,11
"['01', '1010110', '00100', '1100001', '1010', '100000', '01011']",1,7,21,15,4,36,11.81008436008436,68,51
"['0001111', '1', '0100']",1,3,6,6,0,12,1.0136363636363637,14,5
"['01', '0011', '11000', '1010111', '00', '11100']",1,6,12,13,4,25,7.6860028860028855,49,44
"['001111', '11', '0010101', '100000', '0000']",1,5,15,10,2,25,4.8396658896658895,38,34
"['1', '1101110', '00110', '0000010', '01000']",1,5,15,10,4,25,4.219047619047619,40,28
"['01', '1011011', '00001']",1,3,7,7,0,14,1.349206349206349,12,7
"['0010', '000111', '1111001']",1,3,8,9,0,17,1.606993006993007,13,7
"['1100010', '10001', '10']",1,3,8,6,0,14,1.8492063492063493,10,8
"['0010', '010', '10000', '1101100']",1,4,12,7,0,19,3.4874458874458876,17,19
"['0010', '1000', '11']",1,3,6,4,2,10,1.4166666666666665,8,5
"['1011010', '11010', '110100']",1,3,8,10,0,18,2.511655011655012,6,14
"['1100', '111', '110101']",1,3,4,9,0,13,2.038095238095238,7,14
"['00', '110', '011']",1,3,4,4,2,8,1.4666666666666668,6,7
"['0', '101011', '1101001', '111110']",1,4,7,13,2,20,2.3855311355311355,24,13
"['1101', '001111', '111']",1,3,3,10,0,13,2.123809523809524,7,15
"['001', '10110', '000']",1,3,7,4,2,11,1.6666666666666665,7,8
"['11010', '001', '00000', '110001', '10100', '10010', '1011000', '1101', '0101', '1010011']",1,10,28,23,8,51,28.40873570873571,119,132
"['1011010', '1', '000', '0101001']",1,4,10,8,2,18,2.2142857142857144,26,10
"['010100', '0110101', '010', '11', '000101']",1,5,13,11,2,24,5.829059829059829,31,26
"['100', '0110', '010010']",1,3,8,5,0,13,2.038095238095238,7,10
"['0001101', '110111', '010111', '10']",1,4,8,13,2,21,3.6623931623931627,19,17
"['11000', '01', '000', '101001']",1,4,10,6,0,16,3.107431457431457,17,15
"['1101000', '110', '011', '000']",1,4,9,7,3,16,2.933333333333333,19,20
"['1010', '1100', '111011']",1,3,5,9,2,14,1.95,8,8
"['1111100', '1110000', '11000', '0000', '110']",1,5,14,12,2,26,6.207575757575757,30,44
"['0111101', '10000', '0010011']",1,3,10,9,2,19,1.2619047619047619,13,7
"['111100', '101', '0101011', '100111', '10', '0111110', '01100', '1011111']",1,8,15,28,5,43,16.05856365856366,96,77
"['01', '010', '0000100', '1001100', '110', '0100']",1,6,17,9,4,26,9.037806637806638,44,50
"['001110', '1001', '10110', '1']",1,4,7,9,0,16,3.012987012987013,20,13
"['1', '100000', '0010101']",1,3,9,5,0,14,0.9972527472527473,15,7
"['101', '1101', '000011', '1010']",1,4,8,9,2,17,3.708730158730159,16,19
"['1', '101000', '0111', '1100', '0111100']",1,5,10,12,2,22,5.105644355644356,35,27
"['0000101', '01111', '01010', '1111']",1,4,9,12,2,21,3.4636363636363634,18,17
"['0', '0001100', '1011100']",1,3,9,6,2,15,1.2142857142857144,14,12
"['1100', '011', '1010011']",1,3,6,8,0,14,1.8987012987012988,10,10
"['0', '10100', '000001', '0111']",1,4,10,6,0,16,2.2271284271284273,22,13
"['0000111', '101', '100', '0']",1,4,8,6,2,14,2.716666666666667,21,12
"['00100', '1010', '01001', '1111001']",1,4,11,10,2,21,3.8454545454545452,18,13
"['0011', '1110110', '11']",1,3,4,9,0,13,1.6565656565656566,11,11
"['1000001', '1', '011', '0010000']",1,4,12,6,2,18,2.5142857142857142,27,10
"['0011101', '111100', '10111', '0001100', '1010', '001110', '1100101']",1,7,19,23,5,42,13.062937062937063,63,62
"['0', '0011', '010']",1,3,5,3,0,8,1.4714285714285715,7,8
"['1010111', '00', '1000101', '1']",1,4,8,9,2,17,2.1031746031746033,26,13
"['0', '1110101', '1100', '011101']",1,4,7,11,0,18,3.0322177822177823,22,13
"['0111000', '0', '0111001', '101101', '1111', '10']",1,6,11,16,2,27,7.289088689088689,56,33
"['010', '01101', '001', '1011001', '0000001']",1,5,15,10,4,25,5.854761904761904,32,29
"['0', '0011', '11100']",1,3,5,5,0,10,1.1777777777777778,11,8
"['00100', '1010', '1001']",1,3,8,5,2,13,2.083333333333333,7,5
"['1100111', '010011', '0']",1,3,6,8,0,14,1.304945054945055,13,6
"['101100', '0010', '1', '0110100', '001100']",1,5,14,10,2,24,5.520496170496171,33,35
"['1011010', '00', '101']",1,3,6,6,0,12,1.4444444444444444,11,6
"['1100011', '1', '0000']",1,3,7,5,0,12,0.7954545454545454,14,4
"['0', '110111', '011']",1,3,3,7,0,10,1.4523809523809523,10,6
"['1', '111001', '1101110']",1,3,4,10,0,14,1.151098901098901,15,9
"['010', '0001110', '001111', '1', '100100']",1,5,12,11,2,23,4.9171550671550674,38,22
"['1011', '0001', '1001', '101001']",1,4,9,9,3,18,4.4,10,29
"['010', '001101', '0110', '0101010', '00', '1011']",1,6,14,12,2,26,9.65961260961261,41,44
"['1011', '0010', '001', '01111']",1,4,7,9,2,16,3.5396825396825395,13,13
"['0011110', '1', '101111']",1,3,4,10,0,14,1.304945054945055,13,4
"['0111101', '00', '11101']",1,3,5,9,0,14,1.5634920634920635,11,8
"['0', '110001', '011101']",1,3,6,7,2,13,1.2380952380952381,13,5
"['101100', '10', '0010101', '1110']",1,4,9,10,0,19,3.39013209013209,20,15
"['0', '01111', '1111010', '0000010', '011111', '1011']",1,6,12,18,2,30,7.109390609390609,59,46
"['01', '100100', '000111']",1,3,8,6,2,14,1.5,11,7
"['1011010', '1111', '0100100', '1011', '011010', '110']",1,6,13,18,4,31,8.504528804528805,43,42
"['100100', '1', '0100']",1,3,7,4,0,11,1.4857142857142858,10,7
"['110110', '1010', '00001']",1,3,8,7,0,15,1.6080808080808082,9,7
"['0', '11000', '01001']",1,3,7,4,2,11,1.2666666666666666,10,6
"['1000110', '0110', '000011']",1,3,10,7,0,17,2.0965034965034963,9,9
"['0', '0111010', '10110', '1101', '0110001']",1,5,11,13,2,24,5.402164502164502,38,22
"['11010', '00', '10', '10011', '0101']",1,5,9,9,4,18,5.852380952380952,24,21
"['0', '1110010', '0101000', '111', '00011']",1,5,12,11,2,23,4.0476190476190474,42,27
"['1', '101', '10001', '110011', '0101']",1,5,8,11,0,19,5.786796536796537,27,37
"['0110', '00', '10', '1011100', '110']",1,5,9,9,2,18,6.106637806637806,26,29
"['1110011', '111000', '1', '110100']",1,4,8,12,2,20,3.0393772893772892,23,23
"['01', '000010', '000011', '11']",1,4,10,6,4,16,3.0833333333333335,19,16
"['0000101', '1101', '001110']",1,3,9,8,0,17,1.760839160839161,11,7
"['11110', '101000', '10110', '00', '0110010']",1,5,13,12,2,25,5.474547674547675,31,30
"['1', '110100', '1101100']",1,3,6,8,0,14,1.458791208791209,12,11
"['00', '1101111', '001010']",1,3,7,8,0,15,1.1837606837606838,14,6
"['111', '101010', '00111', '1100111', '110']",1,5,8,16,2,24,6.221950271950272,29,44
"['1001100', '1011', '00', '110111']",1,4,8,11,0,19,3.1704351204351204,21,15
"['0010110', '1', '0011010']",1,3,8,7,2,15,1.2142857142857144,14,7
"['0011000', '1011110', '10101', '0111', '000', '0111110', '0101001', '111001']",1,8,21,25,4,46,16.271517371517373,93,76
"['1', '001101', '0010100']",1,3,8,6,0,14,1.304945054945055,13,7
"['0001001', '1011011', '1', '01100']",1,4,10,10,2,20,2.738095238095238,25,11
"['1111100', '01', '1000101']",1,3,7,9,2,16,1.0952380952380951,15,7
"['111100', '011', '1001000', '0110', '100010', '1010', '00']",1,7,18,14,4,32,12.066916416916417,64,60
"['110000', '00', '001', '1101']",1,4,9,6,0,15,3.249206349206349,17,18
"['1000000', '10000', '100011', '10011']",1,4,15,8,2,23,4.185081585081585,14,36
"['0100001', '101', '11110', '00100']",1,4,11,9,2,20,2.8,21,11
"['00011', '010', '100', '00000']",1,4,12,4,4,16,3.2666666666666666,16,21
"['0001001', '11', '01111', '111011', '011001', '010011']",1,6,13,19,3,32,9.0007215007215,45,54
"['1000001', '001', '00100', '11111', '1110']",1,5,12,12,2,24,4.393795093795093,35,27
"['0011011', '11000', '0101']",1,3,8,8,0,16,1.6717171717171717,10,8
"['1110111', '0', '0101111', '00111', '0101']",1,5,8,16,2,24,5.387012987012987,36,32
"['011', '000101', '111011', '1111010', '000', '1101', '110']",1,7,13,19,5,32,11.638994338994339,65,64
"['000100', '1100', '1111110', '110101']",1,4,10,13,2,23,3.2146853146853145,20,17
"['01', '100001', '0101100', '11']",1,4,9,8,2,17,2.8504273504273505,23,12
"['011111', '1', '000001']",1,3,6,7,2,13,0.9047619047619047,14,6
"['101010', '0101', '11100', '00011']",1,4,10,10,2,20,3.4020202020202017,17,14
"['010000', '0001110', '101', '0110', '1111000', '000001']",1,6,20,13,4,33,8.078832278832278,57,47
"['1', '0000010', '0000', '00010', '1011111']",1,5,15,9,2,24,4.083694083694084,42,32
"['010', '011', '00111', '10', '11100']",1,5,8,10,4,18,5.5738095238095235,26,27
"['10111', '00', '1']",1,3,3,5,0,8,0.6190476190476191,10,4
"['0110101', '111', '00011', '010010', '0101100', '1100011', '1100']",1,7,19,20,3,39,12.783694083694083,65,65
"['0010110', '110010', '01', '0011000', '01111', '1100100', '1101110', '100011']",1,8,23,24,6,47,16.788100788100788,98,81
"['01101', '00', '10', '0101', '111101']",1,5,8,11,2,19,5.942352092352092,26,26
"['01', '111', '0001', '1110110', '0101011', '0011110', '0000011', '01001', '000111']",1,9,23,25,4,48,20.625074925074927,121,110
"['010000', '001000', '11000', '1110011', '100', '100110', '1010', '10010', '0000', '110101']",1,10,31,21,8,52,29.591119991119992,119,137
"['1010110', '11011', '1001', '0010011', '00', '110']",1,6,13,15,2,28,8.898196248196248,47,40
"['1110111', '11', '10001', '1001', '0110011']",1,5,9,16,2,25,6.16955266955267,32,44
"['1101', '100000', '0000010', '1']",1,4,12,6,0,18,2.4685814185814188,25,14
"['1000010', '0011', '1001']",1,3,9,6,2,15,2.0227272727272725,9,8
"['101000', '00010', '0011111', '001000']",1,4,15,9,2,24,3.3752913752913756,19,29
"['1000', '010010', '000', '0001111']",1,4,13,7,0,20,4.084648684648685,19,24
"['011101', '01', '1111']",1,3,3,9,0,12,1.6333333333333333,9,8
"['101100', '011', '0101001']",1,3,8,8,0,16,2.0358974358974358,10,7
"['00', '011', '11']",1,3,3,4,2,7,1.2000000000000002,5,6
"['0100', '1110', '1111']",1,3,4,8,3,12,1.5,6,8
"['0011', '100010', '11']",1,3,6,6,0,12,1.7666666666666666,9,8
"['0', '0001', '110001']",1,3,7,4,0,11,1.4857142857142858,10,7
"['1001000', '0111010', '0011101', '11']",1,4,11,12,3,23,3.333333333333333,25,11
"['0010001', '10', '101101']",1,3,8,7,0,15,1.5598290598290598,12,8
"['1000011', '0110', '011', '1110']",1,4,8,10,2,18,3.6876623376623376,18,18
"['01', '1', '1110100']",1,3,4,6,0,10,1.3611111111111112,12,6
"['11110', '011011', '101', '100', '011101', '00']",1,6,10,15,4,25,8.48066378066378,43,36
"['11010', '01111', '0010011', '10100', '00', '10']",1,6,13,13,5,26,7.712698412698413,50,40
"['101011', '011010', '01111']",1,3,6,11,2,17,1.9393939393939394,7,7
"['11001', '11010', '01101', '0011', '01001', '000010', '000', '00010']",1,8,23,15,5,38,17.79011544011544,66,88
"['01', '1101', '11011', '0001000']",1,4,9,9,0,18,3.2683982683982684,21,15
"['1011', '1', '100001']",1,3,5,6,0,11,1.2857142857142856,11,13
"['110010', '11', '0011001', '0011', '011011', '10000']",1,6,15,15,2,30,8.564579864579864,48,45
"['0001010', '00', '0001111']",1,3,10,6,2,16,1.6031746031746033,12,15
"['010100', '0', '111010', '00011', '10011', '01011']",1,6,14,14,5,28,7.729004329004329,48,42
"['011101', '100011', '000001', '0001010', '110', '01011', '101001']",1,7,21,18,4,39,11.656798756798757,62,53
"['11110', '111', '100', '00', '110']",1,5,6,10,3,16,5.152380952380953,21,29
"['110010', '10101', '110111', '110', '0100']",1,5,10,14,2,24,6.192640692640692,26,27
"['110', '011', '1110']",1,3,3,7,2,10,2.095238095238095,5,11
"['0110000', '001', '10']",1,3,8,4,0,12,1.2444444444444445,12,7
"['1010', '0010', '01101', '0101100']",1,4,11,9,2,20,4.0227272727272725,15,18
"['01101', '0011', '1100010', '000101', '10100', '10', '1010000']",1,7,21,15,4,36,12.466433566433567,69,59
"['11010', '001000', '10111', '1100101', '1100', '01110']",1,6,15,17,3,32,9.23053613053613,42,39
"['01', '1', '1100101']",1,3,4,6,0,10,1.3611111111111112,12,9
"['101100', '1101', '011']",1,3,5,8,0,13,1.838095238095238,8,7
"['010100', '0000100', '0011000', '11', '0101011', '1010', '0111']",1,7,21,16,5,37,11.996292596292596,73,64
"['001100', '00', '1010001']",1,3,10,5,0,15,1.4059829059829059,12,8
"['01001', '001', '1']",1,3,5,4,0,9,1.5833333333333333,8,8
"['01', '1000', '100', '1101']",1,4,7,6,2,13,3.3285714285714283,12,16
"['1001010', '010101', '10', '10011', '0000', '1101', '11100']",1,7,17,16,4,33,12.007542457542458,62,53
"['1010111', '000', '001100', '1101', '11100']",1,5,12,13,0,25,5.507159507159507,32,30
"['1000', '01000', '110101']",1,3,9,6,0,15,2.0343434343434343,7,7
"['1000', '01111', '1110000']",1,3,8,8,0,16,1.4494949494949494,12,10
"['01011', '1000110', '011', '10']",1,4,8,9,0,17,3.4325396825396823,19,17
"['110010', '0110', '01011', '11']",1,4,7,10,0,17,3.55021645021645,17,17
"['0010', '10010', '0110']",1,3,8,5,2,13,2.083333333333333,4,13
"['0001001', '1', '011001']",1,3,8,6,0,14,1.304945054945055,13,9
"['01001', '1010100', '001110']",1,3,10,8,0,18,1.5198135198135199,10,7
"['0011011', '011', '00001']",1,3,8,7,0,15,1.6,10,9
"['1001111', '00', '110001', '0000100']",1,4,13,9,2,22,3.048229548229548,26,13
"['101', '110', '11']",1,3,2,6,2,8,2.2666666666666666,4,10
"['0', '1111', '001011', '0100']",1,4,7,8,2,15,1.9357142857142857,21,13
"['00001', '0110', '1111', '10010', '0011111', '010011']",1,6,14,17,4,31,8.22043512043512,46,40
"['0010110', '1', '000', '0011011', '101110', '01000']",1,6,16,13,2,29,7.467371517371517,55,44
"['1011', '00', '0101', '10']",1,4,6,6,4,12,3.583333333333333,12,11
"['0110101', '00', '1110', '1111']",1,4,6,11,2,17,2.8005050505050506,19,14
"['0011', '1010010', '1']",1,3,6,6,0,12,1.1954545454545453,13,6
"['111', '100010', '0000101', '00', '01001', '1110']",1,6,15,12,0,27,7.422044622044622,50,36
"['001', '000101', '0111', '0000', '110', '111101']",1,6,13,13,6,26,7.5055555555555555,45,43
"['010000', '100110', '1011', '010011', '01110']",1,5,14,13,3,27,6.651515151515151,26,28
"['0011', '01001', '000100']",1,3,10,5,0,15,1.993939393939394,8,8
"['10', '111', '0111']",1,3,2,7,0,9,1.5904761904761904,6,10
"['011', '11000', '10110', '011101', '10100', '0000']",1,6,15,13,3,28,8.494300144300144,41,42
"['10111', '0110', '1010011']",1,3,6,10,0,16,2.0454545454545454,8,7
"['111', '000101', '0011010', '01111', '1000', '100011', '1110']",1,7,16,19,4,35,12.037068487068487,62,62
"['1110101', '001001', '0001011', '11']",1,4,10,12,2,22,3.344932844932845,23,21
"['0', '1001001', '0110', '111']",1,4,7,8,0,15,2.185064935064935,22,8
"['010100', '0010', '11011', '0101110', '00011', '1111', '10', '010110']",1,8,18,21,6,39,16.091369741369743,76,83
"['0110', '0100110', '1101010']",1,3,9,9,2,18,1.987012987012987,9,14
"['11001', '0001001', '0', '11011', '01011', '0011100', '0100']",1,7,18,16,5,34,11.513275613275614,70,57
"['11011', '010', '0011', '10', '001100', '0110110']",1,6,13,14,0,27,9.147441447441448,44,41
"['10001', '0110', '11']",1,3,5,6,0,11,1.6825396825396823,9,4
"['1101001', '00', '010']",1,3,7,5,0,12,1.8444444444444446,10,4
"['0', '101', '111111']",1,3,2,8,0,10,0.9444444444444444,12,4
"['010', '1001', '0011111', '101101']",1,4,8,12,0,20,3.598934398934399,21,12
"['0', '110100', '011101', '110011', '011111']",1,5,9,16,4,25,4.809523809523809,37,27
"['0000', '11', '0001', '0100']",1,4,10,4,3,14,2.4166666666666665,14,17
"['1101001', '0110111', '0001', '0010101', '00110', '01010']",1,6,18,17,5,35,9.856998556998557,41,39
"['110000', '0011', '1001', '10', '000000']",1,5,15,7,4,22,4.966666666666667,33,29
"['0001010', '1', '0111011']",1,3,7,8,2,15,1.0714285714285714,15,4
"['1000000', '0011', '01010', '1111']",1,4,11,9,2,20,2.6565656565656566,22,13
"['00', '10101', '1']",1,3,4,4,0,8,0.9047619047619047,9,4
"['00', '1', '011', '110101']",1,4,5,7,0,12,2.3523809523809525,18,11
"['011101', '101010', '0000100', '11']",1,4,11,10,2,21,2.799145299145299,24,10
"['1010111', '00110', '000', '11']",1,4,8,9,0,17,2.8325396825396822,21,12
"['0011101', '1010', '1011011', '100']",1,4,9,12,2,21,3.844155844155844,20,17
"['00010', '100111', '011', '11']",1,4,7,9,0,16,3.297835497835498,18,15
"['010000', '11', '0010101', '10011', '10', '110']",1,6,13,12,2,25,8.053696303696304,48,36
"['11', '00', '100011', '111011']",1,4,6,10,4,16,2.4166666666666665,21,21
"['01', '00', '0111010', '001']",1,4,8,6,2,14,3.388888888888889,17,18
"['010', '0001', '000101', '00', '110']",1,5,12,6,2,18,5.801587301587301,24,31
"['1101110', '00', '01001', '01000', '0100']",1,5,14,9,2,23,6.377200577200577,28,40
"['0001', '1001', '0110']",1,3,7,5,3,12,1.75,7,6
"['00', '001', '11100', '01100']",1,4,9,6,2,15,3.742857142857143,15,25
"['01101', '1110', '0000']",1,3,7,6,2,13,1.3611111111111112,8,6
"['10001', '0011110', '0110001', '1111']",1,4,10,13,2,23,3.479076479076479,21,14
"['00011', '11', '0011', '10001', '11101', '1001111', '0100']",1,7,14,18,5,32,12.287012987012986,62,69
"['0', '0101010', '001', '0110011']",1,4,10,8,2,18,2.7142857142857144,25,15
"['00101', '0001', '100', '1001', '1110100', '000']",1,6,16,10,4,26,9.266233766233766,37,51
"['1011010', '011100', '1011110', '00', '10', '1100111', '1011011']",1,7,15,23,6,38,12.539072039072039,77,59
"['0', '00101', '0011', '110100', '01110']",1,5,11,10,2,21,4.998845598845598,32,27
"['0', '1101000', '01']",1,3,6,4,0,10,1.3611111111111112,12,6
"['0', '001', '01011', '1001010']",1,4,9,7,0,16,2.85,21,12
"['0', '0010', '011111', '11']",1,4,5,8,0,13,1.9190476190476191,21,12
"['11011', '1', '0100']",1,3,4,6,0,10,1.1777777777777778,10,4
"['00000', '1110', '1101110']",1,3,8,8,0,16,1.2828282828282829,12,10
"['1110101', '110', '01111', '00001']",1,4,8,12,2,20,2.75,21,17
"['01', '101000', '101011', '1001', '0011010', '1000', '0111', '0110110']",1,8,20,20,7,40,16.63111333111333,88,73
"['01', '1010100', '1110', '111110']",1,4,7,12,0,19,2.499106449106449,21,17
"['00', '10010', '00011']",1,3,8,4,2,12,1.7428571428571429,8,8
"['001101', '1', '1111001']",1,3,5,9,0,14,0.9972527472527473,14,9
"['010100', '01', '110101']",1,3,7,7,2,14,1.6666666666666665,10,6
"['10111', '111000', '10110', '1']",1,4,6,11,2,17,3.025108225108225,21,19
"['1110011', '1000', '1101', '1010010', '001011']",1,5,13,15,4,28,5.99050949050949,30,30
"['00100', '1110010', '100010']",1,3,11,7,0,18,2.163170163170163,9,9
"['0', '001011', '010100']",1,3,8,5,2,13,1.2380952380952381,13,9
"['101000', '010', '011']",1,3,7,5,2,12,1.7777777777777777,8,7
"['100', '001', '000010']",1,3,9,3,2,12,1.7777777777777777,9,9
"['0010', '0111001', '001101', '0000111', '01001']",1,5,16,13,2,29,6.712920412920413,30,30
"['1001010', '110110', '100', '000']",1,4,11,8,2,19,3.747008547008547,18,17
"['01', '0110', '0010', '0101100']",1,4,10,7,2,17,3.80050505050505,16,23
"['1101100', '010101', '0000011', '10', '1110']",1,5,13,13,2,26,4.647918747918748,41,25
"['001', '111', '000']",1,3,5,4,3,9,1.0,6,6
"['1', '0000110', '1011100', '01010', '110']",1,5,12,11,2,23,4.938095238095238,38,23
"['11101', '1', '01011']",1,3,3,8,2,11,1.2666666666666666,11,9
"['01011', '0111110', '011000']",1,3,8,10,0,18,1.6608391608391608,9,12
"['110010', '001', '001111', '00101', '11', '10101', '10110', '1000', '1111011']",1,9,18,25,5,43,21.092746142746144,109,112
"['00', '0110', '001011', '101111']",1,4,8,10,2,18,3.283333333333333,19,13
"['10100', '1010010', '11']",1,3,7,7,0,14,1.8492063492063493,10,10
"['0110111', '011', '0001', '1001', '010010', '011101', '000', '0101100', '0110010']",1,9,25,22,9,47,22.11832056832057,103,115
"['0010', '0111001', '11', '10101', '00110', '10011']",1,6,13,15,3,28,9.25974025974026,43,33
"['01', '11101', '11100']",1,3,4,8,2,12,1.657142857142857,8,10
"['0', '010', '011']",1,3,4,3,2,7,1.6666666666666665,5,9
"['0101', '010', '01110', '11']",1,4,6,8,0,14,3.9119047619047618,12,15
"['0', '0011', '0010', '111100']",1,4,8,7,2,15,2.6357142857142857,20,19
"['101011', '001110', '10', '0000']",1,4,10,8,2,18,3.0,21,14
"['1101011', '10', '000']",1,3,6,6,0,12,1.2444444444444445,12,4
"['11110', '1', '000101', '00', '010110']",1,5,10,10,2,20,3.948051948051948,37,22
"['010', '11', '10101', '100101', '100111', '1100', '0100']",1,7,14,16,4,30,13.214141414141414,53,57
"['0', '100011', '1011110']",1,3,6,8,0,14,1.151098901098901,14,5
"['01000', '11010', '100', '1111111']",1,4,8,12,2,20,2.966666666666667,22,13
"['11001', '01', '0']",1,3,4,4,0,8,1.5714285714285714,8,5
"['0010111', '00001', '100101', '10', '0111101']",1,5,13,14,2,27,5.009435009435009,36,26
"['1101000', '0000000', '0001111', '111111', '010111', '1011']",1,6,17,20,5,37,6.873826173826174,58,59
"['0100000', '0011101', '011']",1,3,10,7,2,17,1.4285714285714286,14,8
"['11001', '011', '000101', '10010', '0011011']",1,5,13,13,2,26,6.441958041958042,29,26
"['1', '001101', '1010', '01001', '110']",1,5,9,10,0,19,5.069264069264069,29,22
"['100', '1111110', '000011']",1,3,7,9,0,16,1.152136752136752,14,8
"['0', '1111', '1101100', '11100', '10010', '1010000', '1100']",1,7,16,17,6,33,11.25974025974026,68,65
"['011111', '0111100', '1101100']",1,3,7,13,2,20,2.087912087912088,8,14
"['11001', '11110', '010', '0110111', '011011', '10111', '101110']",1,7,12,25,5,37,13.955944055944055,56,71
"['010100', '1111101', '1000101', '0010000', '1001101', '0111', '000100']",1,7,24,20,6,44,12.498667998668,68,59
"['101011', '00110', '0100111', '0000110']",1,4,13,12,2,25,4.326173826173826,16,16
"['0001001', '11110', '101100', '0011001', '00110']",1,5,16,14,4,30,6.6296370296370295,26,34
"['1000010', '001', '111', '000011']",1,4,11,8,2,19,3.213675213675214,20,15
"['1010000', '010', '1']",1,3,7,4,0,11,1.35,12,4
"['100', '010001', '101001']",1,3,9,6,2,15,2.1666666666666665,8,9
"['1110010', '10110', '00000']",1,3,10,7,2,17,1.5666666666666667,10,7
"['100101', '001', '1', '1101110']",1,4,7,10,0,17,2.717765567765568,24,15
"['1101111', '1', '0011001', '001110', '1110110']",1,5,10,18,3,28,4.892857142857143,42,26
"['0', '1001011', '11']",1,3,4,6,0,10,0.6944444444444444,13,6
"['01', '1010', '0010010', '11100']",1,4,10,8,0,18,3.1089466089466087,20,15
"['11011', '1', '0101001']",1,3,5,8,0,13,1.25,13,8
"['11001', '101100', '01101', '0011', '10', '1110']",1,6,11,15,4,26,9.464069264069265,39,37
"['11110', '01101', '111010']",1,3,5,11,2,16,2.0545454545454547,6,9
"['00111', '1000011', '0010100', '11']",1,4,11,10,2,21,3.222222222222222,23,18
"['0', '101', '1101111', '0010000']",1,4,9,9,2,18,2.2857142857142856,29,8
"['0001010', '1', '0110']",1,3,7,5,0,12,1.3772727272727274,12,5
"['01', '111', '100', '0001010', '110101']",1,5,10,11,2,21,5.026495726495726,33,22
"['11001', '1000', '1000011', '001011', '01100']",1,5,15,12,2,27,6.1335664335664335,29,28
"['0010', '010000', '001010', '0000', '00010']",1,5,20,5,4,25,7.467171717171717,18,70
"['01', '0010', '10111', '1010', '11101']",1,5,8,12,4,20,6.048412698412698,23,25
"['0001', '11010', '1011000']",1,3,9,7,0,16,1.6565656565656566,10,8
"['1110011', '0110', '10']",1,3,5,8,0,13,1.6565656565656566,11,5
"['11001', '1101', '10', '1110']",1,4,5,10,2,15,4.2103174603174605,12,20
"['00101', '0011000', '1110011', '0001011', '1011', '110', '01110']",1,7,18,20,5,38,13.069047619047618,69,60
"['0', '0100010', '010010', '11111', '00010']",1,5,14,10,2,24,4.431518481518482,37,37
"['01', '00101', '1101', '001001', '11100']",1,5,11,11,2,22,5.811688311688312,27,33
"['10100', '01', '011011', '0100101']",1,4,10,10,0,20,3.497224997224997,21,16
"['0011101', '1', '1110']",1,3,4,8,0,12,1.3772727272727274,12,6
"['10101', '00', '0000100']",1,3,10,4,0,14,1.5158730158730158,12,8
"['1011010', '1011001', '1', '111010', '00000', '110001']",1,6,16,16,4,32,7.2607392607392605,57,41
"['100110', '00', '001001', '10110']",1,4,11,8,2,19,3.6926406926406923,18,18
"['100', '1', '011', '01010']",1,4,6,6,2,12,3.1666666666666665,15,11
"['0010', '101', '000', '1011', '1110110', '1001011']",1,6,13,15,6,28,9.046320346320346,44,38
"['01', '0010', '01110', '0100101']",1,4,10,8,0,18,3.743145743145743,18,19
"['011101', '110', '000', '11']",1,4,6,8,2,14,2.7444444444444445,17,12
"['10001', '0111010', '110', '10011']",1,4,9,11,2,20,3.4,19,14
"['00101', '1111', '00010', '110', '01011']",1,5,10,12,3,22,5.382539682539683,26,25
"['1011', '00', '100', '1111']",1,4,5,8,2,13,2.4904761904761905,14,15
"['111', '1110', '1001101']",1,3,4,10,0,14,2.1844155844155844,8,12
"['0001001', '111', '000']",1,3,8,5,2,13,1.0,12,8
"['111111', '100101', '1111001']",1,3,5,14,2,19,1.8846153846153846,8,19
"['110110', '01', '11']",1,3,3,7,2,10,1.5,9,8
"['0001001', '001', '11', '1011110', '101010', '00000', '100100', '1101100', '111000', '111101']",1,10,28,27,7,55,24.21941391941392,154,133
"['101011', '01101', '1', '0111']",1,4,5,11,0,16,3.0533910533910533,18,17
"['1000', '110001', '000101', '11']",1,4,10,8,2,18,3.4,19,19
"['1', '01011', '000', '1110']",1,4,6,7,0,13,1.9634920634920634,19,11
"['111010', '011010', '1110101', '010110', '000', '011001', '0111101', '0100']",1,8,21,24,6,45,18.532178932178933,75,92
"['1000', '110', '111100', '11']",1,4,6,9,0,15,3.4714285714285715,16,18
"['000001', '11010', '111', '0']",1,4,8,7,0,15,1.954906204906205,23,12
"['10100', '11110', '11101', '00']",1,4,7,10,3,17,2.942857142857143,17,14
"['0010', '111', '00', '01010', '0001011']",1,5,12,9,0,21,4.928860028860028,30,29
"['100', '1100000', '1000111', '00', '0100001']",1,5,17,9,3,26,5.933333333333334,37,26
"['1000110', '101', '1010', '1010011']",1,4,10,11,2,21,4.368831168831169,17,25
"['00110', '100', '1']",1,3,5,4,0,9,1.3333333333333333,9,5
"['011', '11', '101000', '100010', '01000', '100101', '01110']",1,7,18,15,5,33,11.835425685425685,62,53
"['10110', '1000111', '011001']",1,3,8,10,0,18,2.0093240093240095,10,7
"['11', '100', '0110', '110011', '0100']",1,5,9,10,2,19,5.945238095238095,25,23
"['0001110', '01', '1']",1,3,5,5,0,10,1.3611111111111112,12,4
"['00000', '10000', '1111']",1,3,9,5,2,14,1.0222222222222221,10,10
"['100001', '101011', '1000', '100101', '1101']",1,5,13,13,5,26,7.033333333333333,21,47
"['1010', '00', '1001001', '1110']",1,4,9,8,2,17,3.0353535353535355,18,12
"['101000', '0001', '1000', '101100']",1,4,13,7,4,20,3.9833333333333334,14,26
"['0', '10111', '0110', '1100100', '1111', '0111101']",1,6,10,18,4,28,7.35021645021645,53,35
"['110110', '0111010', '111', '0101', '1100']",1,5,9,15,2,24,6.5333000333000335,27,26
"['1', '10', '011000']",1,3,5,4,0,9,1.4523809523809523,10,4
"['01', '1001', '0010']",1,3,6,4,2,10,2.083333333333333,6,5
"['0', '1000', '110', '1100111']",1,4,7,8,0,15,2.866883116883117,21,13
"['1', '0111', '1101011']",1,3,3,9,0,12,1.1954545454545453,12,10
"['0010', '1110100', '000']",1,3,9,5,0,14,1.8025974025974025,9,13
"['101011', '1110110', '10101', '0110110']",1,4,9,16,2,25,4.638028638028638,14,20
"['11011', '00101', '10111', '1111', '0101']",1,5,7,16,5,23,6.722222222222222,19,39
"['0', '1001111', '11']",1,3,3,7,0,10,0.6944444444444444,13,6
"['0101', '01011', '000111']",1,3,7,8,0,15,2.216161616161616,6,10
"['1001', '100000', '111', '10011']",1,4,9,9,0,18,3.327994227994228,16,27
"['1101', '1001', '110001', '000']",1,4,9,8,2,17,3.873809523809524,13,18
"['00111', '1011', '00', '01001']",1,4,8,8,2,16,3.4095238095238094,16,13
"['1111100', '1011', '0010']",1,3,6,9,2,15,1.2272727272727273,11,6
"['0011', '01001', '0111010']",1,3,8,8,0,16,1.712121212121212,9,7
"['11', '1100', '0100']",1,3,5,5,2,10,1.75,6,8
"['00111', '0010100', '110111']",1,3,8,10,0,18,1.8554778554778555,9,11
"['101010', '00', '1000', '11111', '1010000', '1100', '1110']",1,7,16,16,3,32,11.21064491064491,60,63
"['0010', '1', '100111', '010110', '1101']",1,5,9,12,4,21,4.938095238095238,33,18
"['101', '01', '00001']",1,3,6,4,0,10,1.8714285714285714,7,9
"['0100110', '0011', '10101', '00', '110']",1,5,11,10,0,21,5.8145743145743145,30,23
"['101010', '101', '1101111', '11']",1,4,5,13,0,18,3.6264957264957265,20,24
"['01', '010011', '011']",1,3,5,6,0,11,1.9666666666666668,8,11
"['0', '00111', '1011001']",1,3,6,7,0,13,1.0833333333333333,13,4
"['1001010', '1', '0110', '0100101']",1,4,10,9,2,19,2.848051948051948,23,12
"['1101', '100', '010001']",1,3,7,6,0,13,1.838095238095238,8,7
"['111', '00001', '10101', '10', '0110011']",1,5,10,12,2,22,5.034920634920635,33,26
"['0010001', '1110011', '100', '1000', '1011111']",1,5,13,15,3,28,5.8077922077922075,36,32
"['1010', '1110011', '0101', '0101100']",1,4,10,12,4,22,4.009740259740259,20,13
"['10110', '111', '1110']",1,3,3,9,0,12,2.246031746031746,4,12
"['101', '1101', '110001', '11']",1,4,5,10,0,15,4.29047619047619,13,34
"['010', '0101101', '0001', '100', '0110', '01010', '011111']",1,7,16,16,4,32,12.523176823176822,56,69
"['100110', '110', '11', '011000']",1,4,8,9,2,17,3.8,19,14
"['1111010', '1001', '0110111']",1,3,6,12,2,18,1.6623376623376622,12,8
"['010011', '111000', '1100']",1,3,8,8,2,16,1.9,9,10
"['10100', '1000111', '11']",1,3,6,8,0,14,1.5158730158730158,12,11
"['010', '0001', '11101', '0000', '1010001']",1,5,14,9,2,23,5.432251082251082,28,25
"['1011', '10111', '0110', '000010']",1,4,9,10,2,19,3.669191919191919,16,13
"['1111100', '001', '10101', '0110', '00110', '110']",1,6,12,15,4,27,8.54069264069264,43,41
"['010101', '001111', '10']",1,3,6,8,2,14,1.4166666666666665,12,6
"['010', '111', '0010101']",1,3,6,7,2,13,1.5333333333333332,10,4
"['101', '00', '10001', '100011']",1,4,9,7,0,16,3.797186147186147,15,19
"['01', '1001', '0111', '001001', '1001111', '111101']",1,6,11,18,4,29,8.896425796425797,46,55
"['0010', '010', '111', '000011', '0011', '10110']",1,6,13,12,4,25,8.786724386724387,36,43
"['001', '0110111', '111', '101', '1001100']",1,5,9,14,5,23,5.438095238095238,32,29
"['1101', '111000', '0110', '1001']",1,4,8,10,3,18,3.8,15,12
"['101010', '110110', '010', '0100101']",1,4,11,11,2,22,3.9290598290598293,18,18
"['01', '00100', '10110', '0011010', '1010011', '101110']",1,6,16,16,4,32,9.52951492951493,45,42
"['010', '001', '111101']",1,3,5,7,2,12,1.5555555555555554,10,5
"['110010', '111', '00100', '100110', '1000', '110101', '1001111', '0001000', '0100']",1,9,26,22,7,48,21.87109557109557,110,105
"['1110111', '0', '1101101', '0001011', '1011111']",1,5,9,20,4,29,5.0,42,31
"['010100', '0100111', '110011', '110111', '01001', '1110']",1,6,14,20,3,34,9.577078477078476,40,54
"['01', '00101', '11010']",1,3,6,6,2,12,1.7428571428571429,9,7
"['00100', '110', '1111000']",1,3,8,7,0,15,1.6,11,9
"['1000000', '000111', '101', '000001']",1,4,15,7,2,22,3.1863247863247866,21,22
"['100101', '01010', '110', '1110', '1101010']",1,5,11,14,0,25,6.121323121323122,25,32
"['000100', '010', '110011', '11']",1,4,9,8,2,17,2.761111111111111,22,12
"['0000111', '1100010', '01', '001001']",1,4,13,9,2,22,3.1910866910866913,25,15
"['11000', '01', '001110']",1,3,7,6,0,13,1.331168831168831,12,7
"['1011', '0110111', '10', '11111']",1,4,4,14,0,18,3.0685425685425685,18,22
"['101000', '01', '001', '01110']",1,4,9,7,0,16,3.1795093795093794,18,15
"['0011', '0101011', '10110', '000101', '000100']",1,5,16,12,2,28,6.615617715617716,25,30
"['0', '110010', '0010000']",1,3,10,4,0,14,1.151098901098901,14,8
"['0001001', '0101110', '001101', '000000', '101110']",1,5,19,13,5,32,6.071428571428571,30,35
"['1111100', '01', '111', '0010000', '1011110', '0110', '00010', '101001']",1,8,20,21,3,41,14.843195693195693,101,70
"['0101000', '1', '0011', '0001', '0110000']",1,5,15,8,4,23,5.088961038961039,38,28
"['000110', '001', '1']",1,3,6,4,0,10,1.4523809523809523,10,5
"['1', '01010', '110101']",1,3,5,7,0,12,1.3463203463203464,11,4
"['110000', '010', '010101', '001']",1,4,11,7,4,18,3.1666666666666665,19,16
"['0', '0101000', '00111', '0100001', '0110010', '101111']",1,6,18,15,3,33,6.7062104562104565,60,37
"['0', '00010', '01101', '110']",1,4,8,6,2,14,3.0166666666666666,18,15
"['011011', '0011', '111111', '1010', '1101']",1,5,7,17,5,24,5.816666666666666,27,32
"['0100010', '011', '0000001', '1101100']",1,4,15,9,3,24,3.1714285714285713,25,15
"['010', '1100101', '010000', '0100']",1,4,13,7,0,20,4.084648684648685,17,20
"['0011', '0010', '1', '0000100']",1,4,11,5,2,16,3.0727272727272728,20,16
"['000110', '1010', '010111', '110', '01110']",1,5,11,13,2,24,6.198196248196248,24,33
"['0', '0001', '1011111']",1,3,5,7,0,12,1.0136363636363637,14,4
"['00111', '0001', '111101', '01']",1,4,7,10,0,17,3.35021645021645,18,18
"['010100', '010', '0110100', '100111', '01100']",1,5,15,12,2,27,6.787451437451438,29,41
"['101100', '11110', '11', '10101', '0110', '0011100']",1,6,12,17,2,29,9.182794982794983,43,36
"['00100', '011', '01011']",1,3,7,6,2,13,1.85,8,9
"['1011', '001', '1']",1,3,3,5,0,8,1.4714285714285715,7,8
"['1001110', '0001', '1111110', '00', '100101']",1,5,12,14,2,26,4.951814851814852,37,27
"['1', '111010', '0111011', '1100000', '00010', '111101', '0100']",1,7,17,19,4,36,10.515384615384615,78,52
"['0001', '000100', '111011']",1,3,9,7,2,16,1.5333333333333334,11,8
"['01', '1101', '110', '0']",1,4,4,6,0,10,3.4904761904761905,11,13
"['001', '00001', '011011', '1010100', '01100']",1,5,15,11,2,26,5.367404817404817,30,32
"['11001', '0001001', '10001', '000', '1011000']",1,5,17,10,4,27,6.345238095238095,29,36
"['110110', '1101000', '001']",1,3,8,8,0,16,1.6136752136752137,11,10
"['1000', '110001', '01111', '000']",1,4,10,8,0,18,3.3414862914862913,18,15
"['0111000', '0101', '11']",1,3,6,7,0,13,1.6565656565656566,11,5
"['010', '00011', '100100', '01111', '1111', '0101010', '0111111', '0000']",1,8,19,22,6,41,14.631446331446332,91,94
"['1110111', '01101', '001', '1010', '111111']",1,5,7,18,0,25,5.4409701409701405,32,31
"['0010', '111010', '0001', '011101', '011110']",1,5,12,14,5,26,6.083333333333333,28,31
"['010001', '0101', '001010', '111']",1,4,10,9,2,19,3.726984126984127,17,13
"['0011', '1101', '100', '10010']",1,4,8,8,2,16,3.7261904761904763,14,16
"['01000', '010', '000011']",1,3,10,4,0,14,1.7398989898989898,9,12
"['101100', '1011110', '01111', '1111', '001011']",1,5,9,19,2,28,6.391686091686092,26,33
"['0011', '000111', '1', '000011']",1,4,9,8,2,17,3.404761904761905,18,21
"['0', '0011', '1011111']",1,3,4,8,0,12,1.1954545454545453,13,5
"['110110', '111010', '1110101', '100000', '0111', '011000']",1,6,16,19,4,35,9.148018648018647,45,45
"['110110', '0010', '001']",1,3,7,6,0,13,1.7015873015873015,8,9
"['011111', '11100', '011', '0000']",1,4,8,10,0,18,2.6422799422799423,20,20
"['101000', '100', '001', '0111']",1,4,9,7,2,16,3.034920634920635,18,16
"['101', '0011', '011100']",1,3,6,7,0,13,1.615873015873016,9,5
"['10111', '1101101', '101']",1,3,4,11,0,15,2.1833333333333336,8,17
"['001', '010001', '101', '0110', '011001']",1,5,12,10,4,22,6.487301587301587,24,32
"['0', '100', '1100']",1,3,5,3,0,8,1.7571428571428571,6,8
"['0', '01001', '110']",1,3,5,4,0,9,1.3333333333333333,9,6
"['1000001', '010000', '10111', '101000', '1010']",1,5,17,11,2,28,6.2391608391608395,29,30
"['01', '001101', '10', '000', '111000']",1,5,11,8,4,19,4.883333333333333,33,28
"['1', '0101011', '1101100', '1000', '1100111', '0010010', '0101', '0100']",1,8,21,20,7,41,15.693506493506494,101,72
"['100', '1011001', '11']",1,3,5,7,0,12,1.4444444444444444,11,9
"['0010011', '1100', '001000']",1,3,11,6,0,17,1.9146853146853147,9,15
"['111110', '01010', '1001']",1,3,6,9,0,15,1.208080808080808,10,5
"['0001011', '1010', '1', '0011100']",1,4,10,9,2,19,2.705194805194805,27,12
"['0101111', '0011', '100', '0000111', '0101001']",1,5,14,14,3,28,6.114285714285714,34,30
"['01', '110', '100', '0000110', '0100']",1,5,12,7,2,19,5.36998556998557,28,29
"['010011', '1', '00001']",1,3,7,5,0,12,1.3463203463203464,11,6
"['100010', '1', '0111100']",1,3,7,7,0,14,0.9972527472527473,16,4
"['11', '0001', '0000', '0101', '0011100']",1,5,13,8,3,21,5.012626262626262,29,29
"['1', '00101', '10001', '0110', '0100']",1,5,11,8,4,19,5.261111111111111,28,19
"['00100', '01', '111']",1,3,5,5,0,10,1.2214285714285715,9,4
"['11010', '1', '1001000', '110011', '01100']",1,5,12,12,2,24,5.238977688977689,36,22
"['01100', '10101', '01110']",1,3,7,8,3,15,1.8,7,6
"['0001', '1111000', '1111', '1010111', '01000', '01001', '000111', '0110001']",1,8,22,23,7,45,16.95993450993451,90,101
"['11011', '111', '1110', '0100']",1,4,5,11,2,16,3.503968253968254,13,20
"['00', '0101', '10010']",1,3,7,4,0,11,1.9047619047619047,8,6
"['0000001', '010110', '0001111']",1,3,12,8,2,20,1.4945054945054945,10,8
"['1011', '110', '1011100', '1111']",1,4,5,13,2,18,3.5155844155844154,15,22
"['1', '1001010', '111110', '01001', '101110', '0100101']",1,6,14,18,4,32,7.196636696636697,56,41
"['1011', '01', '110', '1110']",1,4,4,9,2,13,3.3285714285714283,12,17
"['0', '1000001', '011', '101011', '10100', '010011', '1011011']",1,7,17,18,4,35,11.225607725607725,71,66
"['10001', '100', '1111', '00110', '00010']",1,5,12,10,3,22,5.3468253968253965,27,22
"['01', '1', '00000']",1,3,6,2,0,8,0.9523809523809523,10,4
"['100', '1000', '001001', '0110']",1,4,11,6,2,17,3.795238095238095,15,17
"['0111111', '010101', '1000', '111011']",1,4,8,15,2,23,2.9254079254079253,21,16
"['1', '0110', '0010011']",1,3,6,6,0,12,1.1954545454545453,13,4
"['010', '001', '110', '00001']",1,4,9,5,3,14,3.1666666666666665,15,16
"['100', '10', '0110001', '101101']",1,4,9,9,0,18,3.7803418803418802,20,16
"['01001', '011010', '00', '101001']",1,4,11,8,2,19,3.6926406926406923,17,15
"['101', '0010010', '001', '00101']",1,4,11,7,2,18,4.2,15,21
"['010', '101101', '10000', '1010', '100101', '110']",1,6,14,13,4,27,9.37907647907648,33,42
"['0011001', '001', '110']",1,3,7,6,2,13,1.5333333333333332,11,10
"['011111', '1', '00011']",1,3,4,8,0,12,1.1645021645021645,12,7
"['010000', '1', '100', '110001', '10']",1,5,11,7,2,18,5.538095238095238,30,20
"['1110011', '110', '1']",1,3,3,8,0,11,1.35,12,10
"['11101', '110', '10000']",1,3,6,7,2,13,1.65,8,7
"['1000110', '110', '011', '111']",1,4,6,10,3,16,3.5999999999999996,16,19
"['0001', '011010', '010111']",1,3,8,8,2,16,1.4666666666666668,9,7
"['011', '1111101', '10']",1,3,3,9,0,12,1.2444444444444445,12,7
"['0', '1010010', '1100101', '10000']",1,4,12,8,2,20,3.0238095238095237,23,11
"['11', '0011010', '0100011', '0101', '11100']",1,5,12,13,2,25,5.7640692640692635,35,26
"['01', '111100', '10']",1,3,4,6,2,10,1.25,11,6
"['1000100', '1011', '1000', '001101']",1,4,12,9,2,21,3.3881118881118883,19,20
"['0', '1101', '01001', '000101']",1,4,9,7,0,16,3.012987012987013,19,14
"['0', '11011', '00100', '100100', '0101']",1,5,12,9,2,21,5.14025974025974,31,23
"['0010', '010010', '100111', '0101001', '101111']",1,5,14,15,3,29,6.345454545454546,30,24
"['11001', '01', '1101011', '001100', '1011111']",1,5,10,17,2,27,5.669275169275169,38,27
"['110', '01111', '000']",1,3,5,6,2,11,1.0833333333333333,9,7
"['11110', '1110010', '100001', '011', '101', '100110', '100111', '000']",1,8,18,21,6,39,16.20858585858586,85,81
"['1100001', '01111', '10', '1100110']",1,4,9,12,2,21,2.888888888888889,26,18
"['0', '100110', '011', '1111']",1,4,5,9,0,14,2.4238095238095236,19,12
"['0001010', '0100100', '1011', '000101']",1,4,15,9,2,24,4.240359640359641,16,17
"['11110', '00101', '1011100', '000000', '0101', '01110']",1,6,17,15,3,32,8.31072261072261,46,44
"['001', '10110', '10']",1,3,5,5,0,10,1.4714285714285715,8,8
"['101010', '0001101', '00', '0000010', '0111', '1101']",1,6,17,13,4,30,7.574736374736375,53,40
"['1010', '0001', '101110', '0111']",1,4,8,10,3,18,3.5,16,15
"['010000', '001', '1011110', '000001', '10']",1,5,15,9,2,24,4.541452991452991,39,29
"['011101', '01', '0011110', '01111']",1,4,7,13,0,20,4.027528027528027,18,18
"['010', '0101011', '1']",1,3,5,6,0,11,1.35,12,6
"['1010100', '010001', '10', '011010']",1,4,12,9,2,21,3.1752136752136755,22,15
"['011011', '11000', '10100', '110', '0100']",1,5,12,11,2,23,6.534559884559885,24,30
"['0001001', '100', '011']",1,3,8,5,2,13,1.5333333333333332,11,7
"['011011', '10111', '000110']",1,3,7,10,2,17,1.9393939393939394,9,5
"['11001', '001011', '010110']",1,3,8,9,2,17,1.9242424242424243,8,5
"['110000', '111', '100100', '100011', '10', '1011', '111000', '111001']",1,8,18,21,5,39,16.771428571428572,83,107
"['00001', '11', '101011', '0010011', '011001', '0011100']",1,6,17,16,4,33,8.26001776001776,51,42
"['0', '0001100', '01010']",1,3,9,4,0,13,1.25,13,12
"['010', '0001', '000101', '0010011', '1111011']",1,5,14,13,2,27,5.749383949383949,34,27
"['1001100', '0100100', '011', '0111']",1,4,11,10,2,21,4.0051948051948045,19,19
"['101010', '001', '0']",1,3,6,4,0,10,1.2301587301587302,10,6
"['1', '00101', '1110011', '110111', '0000']",1,5,10,13,0,23,3.7730103230103227,40,27
"['00111', '101', '1000', '0010010']",1,4,11,8,0,19,3.50981240981241,19,15
"['0', '010011', '100101']",1,3,7,6,2,13,1.4047619047619047,12,4
"['0010000', '100', '10110', '1010100', '1100110', '0010010', '0100']",1,7,25,15,4,40,14.377272727272727,61,78
"['11001', '0011', '10']",1,3,5,6,0,11,1.5714285714285714,9,7
"['0', '1111', '010101', '1011', '0110010', '0000110', '101001']",1,7,17,18,6,35,10.637728937728937,76,43
"['1000100', '00100', '100000', '00010', '0101001']",1,5,22,8,4,30,7.338295038295039,22,38
"['10101', '010001', '10011']",1,3,8,8,2,16,2.254545454545455,6,10
"['110000', '101', '011000']",1,3,9,6,2,15,1.7222222222222223,10,6
"['011', '01111', '001010', '000', '110', '1110']",1,6,11,13,3,24,7.937518037518037,38,47
"['11', '0101101', '101', '0011', '000', '1011']",1,6,10,13,4,23,8.60137085137085,38,42
"['0111111', '1001', '101111']",1,3,4,13,0,17,1.732867132867133,10,12
"['0001', '010000', '10', '011']",1,4,10,5,0,15,2.8492063492063493,18,15
"['10111', '00010', '1101101']",1,3,7,10,2,17,1.7333333333333334,9,5
"['01', '100', '1100000', '0000']",1,4,12,4,0,16,2.854256854256854,20,21
"['0111000', '11011', '10000', '110011', '0100']",1,5,14,13,2,27,6.074980574980575,29,27
"['0', '1100010', '010', '111']",1,4,7,7,2,14,2.283333333333333,21,14
"['001110', '0010000', '1111']",1,3,9,8,0,17,1.3972027972027972,12,7
"['1101000', '00', '10011']",1,3,8,6,0,14,1.5158730158730158,12,7
"['1101111', '111', '100110', '00', '1010011', '0101']",1,6,11,18,2,29,7.485170385170385,53,41
"['110110', '0100000', '101001', '1000', '11100', '001011', '0100101']",1,7,23,18,5,41,12.945987345987346,63,55
"['1010', '001', '1', '0111010']",1,4,7,8,0,15,2.8487012987012985,20,13
"['11001', '000011', '10', '01001', '0101', '1100']",1,6,14,12,4,26,9.41002886002886,36,43
"['111000', '00101', '110101']",1,3,8,9,2,17,1.7575757575757576,9,11
"['011010', '001010', '100001', '101111']",1,4,12,12,4,24,3.3333333333333335,17,12
"['101', '01', '00', '11']",1,4,4,5,3,9,3.0,8,11
"['1001110', '11010', '0000100', '11101', '10']",1,5,13,13,4,26,5.26031746031746,37,23
"['11110', '111', '000011', '101', '00100', '1000']",1,6,13,13,4,26,7.432900432900433,45,42
"['011', '10110', '1010', '0000', '0011011', '1101', '01011']",1,7,15,17,5,32,12.924531024531024,54,56
"['0', '0010', '010111', '110100']",1,4,9,8,2,17,2.6714285714285713,22,16
"['001', '0111101', '110', '010']",1,4,7,9,3,16,3.2666666666666666,18,15
"['1001', '0010010', '10', '1101', '111000', '1100']",1,6,14,13,3,27,9.446192696192696,41,38
"['0110111', '1011110', '1000', '00110', '000', '011111', '0101']",1,7,16,20,4,36,11.771411921411921,68,60
"['01', '00', '100111', '1111011']",1,4,6,11,2,17,2.782051282051282,23,13
"['1010', '001', '0000100', '100010']",1,4,14,6,0,20,3.9527805527805526,17,17
"['0', '1010', '111101']",1,3,4,7,0,11,1.2857142857142856,11,4
"['0100001', '0010100', '0111']",1,3,11,7,2,18,1.6623376623376622,11,7
"['0110101', '0011', '01110', '11']",1,4,7,11,0,18,3.7279942279942277,17,14
"['100', '1100', '101111']",1,3,5,8,0,13,1.7015873015873015,9,10
"['0011', '1101', '1000111']",1,3,6,9,2,15,1.7727272727272727,10,11
"['0100000', '1', '01011']",1,3,8,5,0,13,1.0833333333333333,14,6
"['0100111', '1011110', '01100', '101001', '0110', '100011', '1001011', '0100']",1,8,22,24,7,46,18.787418137418136,80,76
"['0100010', '0011', '1110011', '10000', '1000', '001100']",1,6,20,13,4,33,9.45977355977356,46,47
"['110000', '001', '000011', '0001', '1010100', '0110', '1111']",1,7,19,15,5,34,10.737867687867688,67,61
"['1111', '110', '011', '0000']",1,4,6,8,4,14,2.380952380952381,16,15
"['1101', '100', '1']",1,3,3,5,0,8,1.4714285714285715,7,8
"['110000', '101', '00', '10']",1,4,8,5,2,13,3.1444444444444444,16,13
"['1010001', '0110110', '001100']",1,3,11,9,2,20,1.9560439560439562,10,4
"['100011', '111010', '011110']",1,3,7,11,3,18,1.6666666666666665,9,6
"['011', '0011', '111110', '0111', '1100111', '1010000']",1,6,12,19,4,31,8.431207681207681,50,52
"['0', '1010', '011']",1,3,4,4,0,8,1.4714285714285715,7,6
"['1110111', '010011', '10', '0100']",1,4,8,11,0,19,3.39013209013209,21,15
"['01', '11000', '00100', '1100100', '110100', '1000', '1001001', '00010']",1,8,26,15,5,41,18.65883005883006,74,95
"['101100', '0001110', '111', '001000', '0101101', '1110011', '0010100', '0000110', '0100']",1,9,30,24,7,54,21.875990675990675,118,119
"['101000', '11000', '001', '100110']",1,4,12,8,2,20,3.7323232323232323,17,18
"['110011', '11110', '1']",1,3,3,9,0,12,1.1645021645021645,12,10
"['0110100', '000', '0000110', '111101', '111001']",1,5,15,14,4,29,5.225274725274725,37,26
"['00101', '0110', '0100', '0000', '010011', '1101010']",1,6,18,12,3,30,9.377505827505827,37,48
"['1000110', '010', '1', '000']",1,4,9,5,2,14,2.4166666666666665,20,11
"['11100', '10001', '010', '1']",1,4,7,7,2,14,2.7666666666666666,19,10
"['1011', '11010', '100011', '1110']",1,4,7,12,2,19,3.396969696969697,14,23
"['0', '001', '1001100', '1101', '1001011']",1,5,11,11,2,22,5.158441558441559,37,24
"['1000', '1', '1101100', '00001']",1,4,10,7,0,17,2.528787878787879,23,16
"['010', '1110010', '110']",1,3,6,7,2,13,1.8666666666666667,9,11
"['0', '1000', '00101', '1001010']",1,4,11,6,0,17,2.9883838383838386,21,15
"['1000001', '11', '100', '1111001', '1101100', '10']",1,6,13,15,5,28,8.023809523809524,55,49
"['11010', '011011', '1110110', '10000', '01010', '001100', '01001', '110101']",1,8,22,23,7,45,18.82051282051282,75,75
"['0110101', '0010', '010', '1']",1,4,8,7,0,15,3.3344155844155843,19,13
"['001', '1111101', '1101010']",1,3,6,11,2,17,1.3714285714285714,12,8
"['01101', '10001', '010', '0011110']",1,4,10,10,2,20,3.4166666666666665,20,13
"['0001001', '010011', '101101', '00011']",1,4,13,11,2,24,4.339160839160839,15,19
"['0001', '1010011', '0001111']",1,3,9,9,2,18,2.168831168831169,10,10
"['010100', '1011', '1']",1,3,5,6,0,11,1.2857142857142856,11,4
"['11001', '11000', '1111', '1001101', '00110', '10', '0111', '1110110']",1,8,15,24,7,39,16.612914862914863,86,85
"['1010', '10011', '01110']",1,3,6,8,2,14,1.711111111111111,7,6
"['10111', '110', '1110']",1,3,3,9,0,12,2.0238095238095237,6,12
"['101010', '0001', '0010111', '011100']",1,4,12,11,2,23,3.0762237762237765,20,15
"['101', '100010', '1010', '1010001', '01011']",1,5,13,12,0,25,7.049100899100899,26,35
"['100011', '000111', '001']",1,3,8,7,2,15,2.1666666666666665,8,8
"['111', '1111001', '100011', '0000111', '110', '01011']",1,6,12,19,4,31,8.296015096015095,51,62
"['0', '01001', '010011', '01010']",1,4,10,7,2,17,3.3887445887445886,18,22
"['00010', '010', '11']",1,3,6,4,0,10,1.4357142857142857,8,6
"['1001110', '00101', '00110', '1000', '01100']",1,5,15,11,3,26,6.7272727272727275,25,33
"['100110', '10', '101000']",1,3,8,6,2,14,1.6666666666666665,11,10
"['0101', '0110111', '11']",1,3,4,9,0,13,1.8383838383838382,10,9
"['11', '0011010', '10', '1100011', '1010010']",1,5,12,13,5,25,5.023809523809524,41,27
"['101', '1110001', '0111001']",1,3,7,10,2,17,2.057142857142857,10,12
"['1110101', '1101110', '111001']",1,3,6,14,2,20,2.10989010989011,8,14
"['111', '1110101', '00', '000010', '000100']",1,5,14,10,2,24,4.245299145299145,40,29
"['01001', '1110', '00001']",1,3,8,6,2,14,1.4666666666666668,8,8
"['1011010', '0110100', '011011', '10101', '0100']",1,5,14,15,2,29,6.995604395604396,25,29
"['0001', '000100', '1']",1,3,8,3,0,11,1.4857142857142858,10,8
"['110011', '00100', '01001', '01']",1,4,10,8,2,18,3.7155844155844155,18,12
"['11000', '01', '100']",1,3,6,4,0,10,1.4357142857142857,8,7
"['0010', '111', '101000', '1000', '111110', '0111', '01100']",1,7,15,17,5,32,11.123520923520923,59,62
"['101', '100', '0111', '000', '110']",1,5,8,8,4,16,5.0476190476190474,19,22
"['0', '110000', '101101', '101011', '100110']",1,5,12,13,4,25,4.809523809523809,37,23
"['101', '1010', '0111', '000010', '000', '110']",1,6,13,10,5,23,7.817460317460317,38,39
"['0101000', '1100101', '001101']",1,3,11,9,2,20,1.8021978021978022,10,7
"['1', '1111110', '01010']",1,3,4,9,0,13,0.9166666666666666,14,5
"['100110', '1000', '0110']",1,3,8,6,2,14,2.1,7,11
"['0100000', '010101', '00', '11']",1,4,11,6,2,17,2.282051282051282,24,14
"['101', '00000', '010110', '100010']",1,4,13,7,2,20,3.356060606060606,18,12
"['11', '0000000', '00001']",1,3,11,3,0,14,0.9523809523809523,14,10
"['11110', '1101111', '111010', '0011001', '100000', '01010', '111001']",1,7,18,24,7,42,11.977256077256078,66,67
"['1', '00110', '1000', '0110010', '0101']",1,5,12,9,2,21,5.156060606060606,34,21
"['10101', '0000011', '11']",1,3,7,7,0,14,1.5158730158730158,12,10
"['1110111', '000110', '11100']",1,3,7,11,0,18,1.6736596736596736,11,10
"['0011', '00', '010110', '01100']",1,4,10,7,0,17,3.932034632034632,16,24
"['101010', '00', '01101', '000101']",1,4,11,8,2,19,3.5108225108225106,19,16
"['000110', '010', '10110', '111']",1,4,8,9,2,17,3.4217171717171717,15,15
"['1011', '0110110', '1110']",1,3,5,10,2,15,1.7727272727272727,8,7
"['010', '000011', '00011', '101011', '00110', '0000111']",1,6,18,14,4,32,10.357148407148408,39,52
"['010', '100100', '1100']",1,3,8,5,0,13,1.838095238095238,7,8
"['001', '100', '000000']",1,3,10,2,2,12,1.5555555555555554,10,11
"['100110', '0010', '11011', '100000']",1,4,12,9,2,21,3.602020202020202,16,14
"['10101', '1', '010110']",1,3,5,7,0,12,1.3463203463203464,12,4
"['0110100', '0011100', '11']",1,3,8,8,2,16,1.746031746031746,12,7
"['0010', '010', '00101']",1,3,8,4,0,12,2.496031746031746,4,13
"['01101', '0011', '0001111', '1010', '1000', '010111', '1000011', '1110']",1,8,19,22,6,41,16.63273948273948,83,82
"['001', '0001', '111011', '00', '010101']",1,5,11,10,2,21,5.42936507936508,29,27
"['01001', '0101011', '1']",1,3,6,7,0,13,1.4166666666666667,12,8
"['111010', '01100', '1001', '110100', '10', '1111111']",1,6,11,19,2,30,8.388755688755689,51,39
"['10000', '11010', '1', '011']",1,4,7,7,2,14,2.5166666666666666,19,13
"['110110', '011', '1110101', '10010', '011001', '011111']",1,6,12,21,3,33,9.725874125874126,44,45
"['0', '010011', '100']",1,3,6,4,0,10,1.4523809523809523,10,6
"['01', '001', '10001', '01111', '000', '1100', '110101']",1,7,14,14,4,28,11.708441558441558,56,57
"['100001', '1100100', '10', '10011', '11111']",1,5,11,14,2,25,5.228393828393829,34,35
"['010', '100011', '0000001', '0110111']",1,4,13,10,2,23,2.807081807081807,23,12
"['00100', '11011', '01010', '1110']",1,4,9,10,3,19,3.3555555555555556,15,13
"['11011', '0101000', '0001', '0001100', '0000', '001100', '1101']",1,7,23,14,5,37,12.643967143967144,60,84
"['0', '1110110', '010111']",1,3,5,9,0,14,1.151098901098901,14,8
"['00', '1000', '1001010', '0100']",1,4,12,5,2,17,3.80050505050505,17,21
"['11010', '010000', '11']",1,3,7,6,0,13,1.3668831168831168,11,6
"['0', '00001', '0011001', '1100011', '01001']",1,5,15,10,4,25,5.204761904761905,35,26
"['1010', '0100000', '1']",1,3,8,4,0,12,1.1954545454545453,13,4
"['01', '111', '000']",1,3,4,4,2,8,0.8,7,4
"['0', '11010', '1010111', '000011']",1,4,9,10,0,19,2.5147352647352648,25,13
"['111', '01111', '00', '010111', '1101']",1,5,6,14,0,20,5.164574314574314,26,33
"['00011', '101', '1000000', '10100', '0100001']",1,5,18,9,4,27,5.697619047619048,34,29
"['110000', '0010', '100', '110111']",1,4,10,9,2,19,2.9825396825396826,19,16
"['101', '01001', '100', '100111']",1,4,8,9,2,17,4.2272727272727275,14,19
"['1101001', '111', '101000', '101', '110100', '1100', '001011', '110101']",1,8,18,23,6,41,18.656454656454656,74,114
"['01101', '0101110', '010111']",1,3,7,11,0,18,2.317016317016317,6,13
"['101100', '01', '10010', '10110']",1,4,9,9,2,18,3.897402597402597,14,19
"['0011011', '001', '010110', '010000']",1,4,13,9,2,22,3.3863247863247863,20,20
"['010', '1000010', '00110', '01010', '1010011', '000000']",1,6,22,11,4,33,9.183705183705184,45,48
"['00011', '10101', '1001', '100', '0100011', '011010']",1,6,16,14,2,30,10.090903540903541,39,39
"['11010', '0101000', '1', '1001000', '00']",1,5,14,8,2,22,4.484126984126984,39,26
"['110010', '010111', '000101']",1,3,9,9,3,18,1.8333333333333333,8,7
"['0', '10111', '0101', '001']",1,4,6,7,0,13,2.9714285714285715,15,11
"['0', '010000', '0110', '111011', '111000']",1,5,12,11,3,23,4.723809523809524,35,27
"['101011', '1111', '1101', '110', '0100']",1,5,7,14,3,21,5.544444444444444,21,30
"['10100', '00', '010000', '000011']",1,4,14,5,2,19,3.329004329004329,20,25
"['10111', '010', '10000']",1,3,7,6,2,13,1.4,9,5
"['11101', '10010', '1111']",1,3,4,10,2,14,1.9333333333333331,7,12
"['0', '011011', '010110']",1,3,6,7,2,13,1.2380952380952381,12,9
"['011011', '01', '0010100']",1,3,8,7,0,15,1.5598290598290598,12,7
"['1101101', '10', '01100']",1,3,6,8,0,14,1.6825396825396823,11,4
"['1011', '0001', '001100']",1,3,8,6,2,14,1.7,8,6
"['0', '0010', '0011000', '110001', '01111']",1,5,13,10,0,23,4.855450105450106,39,24
"['101000', '00101', '0000']",1,3,11,4,0,15,1.812121212121212,7,13
"['010', '011110', '11']",1,3,4,7,0,11,1.5666666666666667,9,6
"['101', '10100', '110']",1,3,5,6,2,11,1.9166666666666665,6,8
"['0000101', '0101', '1', '0001000']",1,4,13,6,2,19,2.8870129870129873,25,17
"['0010110', '00', '0001110']",1,3,10,6,2,16,1.746031746031746,12,19
"['101', '1011100', '0101100']",1,3,8,9,2,17,2.057142857142857,10,9
"['00110', '010001', '0010000']",1,3,13,5,0,18,1.9813519813519813,9,11
"['110111', '101', '111', '10011']",1,4,4,13,2,17,3.977272727272727,13,35
"['01', '0010010', '1101111']",1,3,7,9,2,16,1.3174603174603174,15,4
"['0001', '110001', '10110', '1010100', '0001100', '111111', '10', '000', '111101']",1,9,22,24,5,46,18.216944166944167,125,107
"['100', '110', '1110100']",1,3,6,7,2,13,1.8666666666666667,9,9
"['00001', '0011', '10000', '00010', '01000']",1,5,18,6,4,24,6.622222222222222,22,39
"['00', '001110', '011110']",1,3,7,7,2,14,1.8333333333333335,9,17
"['1001', '1', '0101100']",1,3,6,6,0,12,1.1954545454545453,13,4
"['1010001', '001', '1100', '11']",1,4,8,8,0,16,3.40981240981241,19,19
"['110110', '1001000', '10']",1,3,8,7,0,15,1.5598290598290598,12,8
"['0011', '111110', '0111010', '1011000']",1,4,10,14,2,24,3.435964035964036,20,15
"['0010', '0111010', '0001110', '111100', '011100', '00100', '0110']",1,7,21,18,6,39,14.645249195249196,53,109
"['11', '01111', '0000001', '00', '0101100', '0101']",1,6,15,12,4,27,6.6226551226551225,55,41
"['010', '0011001', '11000', '00110', '1000']",1,5,15,9,2,24,6.622438672438673,28,34
"['10001', '01111', '001101']",1,3,7,9,2,16,1.6727272727272728,9,7
"['11001', '111', '0110000', '00', '100011', '110']",1,6,13,13,2,26,7.980752580752581,47,38
"['1011', '0001', '1', '0000']",1,4,8,5,3,13,2.3,16,14
"['001011', '0101101', '10000', '10', '0111', '101110']",1,6,14,16,2,30,8.494738594738594,50,37
"['0', '1110000', '00100', '110001', '11101', '001100']",1,6,17,13,4,30,7.833316683316683,54,42
"['11010', '1001', '0110', '0010100', '001110']",1,5,14,12,2,26,6.487412587412587,28,27
"['10100', '0001', '000']",1,3,9,3,0,12,1.8015873015873014,6,13
"['0100000', '010000', '0001110', '1100100', '010110', '000']",1,6,25,11,5,36,9.514285714285714,45,85
"['110010', '0110100', '011', '10100', '00']",1,5,13,10,0,23,5.79015429015429,33,33
"['00110', '0001', '011']",1,3,7,5,0,12,1.9880952380952381,6,7
"['11001', '011', '101110', '0111']",1,4,6,12,0,18,4.0359307359307355,16,17
"['1111', '100100', '00001']",1,3,8,7,0,15,1.1676767676767676,11,7
"['0110101', '1010', '00']",1,3,7,6,0,13,1.8383838383838382,10,6
"['101111', '001101', '011110', '111']",1,4,6,15,3,21,4.0,16,14
"['011100', '11', '101001', '010110', '011110', '0111', '0100101']",1,7,16,21,4,37,13.087101787101787,60,60
"['100', '001', '10']",1,3,5,3,2,8,1.8666666666666667,5,8
"['0010', '011010', '10', '011000']",1,4,11,7,2,18,3.9,16,26
"['1010110', '001', '111']",1,3,5,8,2,13,1.1333333333333333,10,6
"['001', '0111110', '0111']",1,3,5,9,0,14,1.6987012987012986,10,9
"['1010111', '101100', '000']",1,3,8,8,0,16,1.45982905982906,11,8
"['0010001', '000110', '010', '0111010', '0010111', '11']",1,6,17,15,3,32,8.403296703296704,55,42
"['0001110', '011', '111', '000', '1010011']",1,5,11,12,5,23,4.914285714285715,34,26
"['0011', '100000', '1011000']",1,3,11,6,0,17,1.5608391608391607,10,11
"['11010', '1001010', '101101', '0000', '0101', '110']",1,6,15,14,2,29,8.915456765456765,40,38
"['000110', '001010', '10']",1,3,9,5,2,14,1.8333333333333335,10,12
"['0010', '110', '1', '1011001']",1,4,7,8,0,15,2.866883116883117,21,11
"['1010110', '00000', '0010101', '11']",1,4,12,9,2,21,2.7698412698412698,25,12
"['010', '1', '0000100']",1,3,8,3,0,11,1.35,12,4
"['0', '111100', '10011', '1000011', '0101']",1,5,11,12,0,23,4.721495171495172,40,25
"['0001', '0000110', '0100']",1,3,11,4,2,15,1.5909090909090908,9,12
"['010', '111110', '10000']",1,3,7,7,0,14,1.308080808080808,11,7
"['011011', '011101', '1010', '111']",1,4,6,13,2,19,3.938095238095238,16,16
"['0110100', '110001', '011101', '0001010', '110101']",1,5,16,16,5,32,7.034798534798535,26,25
"['1101', '1100', '110100', '1101110']",1,4,8,13,2,21,4.573776223776224,13,29
"['00101', '0000100', '0101010', '1010', '0011011', '00010', '110']",1,7,23,15,5,38,12.946753246753246,61,70
"['1010010', '100', '00000']",1,3,11,4,0,15,1.6,10,9
"['1', '00000', '000101', '1010011', '101111', '1101010']",1,6,16,16,4,32,6.797369297369298,59,39
"['110', '010111', '0011111', '00000']",1,4,10,11,0,21,2.5606449106449105,24,18
"['010', '100110', '1000', '1011', '11100']",1,5,11,11,2,22,6.0660894660894655,24,25
"['010', '11', '00011', '010110', '000010', '11100']",1,6,15,12,4,27,8.071645021645022,47,45
"['0110000', '1', '011', '0100']",1,4,9,6,0,15,3.0487012987012987,20,15
"['010', '1111101', '11011', '1100000', '01011', '01000']",1,6,15,17,5,32,8.028571428571428,51,46
"['001101', '111', '0001', '1110101', '101001']",1,5,11,15,2,26,5.867299367299367,28,39
"['11001', '10110', '0011010', '0101010', '00']",1,5,14,12,4,26,6.179365079365079,33,27
"['1011011', '100', '1', '1010101']",1,4,7,11,2,18,3.057142857142857,24,22
"['11110', '0101111', '010010', '1001101', '0111']",1,5,11,18,2,29,6.374225774225774,29,30
"['11001', '1011101', '00']",1,3,6,8,0,14,1.6825396825396823,11,5
"['010', '100', '0111', '1111']",1,4,5,9,4,14,2.845238095238095,14,15
"['011100', '11010', '1', '011110']",1,4,7,11,2,18,3.0108225108225106,20,14
"['001', '101010', '10011', '0101', '110', '01100']",1,6,13,13,4,26,8.871139971139971,38,34
"['011111', '1001100', '0111011']",1,3,7,13,2,20,1.9560439560439562,9,10
"['110010', '010111', '00101']",1,3,8,9,2,17,1.9545454545454546,8,7
"['010', '0100110', '10', '000']",1,4,10,5,2,15,3.511111111111111,17,23
"['0010', '101110', '010110']",1,3,8,8,2,16,2.033333333333333,7,12
"['00100', '01', '00']",1,3,7,2,2,9,1.6428571428571428,7,12
"['0', '01', '1011100']",1,3,5,5,0,10,1.3611111111111112,12,6
"['101000', '100', '10010', '1']",1,4,9,6,0,15,3.262987012987013,18,17
"['0', '110001', '110111']",1,3,5,8,2,13,1.2380952380952381,12,7
"['101', '11110', '110']",1,3,3,8,2,11,1.9166666666666665,7,9
"['0010', '11011', '001', '00000']",1,4,11,6,2,17,3.168253968253968,16,16
"['0001011', '000111', '001010', '0']",1,4,12,8,2,20,3.1804029304029307,22,20
"['1100', '010', '1', '000001']",1,4,9,5,0,14,2.6015873015873017,20,11
"['10', '0100', '00011']",1,3,7,4,0,11,1.3968253968253967,9,7
"['0', '111', '01010', '111011']",1,4,5,10,0,15,2.331168831168831,21,14
"['01', '001', '00', '110111', '01110']",1,5,8,10,2,18,5.664574314574315,28,22
"['0', '0001010', '11']",1,3,6,4,0,10,0.6944444444444444,13,4
"['00', '010', '01001']",1,3,7,3,0,10,2.1214285714285714,6,10
"['11000', '11011', '100', '101110']",1,4,8,11,2,19,3.789393939393939,16,17
"['00011', '11000', '100010', '10100', '011111', '1100']",1,6,16,15,5,31,8.628282828282828,45,47
"['010101', '0110', '1110', '110']",1,4,7,10,2,17,4.108730158730158,11,20
"['11000', '00110', '101', '000']",1,4,10,6,4,16,3.433333333333333,16,17
"['1001110', '100', '111011']",1,3,6,10,0,16,1.6598290598290597,12,8
"['10111', '111010', '01110']",1,3,5,11,2,16,2.0727272727272728,7,7
"['0100111', '001101', '1100010', '100', '001110', '011000']",1,6,19,16,5,35,9.350793650793651,51,43
"['0011', '11110', '001', '101001']",1,4,8,10,0,18,3.1818903318903318,17,17
"['11001', '0110111', '111', '000101', '110011', '001100', '011010']",1,7,17,22,4,39,13.776184926184927,61,63
"['10100', '1101', '010', '010001']",1,4,10,8,0,18,3.982034632034632,15,13
"['1', '00001', '1011', '00010', '101001']",1,5,12,9,2,21,5.295815295815296,31,26
"['001100', '00110', '1111110']",1,3,8,10,0,18,1.8706293706293706,9,15
"['11010', '100100', '000']",1,3,9,5,0,14,1.893939393939394,8,8
"['00000', '10100', '1011', '001011', '111101']",1,5,13,13,4,26,5.007070707070707,31,30
"['0001', '1001', '1010101']",1,3,8,7,2,15,1.8409090909090908,7,13
"['0010', '11', '1001', '001110', '110']",1,5,9,10,2,19,6.2595238095238095,25,24
"['000', '01000', '1110']",1,3,8,4,0,12,1.4801587301587302,8,12
"['11010', '011', '110100', '00', '1110']",1,5,9,11,0,20,5.496392496392496,25,32
"['010', '0011101', '0101000', '11011', '101', '1010111', '011001', '110', '0100101']",1,9,22,26,7,48,22.466466866466867,114,96
"['0', '01111', '1010', '110', '001011']",1,5,8,11,0,19,4.624819624819625,30,24
"['10100', '10011', '110101']",1,3,7,9,2,16,2.0545454545454547,7,10
"['0111010', '01111', '1']",1,3,4,9,0,13,1.4166666666666667,12,7
"['101', '0110011', '011001']",1,3,7,9,0,16,2.18974358974359,8,12
"['11001', '0001', '10', '0100']",1,4,9,6,2,15,3.4047619047619047,14,13
"['101010', '01', '0101001', '0000']",1,4,12,7,0,19,3.0106449106449107,21,14
"['0', '0010', '0110110']",1,3,7,5,0,12,1.1954545454545453,12,13
"['0001101', '11101', '1000101', '010010']",1,4,13,12,2,25,4.274392274392274,17,17
"['010', '010110', '111']",1,3,5,7,2,12,1.4444444444444444,8,7
"['01', '110001', '001101']",1,3,7,7,2,14,1.6666666666666665,12,9
"['1010110', '0100110', '001111', '100', '111101', '01110', '0100']",1,7,17,21,4,38,12.986624486624487,63,62
"['01', '101011', '10100', '001110']",1,4,9,10,2,19,3.329004329004329,19,14
"['1011110', '11011', '00111']",1,3,5,12,2,17,1.9333333333333331,9,8
"['0010', '11011', '11']",1,3,4,7,0,11,1.349206349206349,9,8
"['0010110', '10111', '101', '100100', '1011000', '1100']",1,6,16,16,2,32,9.482955932955933,45,46
"['001', '00101', '11', '101', '1100000', '1000']",1,6,14,10,2,24,8.552669552669553,43,47
"['1011110', '0111101', '010101']",1,3,7,13,2,20,2.087912087912088,8,9
"['1011010', '01', '11', '011011', '10000', '0000101', '10100', '1100111']",1,8,20,21,7,41,14.77099567099567,101,77
"['0', '11101', '110']",1,3,3,6,0,9,1.5833333333333333,8,5
"['11010', '0101', '0010011']",1,3,8,8,0,16,1.893939393939394,9,7
"['01101', '1', '001000', '0011001', '0101']",1,5,13,10,0,23,5.6332278832278835,32,26
"['101', '01011', '01000']",1,3,7,6,2,13,1.85,7,6
"['0011', '1', '0100']",1,3,5,4,2,9,1.3,9,5
"['01', '110', '011', '000010']",1,4,8,6,2,14,3.2555555555555555,17,15
"['00', '011', '1100100', '0100']",1,4,10,6,0,16,3.2098124098124097,19,23
"['001', '01111', '001011', '000']",1,4,9,8,2,17,3.2954545454545454,16,19
"['001111', '00110', '10', '0101', '1110']",1,5,9,12,2,21,5.915367965367965,28,29
"['110011', '1111001', '001010', '011101']",1,4,10,15,3,25,4.0,20,13
"['1011110', '10101', '1']",1,3,4,9,0,13,1.25,13,10
"['11000', '0100100', '1001011']",1,3,11,8,2,19,2.0476190476190474,10,6
"['0101', '001010', '011']",1,3,7,6,0,13,2.3238095238095235,6,7
"['001', '0000100', '111', '100', '0110', '0001101', '010110', '00010', '110']",1,9,24,17,6,41,20.844067044067042,102,109
"['101', '01', '000101']",1,3,6,5,0,11,1.9666666666666668,8,10
"['011', '11111', '1000', '000001', '10', '0111', '11100']",1,7,13,16,4,29,9.712121212121211,66,63
"['1100111', '1110110', '010101']",1,3,7,13,2,20,1.9450549450549453,9,9
"['0001', '1001', '10101', '1010011', '00010']",1,5,14,11,4,25,7.026767676767677,21,32
"['01', '100000', '111', '10']",1,4,7,6,2,13,2.272222222222222,20,13
"['111111', '11101', '100', '0100011']",1,4,7,14,0,21,2.6905205905205904,22,21
"['001', '111010', '0011', '100101', '10']",1,5,10,11,2,21,5.568253968253968,30,26
"['0', '0100100', '11']",1,3,6,4,0,10,0.6944444444444444,13,4
"['1100011', '10100', '011']",1,3,7,8,0,15,1.7666666666666666,11,9
"['0010010', '0101', '10', '11']",1,4,8,7,2,15,3.4494949494949494,18,11
"['0100110', '00101', '01100', '1001100', '00010', '1110']",1,6,19,14,5,33,9.667243867243867,40,50
"['010000', '0001110', '011', '101', '1101', '111001']",1,6,14,15,4,29,8.57146187146187,52,36
"['11011', '0100010', '0010101', '10', '0101', '111001']",1,6,15,16,2,31,8.69048729048729,48,38
"['0010110', '10000', '01000', '00', '11101', '1011', '01100']",1,7,19,14,4,33,11.827272727272726,63,58
"['110000', '0010', '01']",1,3,8,4,0,12,1.3166666666666667,10,7
"['110011', '00', '001011', '01100']",1,4,10,9,2,19,3.5108225108225106,20,18
"['00', '0010', '010110']",1,3,8,4,0,12,1.7666666666666666,8,15
"['100', '1100', '111']",1,3,4,6,2,10,1.7619047619047619,5,10
"['111010', '111', '00', '0101', '001011', '01100', '011000']",1,7,16,16,3,32,11.88023088023088,59,64
"['0', '00101', '111']",1,3,4,5,0,9,0.8333333333333333,10,4
"['111100', '11', '10110', '000', '0001011']",1,5,11,12,0,23,4.761949161949162,37,30
"['01', '010', '0001']",1,3,6,3,0,9,2.038095238095238,5,8
"['1010', '10011', '1111110']",1,3,5,11,0,16,1.3636363636363635,10,9
"['1010', '010', '110010', '00000']",1,4,12,6,0,18,3.8137085137085136,15,20
"['110001', '1', '10', '0000']",1,4,8,5,0,13,2.3857142857142857,20,10
"['001101', '1101000', '0110', '001010', '01000', '0100']",1,6,20,12,4,32,10.548445998445999,36,62
"['1100000', '1', '100111']",1,3,7,7,0,14,0.9972527472527473,15,9
"['0010', '0011', '110001', '1000', '1101']",1,5,12,10,4,22,6.3,25,27
"['1000100', '10110', '00101']",1,3,10,7,2,17,1.9333333333333331,9,8
"['011010', '00', '10', '1101', '0101', '01100']",1,6,12,11,4,23,9.568614718614718,34,40
"['110011', '001011', '00101']",1,3,8,9,2,17,2.3030303030303028,7,13
"['001001', '11', '1110101', '0010010', '1011011']",1,5,13,16,3,29,5.987179487179487,35,31
"['1110101', '10000', '0111']",1,3,7,9,0,16,1.2676767676767677,12,8
"['1010111', '11110', '001', '1']",1,4,5,11,0,16,2.2333333333333334,23,16
"['01', '0010', '100011']",1,3,7,5,0,12,1.7666666666666666,9,4
"['010', '011', '11', '1000010', '000', '001011']",1,6,14,10,3,24,8.026495726495726,44,39
"['0011', '1', '000']",1,3,5,3,0,8,0.9714285714285714,8,6
"['0', '1110110', '11']",1,3,3,7,0,10,0.6944444444444444,13,6
"['1011010', '1001', '1011100', '0100001', '0101']",1,5,15,14,5,29,6.425324675324675,32,31
"['111100', '11', '1001', '0000', '1110110']",1,5,10,13,2,23,4.789432789432789,36,26
"['001', '0010101', '0101010', '111111', '011000']",1,5,14,15,4,29,5.010989010989011,36,24
"['101', '1011101', '1001', '0101', '110']",1,5,8,13,4,21,6.746536796536796,24,39
"['0', '0011', '1000111']",1,3,6,6,0,12,1.3772727272727274,12,5
"['0', '11101', '100111', '1001011']",1,4,7,12,0,19,3.0042457542457544,22,19
"['0001010', '010000', '110']",1,3,11,5,0,16,1.45982905982906,11,11
"['01011', '0110', '010010', '11']",1,4,8,9,0,17,3.932034632034632,15,17
"['1001110', '010', '1', '00001', '0111100']",1,5,12,11,2,23,4.380952380952381,41,21
"['0111', '110001', '01100']",1,3,7,8,0,15,1.793939393939394,9,7
"['011000', '010110', '000', '111']",1,4,10,8,4,18,2.888888888888889,19,17
"['0', '100', '0110', '1111000']",1,4,8,7,0,15,2.866883116883117,21,15
"['0', '110110', '111']",1,3,3,7,0,10,0.9523809523809523,11,6
"['101100', '0010000', '11', '1100100', '110011']",1,5,15,13,4,28,5.509157509157509,37,35
"['1', '001000', '101000', '0110', '0111', '000010', '111000']",1,7,20,13,6,33,10.692857142857143,68,66
"['0101', '100', '00101']",1,3,7,5,0,12,1.9603174603174602,6,10
"['0', '001', '000011', '101010', '111000']",1,5,13,9,3,22,4.579365079365079,37,25
"['101', '10100', '1', '1010000']",1,4,9,7,0,16,3.2666666666666666,20,23
"['01', '01111', '0110', '1000', '000100', '1100']",1,6,14,11,3,25,7.901731601731601,43,44
"['00010', '0001', '001011', '110101']",1,4,12,9,2,21,3.8282828282828283,14,17
"['0000101', '01001', '1101']",1,3,9,7,0,16,1.6565656565656566,9,10
"['11001', '01', '010000', '0011001', '110111', '10', '1011000', '111101']",1,8,19,22,7,41,15.66056166056166,95,78
"['0110101', '0', '1100100', '100111', '01010', '1100', '01110']",1,7,17,18,4,35,12.091375291375291,70,54
"['1000001', '101011', '11000', '0101010', '00', '10010', '1100']",1,7,21,15,4,36,12.973648573648573,62,54
"['0110111', '00111', '1000', '10', '011001', '0100']",1,6,14,14,2,28,8.65949050949051,47,42
"['0', '101010', '100', '011']",1,4,7,6,2,13,2.952380952380952,18,13
"['0111000', '110000', '001101', '11', '101011']",1,5,13,14,3,27,5.2905982905982905,38,27
"['0', '0001001', '0111']",1,3,7,5,0,12,1.1954545454545453,13,6
"['01', '010', '1010100', '111']",1,4,7,8,2,15,3.1777777777777776,18,11
"['0011', '10001', '1', '101111']",1,4,6,10,0,16,2.831168831168831,20,20
"['101', '00110', '10010']",1,3,7,6,2,13,2.05,7,6
"['1010', '11101', '110100']",1,3,6,9,0,15,2.193939393939394,6,7
"['0', '010', '1111110', '110111', '011001']",1,5,8,15,2,23,4.422283272283273,39,23
"['0001', '1100101', '111']",1,3,6,8,0,14,1.431168831168831,10,11
"['0111001', '111', '101', '00', '100011']",1,5,9,12,2,21,4.5837606837606835,33,24
"['00011', '0001', '00', '11111', '0111110', '01110']",1,6,12,16,3,28,7.939826839826839,47,45
"['0001', '011', '111']",1,3,4,6,2,10,1.5238095238095237,6,8
"['001100', '110010', '010', '0001110']",1,4,13,9,2,22,3.8307692307692305,20,24
"['1001010', '0110100', '01110', '0']",1,4,11,9,2,20,2.7142857142857144,24,21
"['0010', '00010', '1', '01010']",1,4,10,5,2,15,3.2222222222222223,14,20
"['0001', '00010', '1110']",1,3,8,5,2,13,1.5833333333333333,8,10
"['01', '0010', '000011', '00', '1010001', '101110', '01110']",1,7,18,14,4,32,11.94969474969475,68,57
"['1001000', '001', '1']",1,3,7,4,0,11,1.35,12,7
"['0010110', '110110', '1', '10111', '1011101']",1,5,9,17,2,26,5.445221445221446,36,29
"['101', '11011', '1100']",1,3,4,8,0,12,1.9880952380952381,6,11
"['1011101', '1100', '10110', '1']",1,4,6,11,0,17,3.028787878787879,21,17
"['110011', '101000', '11011', '1111110']",1,4,8,16,2,24,3.3904428904428903,17,24
"['00100', '11011', '0111', '111001']",1,4,8,12,2,20,3.3838383838383836,17,16
"['111011', '000111', '1', '00001']",1,4,8,10,2,18,2.4956709956709955,24,19
"['011', '10110', '1111', '1110100', '01001']",1,5,9,15,2,24,6.020923520923521,29,28
"['11001', '101', '0010101', '1000010']",1,4,12,10,2,22,3.688095238095238,19,19
"['01', '001', '101000', '0001', '1001111']",1,5,12,10,0,22,5.91969141969142,32,29
"['1', '0100010', '100011', '110', '1101010']",1,5,12,12,2,24,4.829059829059829,38,26
"['00', '001', '000101']",1,3,8,3,0,11,1.9666666666666668,8,12
"['01', '10110', '10000', '1100', '1110']",1,5,10,10,4,20,5.54047619047619,24,25
"['1001', '1000111', '100101', '01001', '110', '1110']",1,6,13,16,2,29,9.242246642246641,42,54
"['1011', '010', '11']",1,3,3,6,0,9,1.638095238095238,6,6
"['0001', '10', '011100']",1,3,7,5,0,12,1.2333333333333334,11,7
"['010011', '110', '01111']",1,3,5,9,0,14,1.4898989898989898,9,10
"['0', '11110', '0001101']",1,3,6,7,0,13,1.0833333333333333,14,6
"['101100', '11011', '101', '01111', '10000', '0111111', '000100']",1,7,16,21,5,37,10.487917637917638,70,62
"['100010', '1010011', '111011']",1,3,8,11,2,19,1.7307692307692308,7,12
"['111', '0011', '1001', '1010', '000']",1,5,9,9,5,18,5.428571428571429,21,23
"['1001', '1100101', '000', '1101010']",1,4,11,10,2,21,4.083116883116883,18,13
"['0001001', '1011', '111', '00001']",1,4,10,9,0,19,2.877994227994228,19,20
"['000', '0101', '011', '1110']",1,4,7,7,4,14,3.119047619047619,13,14
"['101', '1', '000']",1,3,4,3,2,7,0.8333333333333333,7,4
"['1000000', '1', '101001', '1101110']",1,4,11,10,2,21,2.291208791208791,28,15
"['11011', '0101011', '110011', '11101', '0000110']",1,5,12,18,4,30,6.868598068598069,27,38
"['000100', '010', '000111']",1,3,10,5,2,15,1.7777777777777777,9,12
"['0', '0111011', '110001', '1111', '1000', '1011']",1,6,10,16,3,26,6.819280719280719,49,42
"['00111', '1011', '111101', '1011111']",1,4,5,17,0,22,3.975291375291375,16,31
"['11', '00111', '100', '0110', '001010', '0101']",1,6,12,12,2,24,9.524891774891774,36,36
"['0111000', '01', '101101', '000', '1100011', '1100']",1,6,15,14,2,29,8.337695637695637,54,39
"['00100', '01', '111011']",1,3,6,7,0,13,1.435064935064935,11,4
"['000100', '110', '1']",1,3,6,4,0,10,1.2301587301587302,11,4
"['0', '00111', '0110', '100101', '0101']",1,5,10,10,2,20,5.629653679653679,28,22
"['01', '01101', '001000']",1,3,8,5,0,13,1.6168831168831168,10,8
"['010000', '00000', '0011', '1001', '111111', '0000010']",1,6,20,12,4,32,7.026301476301477,53,49
"['01101', '001001', '11000', '0001111', '0101']",1,5,14,13,2,27,6.333566433566434,30,30
"['1110101', '1010110', '10']",1,3,6,10,2,16,1.6031746031746033,13,8
"['101', '00', '100']",1,3,5,3,2,8,1.8666666666666667,4,7
"['0011', '0101100', '000']",1,3,9,5,0,14,1.6987012987012986,9,13
"['011', '0000101', '110011', '0000', '0100011']",1,5,16,11,2,27,6.0668664668664665,31,34
"['0100001', '1100', '1000010', '11']",1,4,12,8,2,20,3.5036075036075034,22,14
"['0010110', '0011', '0000110']",1,3,11,7,2,18,2.311688311688312,7,15
"['011011', '101', '00', '0111', '00010', '1010010']",1,6,14,13,0,27,8.371373071373071,46,38
"['1110111', '0111001', '0100110', '0010101', '000', '01001', '01100']",1,7,21,20,6,41,12.314285714285715,66,62
"['11110', '010', '011', '111', '1111000', '110']",1,6,8,16,4,24,9.0,38,54
"['0110101', '1011001', '1000', '00', '01010', '1011']",1,6,15,14,4,29,9.014430014430014,45,35
"['11110', '01101', '0110', '10000', '110111']",1,5,10,15,3,25,5.636363636363637,28,26
"['10101', '100', '1101011', '000']",1,4,9,9,2,18,3.75,17,13
"['0100001', '01111', '1', '0000']",1,4,10,7,0,17,2.032828282828283,25,11
"['10111', '0001010', '0101', '10000']",1,4,12,9,2,21,3.405050505050505,18,13
"['01', '100001', '1111', '1000010', '100110']",1,5,13,12,2,25,5.3003885003885,34,33
"['1110', '11011', '01110', '11111']",1,4,4,15,3,19,4.222222222222222,11,23
"['1000001', '1100', '0']",1,3,8,4,0,12,1.1954545454545453,13,4
"['0010', '01', '100', '0011010', '111111', '100000']",1,6,15,13,2,28,6.842291042291042,57,39
"['0101110', '0101', '1001000']",1,3,10,8,2,18,1.844155844155844,11,9
"['0010', '001', '001011']",1,3,8,5,0,13,2.3238095238095235,6,13
"['1000', '00', '111', '111101']",1,4,6,9,0,15,2.269047619047619,20,16
"['10001', '010101', '10110']",1,3,8,8,2,16,2.0545454545454547,8,8
"['1110111', '00110', '10000', '11111']",1,4,8,14,3,22,2.8666666666666667,21,19
"['00001', '00100', '10010', '100000', '1100', '1111111']",1,6,18,14,3,32,7.561926961926962,51,44
"['01', '1001', '10110', '110011', '01000']",1,5,11,11,2,22,6.315584415584415,27,21
"['1001001', '110010', '101101']",1,3,9,10,2,19,2.051282051282051,8,10
"['11010', '11000', '1110011', '00', '10']",1,5,10,11,4,21,5.807936507936508,30,27
"['0010', '001', '000011', '1010101', '1100']",1,5,14,10,2,24,5.547685647685648,30,27
"['001', '010001', '011', '000000', '11111', '0100']",1,6,16,11,4,27,6.845382395382395,48,42
"['110011', '1000', '10110', '111']",1,4,7,11,0,18,3.264502164502164,16,19
"['1011110', '1101000', '1100000']",1,3,11,10,3,21,1.7142857142857142,10,10
"['00110', '01001', '00101']",1,3,9,6,3,15,2.2,7,9
"['0', '1111101', '11', '1001', '1000010']",1,5,9,12,2,21,4.156854256854257,41,25
"['101', '10001', '110001', '000101', '10100']",1,5,14,11,4,25,7.009090909090909,24,41
"['0', '110', '001010', '1001010']",1,4,10,7,0,17,2.803235653235653,21,21
"['010100', '001001', '1', '100001']",1,4,12,7,3,19,2.6904761904761907,22,13
"['1011', '01001', '1001', '0110']",1,4,8,9,3,17,4.222222222222222,11,15
"['11', '0011', '0110', '0000101', '0100100']",1,5,14,10,4,24,6.231962481962482,32,24
"['0', '100101', '111100']",1,3,6,7,2,13,1.0714285714285714,13,4
"['1101001', '1', '0011110', '010101', '0110110']",1,5,12,16,3,28,5.18956043956044,42,20
"['1', '1110000', '0110011']",1,3,7,8,2,15,1.0714285714285714,15,7
"['0001', '10010', '01100', '101101']",1,4,11,9,2,20,3.5656565656565657,15,13
"['11001', '10111', '01110']",1,3,5,10,3,15,2.0,8,5
"['0010110', '00001', '1100001', '1001', '100000', '10']",1,6,20,11,2,31,8.754456654456654,50,46
"['10111', '0010011', '000010', '11111', '0101']",1,5,12,15,2,27,5.199222999222999,30,26
"['10001', '001111', '0111']",1,3,6,9,0,15,1.7898989898989899,9,8
"['010100', '1101001', '11001', '0110', '10', '01000', '1111011']",1,7,17,19,4,36,12.922255522255522,64,51
"['0', '01011', '0100']",1,3,6,4,0,10,1.4,9,10
"['0', '10', '1111']",1,3,2,5,0,7,1.0,8,4
"['0', '101000', '01101', '1111100']",1,4,9,10,0,19,2.52988677988678,25,13
"['0', '1000100', '0111010', '01010', '01001']",1,5,15,10,4,25,5.204761904761905,38,33
"['1001100', '00010', '010011', '01111']",1,4,12,11,2,23,3.6086247086247085,17,15
"['01', '011', '10100', '000000', '1001011']",1,5,14,9,0,23,4.7132700632700635,36,24
"['01', '11', '1000110', '10000', '10100', '000', '011010']",1,7,18,12,4,30,10.84128649128649,65,54
"['1', '011', '0100010', '100', '0100100', '011000']",1,6,17,10,4,27,8.247985347985347,52,43
"['0', '1101101', '110', '0010000']",1,4,10,8,2,18,2.4285714285714284,28,12
"['010', '1000101', '11', '10001', '011101', '1100', '01000']",1,7,17,15,2,32,12.441430791430792,62,53
"['01101', '1000101', '10111', '0001', '111011', '1111', '00', '00010']",1,8,17,21,5,38,15.079309579309578,82,79
"['000011', '0001', '100', '01111', '0010011', '00']",1,6,16,11,0,27,8.32112887112887,45,50
"['0010', '1010101', '001010', '011']",1,4,11,9,0,20,3.9527805527805526,16,15
"['0', '01', '0101011', '1111', '0111']",1,5,6,12,2,18,4.42020202020202,31,28
"['00011', '101000', '100', '1101011', '100111', '000']",1,6,16,14,4,30,9.185120435120435,46,52
"['00110', '001111', '111', '101111']",1,4,6,14,2,20,3.9393939393939394,15,25
"['11110', '110010', '000001']",1,3,9,8,2,17,1.2272727272727273,11,8
"['01', '00001', '00011', '110001', '110']",1,5,12,9,2,21,5.7140692640692645,29,31
"['001', '10', '0000010']",1,3,9,3,0,12,1.4444444444444444,11,8
"['1111', '1110110', '001011', '01110', '0100']",1,5,10,16,2,26,5.683566433566433,29,29
"['1110011', '100011', '10', '1']",1,4,6,10,0,16,2.916056166056166,23,23
"['1101001', '010101', '1101100', '0001111']",1,4,12,15,3,27,3.857142857142857,18,19
"['10010', '10', '11']",1,3,4,5,2,9,1.6428571428571428,7,8
"['0100011', '110', '0110100']",1,3,9,8,2,17,1.5714285714285714,13,8
"['001', '1011001', '0011', '0011010', '10010', '000001', '0111', '1101']",1,8,21,19,5,40,17.214441114441115,79,79
"['0', '01100', '1111']",1,3,4,6,0,10,0.7777777777777777,11,4
"['101100', '01', '101011', '0011011', '110', '001011', '01100']",1,7,16,19,3,35,12.962454212454212,63,66
"['0010', '110', '0111']",1,3,5,6,2,11,1.6428571428571428,6,8
"['1000001', '11110', '01111', '1100', '01110']",1,5,11,15,3,26,5.723232323232323,30,29
"['1011', '0110', '111001']",1,3,5,9,2,14,1.95,8,5
"['11001', '000101', '10010', '000010', '001100']",1,5,18,10,5,28,6.784848484848485,25,28
"['1010000', '0100111', '0010100', '10']",1,4,14,9,3,23,3.1904761904761902,25,15
"['00', '1101011', '11']",1,3,4,7,2,11,0.8888888888888888,12,8
"['00110', '00', '0011111']",1,3,7,7,0,14,1.6825396825396823,11,15
"['010001', '01101', '010', '11', '10', '1100110', '000010']",1,7,17,14,4,31,12.168575868575868,66,54
"['0011101', '0011', '1111', '110111', '011111']",1,5,7,20,4,27,6.605827505827506,26,45
"['010100', '1', '101101', '10000', '1101']",1,5,11,11,2,22,4.9067821067821065,33,25
"['010000', '00011', '011110', '1010011', '101111', '01000']",1,6,18,17,5,35,9.067365967365967,44,45
"['110', '1', '1100101']",1,3,4,7,0,11,1.35,12,10
"['010001', '01101', '001111']",1,3,8,9,2,17,1.9545454545454546,8,8
"['1011010', '010', '0100110', '11', '00']",1,5,11,10,4,21,4.8920634920634924,36,26
"['0011001', '00', '010101', '10010', '1111111']",1,5,12,15,2,27,4.7206682206682204,42,21
"['11011', '110', '1111000', '000']",1,4,8,10,2,18,3.033333333333333,20,20
"['11110', '000', '000010', '110', '0100']",1,5,13,8,2,21,4.9953823953823955,28,38
"['010', '011', '100', '111111', '0000010', '01110']",1,6,13,14,3,27,7.154856254856255,54,41
"['0111', '01010', '0110', '0011100']",1,4,10,10,2,20,4.4267676767676765,13,23
"['1011', '0001001', '0011100']",1,3,10,8,2,18,1.8051948051948052,11,6
"['11011', '1', '10000', '010010', '0101']",1,5,11,10,2,21,4.936219336219336,31,20
"['011', '1101', '000100', '110', '01100']",1,5,11,10,2,21,6.278066378066378,25,27
"['11010', '11', '100111', '110111', '1001100', '001100']",1,6,13,19,3,32,9.336385836385837,45,57
"['100000', '0101', '1000101']",1,3,11,6,0,17,1.8965034965034966,9,12
"['00', '011010', '001', '10011']",1,4,9,7,0,16,3.6113275613275615,16,12
"['011', '11', '1001', '100', '0100']",1,5,8,8,4,16,6.14047619047619,19,25
"['11011', '00', '111101', '01000']",1,4,8,10,2,18,2.598051948051948,21,12
"['10111', '11010', '001101', '1111']",1,4,6,14,2,20,3.8060606060606057,14,21
"['00010', '010', '1101110']",1,3,8,7,0,15,1.85,10,12
"['010', '0001', '000101', '000', '1110110', '0100011', '0100']",1,7,21,13,6,34,13.122977022977024,63,73
"['11010', '1', '10110', '01010', '000']",1,5,10,9,3,19,4.95,28,23
"['0111000', '11', '101010', '101', '1110']",1,5,9,13,0,22,5.791863691863692,30,23
"['10100', '1100001', '010001', '0111']",1,4,12,10,0,22,3.753069153069153,19,17
"['10110', '000', '101001']",1,3,8,6,0,14,1.6717171717171717,8,6
"['0011', '0110010', '1', '010110']",1,4,9,9,0,18,2.8965534465534466,22,12
"['11001', '0001001', '0101000', '0110111', '001101', '100', '00', '10100', '011001', '1011']",1,10,28,24,7,52,28.382461982461983,136,133
"['11001', '110010', '1000', '11101', '001110', '0011111', '0101']",1,7,16,21,6,37,12.86006216006216,63,61
"['011', '1000111', '0111', '1010001', '110']",1,5,10,14,4,24,6.082251082251082,32,33
"['11010', '10010', '1']",1,3,5,6,2,11,1.4666666666666668,9,8
"['0', '010001', '11', '10011', '01010', '101111']",1,6,11,14,4,25,7.208225108225108,50,34
"['00101', '011', '0011100', '0000']",1,4,12,7,0,19,3.6963203463203462,17,23
"['1', '011110', '001000']",1,3,7,6,2,13,1.0714285714285714,13,4
"['11110', '111', '000']",1,3,4,7,2,11,1.0,9,8
"['1010', '1011100', '0000000']",1,3,12,6,2,18,1.3766233766233766,12,10
"['01', '011100', '0010000', '0011', '10', '1101']",1,6,14,11,4,25,7.946697746697747,50,37
"['00100', '1001', '111011', '1001111', '101001']",1,5,12,16,2,28,6.282284382284383,29,35
"['0', '0100', '11']",1,3,4,3,0,7,0.7333333333333334,8,4
"['0010110', '0001101', '11101', '0111', '110', '0110001']",1,6,15,18,3,33,9.621428571428572,47,42
"['0', '010101', '0011101']",1,3,7,7,0,14,1.151098901098901,13,8
"['011', '110100', '0000011', '11100', '101001']",1,5,14,13,2,27,5.755400155400156,32,31
"['00010', '0100111', '11100', '100011']",1,4,12,11,2,23,3.6086247086247085,20,15
"['1011', '100', '000000']",1,3,9,4,0,13,1.2158730158730158,11,7
"['1011', '1010', '0000100']",1,3,9,6,2,15,1.6590909090909092,10,6
"['11010', '001', '010010', '011110', '0000']",1,5,14,10,2,24,5.384559884559884,27,33
"['101001', '101', '00', '1110']",1,4,7,8,0,15,2.8714285714285714,17,13
"['1001001', '110010', '001', '10']",1,4,10,8,0,18,3.3803418803418803,21,16
"['0011001', '0010', '100101', '11']",1,4,10,9,0,19,3.4204351204351204,20,13
"['0100110', '011', '11', '000010', '1100']",1,5,12,10,0,22,5.183977133977134,34,26
"['010', '111', '1011101', '100', '111000', '110', '01000']",1,7,14,16,4,30,12.27043512043512,58,54
"['01', '1000101', '0011', '000001', '01001', '110']",1,6,16,11,0,27,8.279453879453879,46,40
"['1010', '0010', '11']",1,3,5,5,2,10,1.75,6,6
"['0000111', '010', '000000', '11']",1,4,12,6,0,18,2.304273504273504,25,18
"['101100', '11010', '11', '101000', '010111', '1110']",1,6,12,17,3,29,9.204761904761904,42,44
"['011', '111', '0001', '10000', '0011010', '1101100', '1010', '100011', '000000']",1,9,26,19,8,45,19.319647019647018,116,107
"['111000', '0110100', '0000100', '101101', '100110', '0001100', '10', '0111101', '01100']",1,9,29,24,7,53,22.88999888999889,113,121
"['0001', '001010', '10011', '11']",1,4,9,8,0,17,3.398701298701299,17,13
"['1101', '0101011', '11']",1,3,4,9,0,13,1.6565656565656566,10,13
"['010100', '11001', '1010110', '111', '00001', '00111', '101', '110']",1,8,17,20,6,37,15.86114996114996,80,79
"['0', '0011101', '0011110', '1001', '111110', '010110', '01010']",1,7,16,20,4,36,11.615284715284716,72,65
"['1111010', '100', '1']",1,3,4,7,0,11,1.35,12,6
"['01', '001', '1000101', '0001011', '1110']",1,5,12,11,2,23,5.092352092352092,36,25
"['0110101', '0011', '1']",1,3,5,7,0,12,1.1954545454545453,12,6
"['0', '0101110', '11', '100', '010101']",1,5,9,10,0,19,4.416056166056166,35,21
"['1000', '001', '101101']",1,3,7,6,0,13,1.615873015873016,8,9
"['0011', '01001', '001000', '11']",1,4,10,7,0,17,3.482034632034632,17,15
"['0001100', '001001', '1110', '1001101']",1,4,13,11,2,24,3.771628371628372,18,13
"['0010110', '000110', '001', '11']",1,4,10,8,0,18,3.534188034188034,19,17
"['0', '0010110', '01101', '001']",1,4,9,7,0,16,2.85,21,17
"['010', '000011', '1010', '000010', '1000011', '01100']",1,6,20,11,2,31,9.265107115107115,45,49
"['11010', '1100', '1']",1,3,4,6,0,10,1.6222222222222222,8,8
"['00', '100', '11']",1,3,4,3,2,7,1.2000000000000002,5,6
"['0', '01101', '100', '1001111', '1110']",1,5,8,12,0,20,5.033549783549783,33,22
"['0111001', '0011', '00', '11101', '111101']",1,5,9,15,0,24,5.5483793983793985,32,30
"['11', '01', '000', '0100']",1,4,7,4,2,11,2.4714285714285715,12,13
"['101', '0101000', '1100']",1,3,8,6,0,14,1.8987012987012988,9,5
"['1', '101', '010010', '01000', '01100']",1,5,12,8,2,20,5.555411255411255,28,22
"['0010', '1100010', '101011', '010010', '10', '1010010', '01110']",1,7,20,17,4,37,13.354989454989456,61,78
"['00111', '11000', '011101', '000', '1101', '111000']",1,6,14,15,4,29,8.951875901875901,44,55
"['1000001', '0001', '10', '000', '1011']",1,5,13,7,2,20,5.3600288600288595,29,28
"['101100', '0100110', '011', '1', '110001']",1,5,11,12,2,23,5.0838217338217335,38,20
"['011', '100000', '10', '000', '1101', '0101']",1,6,13,9,4,22,7.6912698412698415,39,37
"['0000', '01', '11011', '11']",1,4,6,7,2,13,2.198412698412698,18,14
"['10011', '01010', '1010011', '1011', '111000']",1,5,12,15,2,27,6.489121989121989,28,35
"['010', '00111', '101', '011011', '1100000', '00', '10011']",1,7,16,15,4,31,11.704900654900655,67,52
"['0', '0010110', '110010', '0001100', '001001']",1,5,17,10,4,27,5.364468864468865,39,34
"['1110010', '011', '100', '1010', '01110', '01100']",1,6,13,14,4,27,9.483621933621933,39,46
"['1001', '11101', '0100011', '001000']",1,4,12,10,0,22,3.46013986013986,19,12
"['00010', '1100', '1', '00001']",1,4,10,5,2,15,2.7555555555555555,19,14
"['11110', '110', '0010000', '1011111']",1,4,9,13,2,22,2.835714285714286,25,17
"['01', '1', '000011']",1,3,5,4,0,9,1.4523809523809523,10,6
"['0110000', '00', '110']",1,3,8,4,0,12,1.4444444444444444,11,10
"['10111', '0000011', '10', '11111', '110']",1,5,8,14,2,22,4.712698412698413,36,35
"['1', '001101', '1010101', '10000', '011001', '110']",1,6,14,14,2,28,7.555927405927406,52,38
"['1100011', '100', '101001', '0100']",1,4,11,9,0,20,4.238494838494838,17,13
"['001111', '111', '0111110']",1,3,4,12,0,16,2.0358974358974358,9,8
"['0001101', '00100', '00', '000111']",1,4,13,7,0,20,3.651071151071151,19,30
"['011', '001000', '00000', '110111', '11111']",1,5,12,13,4,25,3.648989898989899,36,32
"['1111100', '00', '10001']",1,3,7,7,0,14,1.5158730158730158,13,6
"['010', '10101', '100', '11101', '0001011']",1,5,11,12,4,23,5.933333333333334,29,23
"['0011', '10100', '111110', '00', '00010']",1,5,12,10,2,22,4.8979076479076475,32,33
"['101', '11000', '000110', '111011']",1,4,9,11,2,20,3.202020202020202,21,14
"['11011', '0011000', '1001', '1111', '10']",1,5,9,13,2,22,5.48051948051948,31,25
"['1101', '01000', '0111100']",1,3,8,8,0,16,1.6565656565656566,10,6
"['1000001', '1', '001101']",1,3,8,6,0,14,0.9972527472527473,14,9
"['101', '0001', '0011', '1100001', '1011']",1,5,11,11,3,22,6.236363636363636,24,38
"['00', '010', '1', '101101']",1,4,6,6,0,12,2.7523809523809524,17,8
"['1011', '100101', '111', '10011']",1,4,6,12,0,18,4.136075036075036,10,35
"['001', '1', '01100']",1,3,5,4,0,9,1.3333333333333333,9,5
"['1000100', '00', '1010']",1,3,9,4,0,13,1.8383838383838382,10,9
"['1101', '1011000', '11']",1,3,5,8,0,13,1.6565656565656566,11,10
"['1011010', '1111110', '0011000']",1,3,9,12,3,21,1.7142857142857142,8,7
"['001000', '00100', '101', '001110', '001010', '11111', '0110010']",1,7,21,17,5,38,12.338073038073038,59,71
"['00', '101101', '10', '1011111']",1,4,6,11,2,17,2.935897435897436,22,15
"['110000', '001', '00100', '000', '011111']",1,5,14,9,4,23,5.186868686868687,33,39
"['1', '0110100', '00011', '011101', '0010010']",1,5,14,12,2,26,4.93006993006993,39,23
"['101000', '00', '11101', '001']",1,4,9,7,0,16,3.0756132756132755,19,16
"['11011', '011', '100', '111110', '1101', '0101', '001011', '0100']",1,8,14,21,7,35,16.58939393939394,70,84
"['11', '000', '011001']",1,3,6,5,0,11,0.9444444444444444,10,4
"['0001101', '10101', '001']",1,3,8,7,0,15,1.6,9,11
"['10100', '0101100', '11']",1,3,7,7,0,14,1.8492063492063493,10,6
"['0', '01', '110101']",1,3,4,5,0,9,1.4523809523809523,10,5
"['110000', '101000', '100100', '110', '1001111']",1,5,15,13,3,28,5.994017094017094,32,33
"['01', '00', '110111']",1,3,4,6,2,10,1.25,10,4
"['1110101', '01000', '0111']",1,3,7,9,0,16,1.4898989898989898,11,7
"['1', '001101', '1100001', '01001', '1011111']",1,5,11,15,2,26,4.336663336663337,42,31
"['101100', '11010', '111010', '0000100', '11']",1,5,13,13,2,26,5.673604173604174,34,30
"['110010', '00100', '0001', '101', '10']",1,5,12,8,0,20,5.936796536796536,27,23
"['0011001', '10', '011', '1100110']",1,4,9,10,2,19,3.2031746031746033,24,14
"['001', '100011', '1111000', '01010']",1,4,11,10,0,21,3.2275058275058273,22,12
"['0011010', '0010011', '1110101', '1010', '00', '1110']",1,6,15,16,5,31,8.326839826839826,51,44
"['00100', '01', '100']",1,3,7,3,0,10,1.7214285714285715,7,9
"['110010', '111', '000']",1,3,6,6,2,12,1.3333333333333333,9,6
"['0', '110110', '1101011']",1,3,5,9,0,14,1.304945054945055,13,8
"['0', '0101110', '111100', '10110', '01000']",1,5,12,12,2,24,5.344338994338994,35,31
"['0010110', '101000', '0101011', '00', '1010000']",1,5,18,11,3,29,5.987179487179487,35,37
"['101100', '1101111', '10101', '100', '10110']",1,5,10,16,2,26,6.951748251748252,26,35
"['1000100', '011100', '0001111', '1001101', '1111', '010111', '10', '000010']",1,8,22,23,6,45,15.33978243978244,97,78
"['010', '110', '10', '01110']",1,4,6,7,2,13,4.338095238095238,10,22
"['0101', '111100', '000101', '011100']",1,4,11,11,3,22,3.3,17,22
"['0', '000010', '111', '01010']",1,4,9,6,0,15,1.8867243867243866,22,14
"['0110100', '0000001', '0111']",1,3,11,7,2,18,1.3766233766233766,12,9
"['000111', '0011010', '1100110']",1,3,10,10,2,20,2.098901098901099,10,9
"['0011', '00', '111000', '010010']",1,4,11,7,2,18,3.333333333333333,21,20
"['11110', '100', '0001']",1,3,6,6,0,12,1.2936507936507935,9,7
"['1010001', '00110', '011010', '01000']",1,4,14,9,2,23,3.8214452214452215,17,15
"['10101', '010', '011', '11']",1,4,5,8,2,13,3.9380952380952383,11,13
"['0', '1110101', '010000']",1,3,8,6,0,14,0.9972527472527473,15,4
"['0010', '010001', '001101', '01111', '010010', '1111', '1010', '010110', '000']",1,9,23,21,7,44,21.519985569985568,93,109
"['1000111', '1100001', '0100110', '000']",1,4,14,10,3,24,3.657142857142857,22,9
"['01', '0100000', '011', '01111', '0100']",1,5,12,9,0,21,5.709018759018759,31,37
"['011011', '011100', '0111']",1,3,6,10,2,16,2.2666666666666666,7,14
"['010', '1', '011000']",1,3,6,4,0,10,1.4523809523809523,10,5
"['0', '0110100', '0011', '011111', '110101']",1,5,10,14,2,24,4.851498501498502,37,24
"['1010000', '010', '1011011', '0001000']",1,4,15,9,3,24,3.5142857142857142,22,16
"['0011', '10001', '01011']",1,3,7,7,2,14,2.1555555555555554,6,8
"['110110', '001', '100', '01111', '110011', '10100', '1110']",1,7,13,19,6,32,12.058152958152958,58,60
"['11001', '1', '1101101', '110111', '000000', '000010', '0000011']",1,7,21,17,5,38,9.674825174825175,80,72
"['1', '000', '0111011']",1,3,5,6,0,11,0.65,14,4
"['001', '110111', '000', '11']",1,4,6,8,2,14,2.2333333333333334,19,16
"['11', '100010', '0110011']",1,3,7,8,0,15,1.5598290598290598,12,8
"['011', '00000', '101000', '1001', '1010']",1,5,14,8,2,22,5.421645021645022,27,27
"['01001', '1001', '1', '0110']",1,4,7,7,2,14,3.1888888888888887,16,14
"['10110', '10010', '00101', '000']",1,4,11,7,3,18,4.2,13,16
"['1', '0011000', '10101', '0011110', '000000', '111000', '01100', '0100']",1,8,25,16,6,41,13.954156954156954,95,95
"['11001', '110001', '1000000', '1010', '001011']",1,5,16,12,2,28,5.78974358974359,32,31
"['01', '00001', '1000000', '0111101', '110101']",1,5,15,12,2,27,4.464368964368965,40,31
"['011', '100', '0110', '11101', '000']",1,5,9,9,3,18,5.25,23,23
"['11010', '1', '1110000']",1,3,6,7,0,13,1.25,13,7
"['11001', '0110101', '0', '010', '01010']",1,5,11,10,2,21,5.533333333333333,32,27
"['011011', '1010', '1000101']",1,3,8,9,0,17,1.760839160839161,10,7
"['100', '01110', '11']",1,3,4,6,0,10,1.4714285714285715,8,4
"['11001', '001101', '001000', '1101000', '1010011']",1,5,17,14,4,31,6.769064269064269,28,32
"['11000', '01', '1000']",1,3,7,4,0,11,1.507936507936508,8,9
"['100110', '1010', '0101', '011']",1,4,8,9,2,17,4.245238095238095,14,15
"['101011', '00', '1110']",1,3,5,7,0,12,1.2333333333333334,10,5
"['00111', '1100000', '1001', '1000000', '10']",1,5,16,9,2,25,5.1226551226551225,38,31
"['10101', '011', '110100']",1,3,6,8,0,14,1.9217171717171717,8,7
"['10', '01000', '11']",1,3,5,4,2,9,1.3571428571428572,8,4
"['0101', '100111', '0100']",1,3,7,7,2,14,1.95,8,6
"['10111', '0001', '0001110']",1,3,8,8,0,16,1.8383838383838382,9,7
"['11110', '0011', '010110', '1100', '0110011']",1,5,11,15,2,26,6.308313908313909,29,32
"['100001', '111100', '10000', '1111']",1,4,10,11,2,21,3.3767676767676766,18,25
"['1', '0011', '10010', '000', '01010']",1,5,11,7,2,18,5.071428571428571,26,22
"['11110', '01001', '010010', '0100']",1,4,11,9,2,20,3.806060606060606,14,25
"['011111', '0011011', '11010']",1,3,6,12,0,18,1.7995337995337994,8,9
"['1011001', '10101', '100', '100110', '01011']",1,5,12,14,2,26,7.040442890442891,28,31
"['1001110', '111', '110100', '10', '1000011', '01000', '0110011']",1,7,18,19,3,37,11.73001998001998,77,58
"['01', '10000', '1101']",1,3,6,5,0,11,1.3968253968253967,9,7
"['01', '00110', '1111111']",1,3,4,10,0,14,1.126984126984127,14,4
"['100', '001', '000']",1,3,7,2,3,9,2.0,4,11
"['010', '001', '101', '111111', '011110', '01000']",1,6,11,15,5,26,7.588383838383838,48,33
"['111010', '00011', '100', '010110', '000', '00010']",1,6,17,11,6,28,9.25959595959596,39,56
"['001', '1101011', '0110', '0000101', '10100', '1000', '1110100', '1100', '1001011', '1110']",1,10,26,26,8,52,26.432900432900432,137,136
"['0001', '11100', '000']",1,3,8,4,0,12,1.8015873015873014,8,13
"['101', '110', '111', '00001']",1,4,6,8,3,14,3.0,15,17
"['00100', '1001101', '11']",1,3,7,7,0,14,1.3968253968253967,12,4
"['000110', '111', '10111', '100', '1100111', '110', '01011', '0110001']",1,8,16,23,7,39,16.756671106671106,84,87
"['000011', '001000', '111111', '10', '01100']",1,5,13,12,3,25,4.207792207792208,39,26
"['1110011', '01111', '011', '0110']",1,4,6,13,0,19,4.085930735930736,16,23
"['10001', '001', '1']",1,3,5,4,0,9,1.5833333333333333,8,10
"['0011', '00101', '10000', '11']",1,4,9,7,2,16,3.457142857142857,16,18
"['101', '01', '01111']",1,3,3,7,0,10,1.8714285714285714,7,8
"['1011', '001', '000011', '11']",1,4,7,8,0,15,3.4047619047619047,16,21
"['0', '00011', '01010', '0010011']",1,4,11,7,2,18,3.0166666666666666,21,18
"['001', '10111', '100100', '1000', '0101100', '0001011', '0000111', '1110110', '110']",1,9,25,24,6,49,20.236674436674438,122,109
"['11001', '001', '011', '001101', '10100', '111101']",1,6,12,16,6,28,9.151010101010101,41,48
"['100', '1', '0110', '0111']",1,4,5,7,2,12,2.907142857142857,14,12
"['01', '010', '0110111', '100011', '0100100']",1,5,13,12,2,25,5.481684981684982,37,26
"['101', '101100', '011', '01000']",1,4,9,8,2,17,3.727272727272727,16,14
"['101', '0100110', '011']",1,3,6,7,2,13,1.8666666666666667,10,5
"['110001', '001', '011']",1,3,6,6,2,12,1.7777777777777777,8,9
"['1100011', '1101', '1']",1,3,4,8,0,12,1.3772727272727274,12,15
"['0', '101100', '010001']",1,3,8,5,2,13,1.2380952380952381,13,6
"['011011', '110100', '10', '000', '110101']",1,5,11,12,3,23,5.566666666666666,31,26
"['1001', '010101', '1111']",1,3,5,9,2,14,1.9,7,9
"['001100', '1110', '0101001']",1,3,9,8,0,17,1.425174825174825,10,6
"['0010', '11100', '011', '1111111']",1,4,6,13,0,19,2.597691197691198,23,18
"['1010', '00011', '1110', '1001101']",1,4,9,11,2,20,3.3282828282828283,17,15
"['100000', '1', '100110', '000011']",1,4,12,7,3,19,2.8571428571428568,23,17
"['0011', '011', '111']",1,3,3,7,2,10,2.095238095238095,4,12
"['100011', '000010', '1110']",1,3,9,7,2,16,1.4666666666666668,10,6
"['1101', '1101101', '01100', '0100']",1,4,9,11,2,20,3.994949494949495,15,17
"['1101', '0111001', '111010', '11']",1,4,6,13,0,19,3.9076146076146077,19,20
"['11000', '001', '10', '0110011']",1,4,9,8,0,17,3.1825396825396823,20,14
"['0000101', '1010', '010', '0111']",1,4,10,8,2,18,3.6194805194805193,18,15
"['11001', '01110', '111001']",1,3,6,10,2,16,2.2363636363636363,7,9
"['0', '1101', '01000']",1,3,6,4,0,10,1.1777777777777778,10,4
"['001011', '1', '10']",1,3,4,5,0,9,1.4523809523809523,10,6
"['1', '1011001', '0101011', '0100011', '0000', '001001', '11100', '111101']",1,8,21,22,5,43,13.53160728160728,98,76
"['0010', '0111010', '000011', '00011', '1010101', '111110', '0011011', '010011', '001011', '1001011']",1,10,29,32,8,61,27.908158508158508,119,152
"['0101000', '1111', '001110', '0000', '111000', '110', '001011']",1,7,19,17,5,36,11.177344877344877,67,76
"['101', '1100110', '11']",1,3,4,8,0,12,1.8444444444444446,10,10
"['0', '00100', '10110', '111']",1,4,7,7,2,14,2.0166666666666666,19,10
"['0011', '100', '10', '00001']",1,4,9,5,0,14,3.157142857142857,16,16
"['10100', '010011', '110111']",1,3,7,10,2,17,1.9393939393939394,8,8
"['0', '1000', '000011']",1,3,8,3,0,11,1.2857142857142856,11,8
"['1100011', '1010', '1000101']",1,3,9,9,2,18,1.948051948051948,9,9
"['1', '001111', '000000', '1101', '110101']",1,5,11,12,3,23,3.538095238095238,41,29
"['1000', '1001', '001111', '01100']",1,4,10,9,2,19,3.628787878787879,18,15
"['1100111', '101', '0101', '0000011']",1,4,10,11,2,21,3.519480519480519,21,18
"['10001', '011', '111']",1,3,4,7,2,11,1.6666666666666665,7,10
"['001100', '1011001', '1011', '1']",1,4,8,10,0,18,3.0322177822177823,22,15
"['11', '10001', '010111', '1110110', '01011']",1,5,9,16,2,25,5.923898323898324,32,36
"['11', '0110', '10100', '1010', '000100']",1,5,12,9,2,21,6.387590187590187,25,26
"['011', '10', '000000', '0101100']",1,4,12,6,0,18,2.2243589743589745,24,17
"['11001', '10001', '110']",1,3,6,7,2,13,2.05,6,12
"['0111000', '010', '110', '00111', '11100']",1,5,11,12,4,23,6.216666666666667,30,31
"['111', '101', '0110', '00010', '1110']",1,5,8,11,4,19,5.849206349206349,22,24
"['0110', '001101', '110100']",1,3,8,8,2,16,2.0666666666666664,9,7
"['100', '10', '1101110']",1,3,5,7,0,12,1.8444444444444446,10,8
"['001', '111111', '0100011', '000111', '0001000']",1,5,15,14,4,29,5.14932844932845,38,33
"['010100', '10', '101101']",1,3,7,7,2,14,1.6666666666666665,11,5
"['1000000', '00100', '10100', '000']",1,4,16,4,2,20,3.65,15,32
"['1011101', '110', '0111100']",1,3,6,11,2,17,1.9142857142857141,11,4
"['010', '110001', '10110', '0110', '1101', '0100011', '11100']",1,7,16,18,4,34,13.67962037962038,58,55
"['0001001', '00000', '101010', '010111', '10011', '1100']",1,6,19,14,4,33,8.817637917637917,45,39
"['00110', '11010', '1011001']",1,3,8,9,2,17,1.9333333333333331,10,5
"['1010', '011010', '0110']",1,3,7,7,2,14,2.1,6,16
"['110111', '00', '101', '0011010']",1,4,8,10,0,18,2.9764957264957266,23,10
"['0101', '01010', '000']",1,3,8,4,0,12,2.2103174603174605,5,11
"['01', '00111', '101', '1000', '0000010']",1,5,13,8,0,21,5.110533910533911,34,24
"['01101', '01', '00', '10']",1,4,6,5,3,11,3.2142857142857144,13,14
"['011011', '101', '010000', '0110']",1,4,10,9,2,19,3.5825396825396822,18,15
"['0100010', '100', '001', '11']",1,4,9,6,2,15,3.111111111111111,19,11
"['1010101', '10', '1100110', '1011', '11100']",1,5,10,15,2,25,5.7640692640692635,34,30
"['0010', '11000', '0011010', '1000', '110']",1,5,14,9,2,23,6.737806637806638,26,37
"['011', '10111', '1010', '11111', '1010001']",1,5,8,16,2,24,6.0264790764790765,27,40
"['00', '0010011', '011', '11']",1,4,7,7,2,14,2.688888888888889,19,18
"['1100011', '101', '10110', '100010']",1,4,10,11,0,21,4.013170163170163,17,19
"['101', '1010001', '0110']",1,3,7,7,0,14,1.535064935064935,11,7
"['0111010', '1000101', '1101000', '110001', '0010101', '10010', '100000', '1011', '0101', '1100']",1,10,31,26,9,57,28.293156843156844,135,132
"['0', '0101101', '0011100']",1,3,8,7,2,15,1.2142857142857144,15,8
"['010001', '001101', '111010', '110001', '0000001', '110111']",1,6,19,18,5,37,8.628205128205128,47,53
"['010', '1', '1000111']",1,3,5,6,0,11,1.15,13,4
"['010', '1001000', '1110', '1001']",1,4,10,8,2,18,3.3337662337662337,19,14
"['111', '100', '1010', '011111', '110', '101001']",1,6,9,16,5,25,8.477777777777778,39,45
"['000011', '101110', '000', '11']",1,4,9,8,2,17,2.611111111111111,22,16
"['0001100', '00', '01101', '110111']",1,4,10,10,0,20,3.121350871350871,23,14
"['1101', '00', '0011010', '0111']",1,4,8,9,2,17,3.3156565656565657,19,13
"['0', '1110000', '111010']",1,3,7,7,0,14,1.304945054945055,13,9
"['00111', '01', '111111']",1,3,3,10,0,13,1.3668831168831168,11,10
"['00010', '0100011', '001', '0111']",1,4,11,8,0,19,3.577994227994228,17,15
"['0011011', '111111', '001', '10']",1,4,6,12,0,18,2.532051282051282,24,16
"['1', '0100101', '0000']",1,3,8,4,0,12,0.7954545454545454,13,4
"['11001', '1011110', '0011', '101011', '1000010', '1101', '000100']",1,7,19,20,6,39,12.246098346098346,66,58
"['1011', '01010', '001111', '101001']",1,4,9,12,2,21,3.8393939393939394,16,13
"['000101', '1110', '11']",1,3,5,7,0,12,1.5666666666666667,10,8
"['0001', '010010', '1001010']",1,3,11,6,0,17,2.114685314685315,8,8
"['1001', '0111010', '1101011', '11']",1,4,7,13,2,20,3.5425685425685423,22,16
"['0110', '001101', '10011']",1,3,7,8,0,15,2.193939393939394,8,4
"['010100', '01101', '11', '1001', '10100', '00010']",1,6,15,12,3,27,8.954834054834054,39,35
"['0110', '10011', '000010', '0000']",1,4,13,6,2,19,3.5565656565656565,16,19
"['000000', '0101', '1100', '1']",1,4,10,5,2,15,2.1,22,12
"['01', '11010', '01010']",1,3,6,6,2,12,1.9428571428571428,7,10
"['00111', '1010100', '0101011', '11101', '100011', '10', '000100']",1,7,19,19,6,38,11.342368742368743,68,58
"['001', '111', '00011', '101', '011001']",1,5,9,11,3,20,6.143939393939394,24,29
"['1000', '01101', '10000', '11']",1,4,9,7,2,16,2.9238095238095236,18,17
"['1000', '100', '1110', '00001']",1,4,10,6,2,16,3.317460317460317,14,18
"['11010', '001', '011', '01111', '111011', '0100011', '011010']",1,7,14,21,6,35,12.591569541569541,58,71
"['011', '1010011', '000100', '110', '01100']",1,5,13,11,2,24,6.064879564879565,32,27
"['11', '101', '100', '00', '0100']",1,5,8,6,4,14,5.495238095238095,17,23
"['011111', '1010', '00']",1,3,5,7,0,12,1.3166666666666667,11,6
"['101', '00', '011111', '1001001', '110']",1,5,9,12,2,21,4.5115384615384615,36,21
"['001', '1', '001101']",1,3,5,5,0,10,1.4523809523809523,10,9
"['0', '1000101', '10000', '00011']",1,4,12,6,2,18,3.1833333333333336,21,15
"['1110011', '101110', '0000']",1,3,8,9,0,17,1.379020979020979,13,4
"['0010', '101', '1001100', '00', '0000111', '101111']",1,6,15,14,2,29,7.918575868575869,54,41
"['010001', '10', '1101110']",1,3,7,8,0,15,1.4059829059829059,13,7
"['0010111', '0101101', '011110', '0000111', '1010000', '110', '0011100']",1,7,22,22,5,44,12.857875457875458,72,64
"['0010110', '0011110', '0101011', '0000000', '001100', '1101', '110']",1,7,23,18,4,41,12.225507825507826,70,73
"['000110', '01', '100', '100000', '0000011']",1,5,17,7,2,24,5.3106837606837605,37,33
"['0110101', '0010', '011', '00011', '0011010', '0100']",1,6,17,13,4,30,9.523232323232323,41,51
"['10111', '000010', '001000']",1,3,11,6,2,17,1.393939393939394,10,7
"['11010', '001001', '0011111']",1,3,8,10,0,18,1.6608391608391608,11,9
"['001', '011', '000', '1011', '0100']",1,5,10,7,5,17,5.595238095238095,18,26
"['0110101', '01', '11', '100101', '000']",1,5,10,10,2,20,4.8247863247863245,33,24
"['01', '10100', '1']",1,3,4,4,0,8,1.5714285714285714,8,6
"['11001', '001111', '1001101', '1000', '111000', '110', '101001']",1,7,17,20,3,37,13.186075036075035,60,70
"['0101101', '001110', '1']",1,3,6,8,0,14,1.304945054945055,14,4
"['1000001', '0010', '1', '00011', '01111', '010010', '00110']",1,7,19,14,3,33,11.396553446553446,67,49
"['01', '11', '01111', '0000011', '111000']",1,5,10,12,2,22,4.788739038739038,39,33
"['1000110', '100', '0100', '00', '01010', '0111100']",1,6,17,11,2,28,9.657647907647908,45,61
"['010', '100', '00110', '010110', '01011']",1,5,12,10,4,22,7.118181818181818,22,40
"['1110111', '010000', '11', '100', '0110', '10100', '0000111', '1011', '0110010']",1,9,22,23,5,45,19.893489843489842,123,101
"['001', '0100110', '001111', '11', '0101101', '0110']",1,6,13,16,2,29,8.98995448995449,47,40
"['0', '0110100', '100', '010110', '1010001', '110101']",1,6,16,14,4,30,8.254945054945054,55,31
"['010010', '00', '10', '1110100']",1,4,10,7,2,17,3.0042735042735043,22,17
"['0000101', '0011', '10101', '1']",1,4,9,8,0,17,3.043939393939394,21,18
"['110011', '10001', '000', '11111']",1,4,8,11,2,19,3.048989898989899,18,16
"['11000', '0001', '101', '10']",1,4,8,6,0,14,3.4428571428571426,15,16
"['110011', '0001', '00001']",1,3,9,6,0,15,2.0343434343434343,7,11
"['10111', '1', '0011000']",1,3,6,7,0,13,1.0833333333333333,14,4
"['1000101', '101', '1101100', '100110', '0000']",1,5,15,12,2,27,5.81032301032301,31,26
"['0101101', '0010', '00']",1,3,8,5,0,13,1.6565656565656566,10,10
"['110000', '0011000', '01111', '1010111', '110111', '01000']",1,6,17,19,6,36,8.614785214785215,49,51
"['101100', '100', '110011', '011111', '1100', '01100']",1,6,13,17,3,30,9.90007215007215,41,54
"['1001', '111101', '10', '0000', '0001000']",1,5,14,9,2,23,4.824864024864024,36,26
"['11110', '001', '1']",1,3,3,6,0,9,1.0833333333333333,10,6
"['11001', '0010100', '1000', '10', '000010', '1110110', '011000']",1,7,22,15,4,37,12.423587523587523,66,60
"['00111', '010000', '00000']",1,3,12,4,2,16,1.490909090909091,8,17
"['0110010', '110', '00101', '0000100']",1,4,14,8,2,22,3.5476190476190474,21,17
"['0', '101011', '10100', '0001']",1,4,9,7,0,16,2.5907647907647906,20,14
"['111', '1001', '01110', '1101', '01100']",1,5,8,13,4,21,6.673015873015872,22,21
"['00010', '011110', '11']",1,3,6,7,0,13,1.331168831168831,11,5
"['111011', '1010', '1000', '0100']",1,4,9,9,3,18,3.65,16,12
"['0', '01', '11100', '01100']",1,4,7,6,2,13,2.9904761904761905,17,18
"['0010001', '001', '1111101', '10', '011000']",1,5,13,12,2,25,4.74981684981685,39,26
"['0001', '1011011', '1', '1101']",1,4,6,10,2,16,2.640909090909091,21,20
"['0011', '11000', '0110']",1,3,7,6,2,13,1.8611111111111112,9,8
"['00100', '0011110', '011']",1,3,8,7,0,15,1.7666666666666666,10,11
"['00', '11011', '1111011']",1,3,4,10,0,14,1.3412698412698414,12,11
"['11001', '011', '100', '000', '1011', '01001']",1,6,12,11,5,23,8.708730158730159,31,39
"['0011', '101001', '0000']",1,3,9,5,2,14,1.5,8,6
"['0', '01', '0011001', '1100110', '1110']",1,5,10,11,2,21,4.594083694083694,40,24
"['0101000', '100111', '1110000', '0000']",1,4,15,9,2,24,3.31008991008991,23,24
"['011101', '00', '110001']",1,3,7,7,2,14,1.6666666666666665,11,5
"['1', '0110', '100101', '000', '0101']",1,5,10,8,2,18,5.045238095238095,28,20
"['0', '1101', '001', '110']",1,4,5,6,2,11,3.1619047619047618,13,13
"['0011001', '10001', '011110', '1000011', '110', '01011', '110101']",1,7,18,21,6,39,12.496603396603396,67,60
"['100', '11110', '1000', '1']",1,4,6,7,0,13,3.034920634920635,16,15
"['01', '10', '01000']",1,3,6,3,2,9,1.6428571428571428,8,7
"['0', '111010', '1001', '1011100', '000001']",1,5,13,11,2,24,4.377139527139527,42,22
"['0001', '0100000', '0001110', '01011']",1,4,15,8,2,23,3.4552669552669553,20,23
"['010100', '0101010', '1101']",1,3,9,8,0,17,2.0685314685314684,7,8
"['0', '111110', '001101']",1,3,5,8,2,13,1.0714285714285714,14,6
"['0000101', '0000100', '0']",1,3,12,3,2,15,1.3571428571428572,13,14
"['000110', '01', '010000', '1011110', '1111', '1010', '01001', '110']",1,8,18,19,4,37,15.333633033633033,88,75
"['001101', '011', '011101', '1010', '001010', '0001000']",1,6,18,14,3,32,9.696370296370297,43,46
"['00100', '011010', '110', '011']",1,4,9,8,2,17,3.727272727272727,16,18
"['0101', '110', '1110']",1,3,4,7,2,11,1.9285714285714284,6,9
"['010', '1', '10011']",1,3,4,5,0,9,1.3333333333333333,9,4
"['1110010', '001', '111', '01010']",1,4,8,10,2,18,3.033333333333333,18,16
"['000100', '00110', '11011', '11100']",1,4,11,10,3,21,3.4363636363636365,18,18
"['00011', '10101', '0000', '1010010', '1100', '1110']",1,6,16,13,5,29,8.347474747474747,40,42
"['01', '111010', '0011001', '0001101', '1000000', '1001001', '1101']",1,7,22,18,4,40,12.050693750693751,75,65
"['0101', '1001', '001010', '1111']",1,4,8,10,3,18,3.3,15,11
"['0', '1001110', '0111000', '101', '1111', '1101110', '01000']",1,7,15,19,3,34,10.39906204906205,79,49
"['0001', '1', '111101']",1,3,4,7,0,11,1.0857142857142859,12,9
"['0001', '1000', '1101', '11100', '0100101']",1,5,13,11,3,24,6.209595959595959,27,29
"['0111000', '011100', '11', '000001', '0100']",1,5,15,10,2,25,5.172999222999223,34,35
"['11000', '100', '11111']",1,3,5,8,2,13,1.4,9,9
"['1111100', '0001110', '001110', '0101', '01000']",1,5,15,14,2,29,5.831102231102231,33,40
"['1001110', '11010', '1']",1,3,5,8,0,13,1.0833333333333333,13,7
"['1000', '110', '0000000', '001111']",1,4,13,7,0,20,2.469019869019869,26,20
"['1011010', '1110011', '11']",1,3,5,11,2,16,1.4603174603174602,13,12
"['0010', '10010', '10', '000']",1,4,10,4,0,14,4.134126984126984,11,22
"['01', '100001', '10', '011']",1,4,7,6,2,13,3.1444444444444444,17,15
"['00010', '010', '10', '0111']",1,4,8,6,0,14,3.4706349206349207,14,19
"['01', '1', '0010000']",1,3,7,3,0,10,1.3611111111111112,12,4
"['0010000', '100', '0110', '100010', '1010']",1,5,16,8,2,24,6.551531801531802,28,32
"['0', '11010', '0011', '1010101', '010010', '1111', '000001']",1,7,17,16,4,33,9.557947607947607,72,47
"['0', '010', '011100', '1001101', '011101']",1,5,11,12,2,23,5.472710622710623,34,29
"['11010', '001', '101101', '110001', '00', '000010']",1,6,16,12,3,28,8.815873015873017,46,39
"['00110', '11010', '1']",1,3,5,6,2,11,1.2666666666666666,11,5
"['010100', '01', '110', '1010001', '11100']",1,5,12,11,0,23,5.3877733377733374,32,23
"['1110101', '100', '001', '110101']",1,4,8,11,2,19,3.700854700854701,17,23
"['1010', '010', '100011', '1111000']",1,4,10,10,0,20,3.4624264624264622,22,14
"['0', '010010', '1101100']",1,3,8,6,0,14,1.151098901098901,14,8
"['100', '001', '011']",1,3,5,4,3,9,1.6666666666666665,6,7
"['101', '11000', '0011100']",1,3,8,7,0,15,1.5666666666666667,11,6
"['1000101', '001101', '100001', '1000', '010011']",1,5,17,12,3,29,7.022144522144522,27,36
"['010100', '000110', '0010', '11011', '01110']",1,5,14,12,4,26,6.3232323232323235,24,32
"['01111', '11010', '0001110', '1']",1,4,7,11,2,18,2.4833333333333334,24,12
"['1100011', '00', '0101', '0010111']",1,4,10,10,2,20,3.3997113997113995,23,14
"['101', '00', '100111', '1011', '110101']",1,5,8,13,2,21,6.190476190476191,26,33
"['0011001', '110', '1100100']",1,3,9,8,2,17,1.9142857142857141,12,9
"['0001001', '1', '101000', '1001', '1010011']",1,5,14,11,2,25,5.339160839160839,37,37
"['0011', '11010', '1110110', '011']",1,4,7,12,0,19,3.7803751803751804,17,20
"['0001101', '101', '000011', '01000']",1,4,13,8,0,21,3.3591297591297593,20,18
"['0010', '101', '10010', '100011', '00010']",1,5,14,9,2,23,7.12041847041847,20,30
"['10101', '100', '01111']",1,3,5,8,2,13,1.6,9,7
"['00100', '0011110', '111011']",1,3,8,10,0,18,1.6456876456876457,11,7
"['011100', '110110', '001101', '1110']",1,4,9,13,3,22,4.0,15,16
"['1011', '10001', '0110111']",1,3,6,10,0,16,1.893939393939394,9,10
"['1111010', '00110', '10', '000', '11111']",1,5,9,13,2,22,4.584920634920635,35,29
"['00', '010011', '110']",1,3,6,5,0,11,1.3444444444444446,10,7
"['0011011', '101', '01', '11']",1,4,5,9,2,14,3.588888888888889,17,17
"['01', '001', '101101']",1,3,5,6,0,11,1.7444444444444445,8,9
"['01111', '00', '010111', '011']",1,4,6,10,0,16,3.3296536796536795,16,20
"['11000', '10100', '00', '1000', '11111', '1011', '1110110', '00010']",1,8,18,19,6,37,14.875901875901876,81,86
"['1000101', '011', '100001', '1111101', '101', '001010', '000']",1,7,18,17,7,35,11.797924297924297,70,57
"['110', '111', '001010', '1111101']",1,4,6,13,2,19,3.217094017094017,20,18
"['0100000', '010', '001', '111', '0001011', '1111011']",1,6,15,15,6,30,6.819047619047619,59,44
"['0', '1111110', '1110', '1111']",1,4,3,13,2,16,2.8545454545454545,20,25
"['0010001', '1101', '0010111']",1,3,9,9,2,18,1.6233766233766234,10,11
"['0100111', '1111101', '10000', '10', '1110']",1,5,10,15,2,25,5.1060606060606055,38,28
"['0011101', '000011', '100', '110001', '0100']",1,5,15,11,2,26,5.475480075480076,33,27
"['11001', '110', '10', '000000']",1,4,10,6,0,16,2.9572871572871575,20,13
"['0', '011100', '1001', '0010100', '10000']",1,5,15,8,0,23,4.895854145854146,36,28
"['0001110', '101', '110001', '1011', '01110', '0110011']",1,6,14,18,2,32,9.325740925740925,49,39
"['101010', '100000', '010111', '0000011']",1,4,15,10,3,25,3.5128205128205128,20,18
"['01', '1001', '0100111', '0000']",1,4,10,7,2,17,3.0353535353535355,19,12
"['110011', '00110', '111']",1,3,5,9,0,14,1.893939393939394,9,8
"['110', '011', '000']",1,3,5,4,3,9,1.3333333333333333,6,7
"['01', '1000', '110', '10110']",1,4,7,7,0,14,3.2928571428571427,14,15
"['0101', '11011', '111', '00011', '000', '1011011', '11100']",1,7,13,19,5,32,11.566089466089466,60,75
"['100001', '1110000', '010111']",1,3,10,9,2,19,1.7307692307692308,12,8
"['11', '1100010', '10111', '10000', '111011', '1100']",1,6,12,17,2,29,8.346264846264846,47,60
"['0', '0111', '001001', '110', '001011']",1,5,10,10,2,20,4.965079365079365,31,26
"['100001', '11100', '011', '01000']",1,4,11,8,2,19,3.317171717171717,18,13
"['000110', '0011', '011']",1,3,7,6,0,13,2.3238095238095235,6,9
"['0010110', '1110001', '001110', '10', '00010', '01110']",1,6,17,15,4,32,9.401809301809301,48,53
"['0011', '001', '1011', '11']",1,4,5,8,2,13,3.9119047619047618,10,22
"['0', '10011', '111101']",1,3,4,8,0,12,1.1645021645021645,12,5
"['011101', '10111', '0001', '11']",1,4,6,11,0,17,2.9764790764790763,19,17
"['10', '010110', '11100', '001011', '01000']",1,5,13,11,4,24,5.93982683982684,30,29
"['1011', '01', '00']",1,3,4,4,2,8,1.5,6,4
"['00101', '111', '00011', '011', '100', '010111', '110']",1,7,12,16,6,28,12.31010101010101,53,63
"['1', '00101', '1101010']",1,3,6,7,0,13,1.25,13,6
"['0010', '001', '00101', '10111', '1111', '1110']",1,6,10,15,5,25,8.334126984126984,33,47
"['01', '00010', '0100101', '110011']",1,4,11,9,0,20,3.663891663891664,19,12
"['101010', '1010101', '00', '1010011', '000111']",1,5,14,14,4,28,6.322954822954823,33,32
"['0001', '1100110', '000']",1,3,9,5,0,14,2.0025974025974023,9,10
"['0', '0010', '110']",1,3,5,3,0,8,1.4714285714285715,7,9
"['00110', '10001', '00011']",1,3,9,6,3,15,2.2,7,5
"['0010', '1001', '000010', '01010', '010011', '1001011']",1,6,19,13,4,32,10.328554778554778,37,41
"['00', '0101', '011001']",1,3,7,5,0,12,1.9666666666666668,8,8
"['0001', '10010', '1110']",1,3,7,6,2,13,1.3611111111111112,8,7
"['0010', '1010100', '00']",1,3,9,4,0,13,1.6565656565656566,10,13
"['0011', '100111', '11']",1,3,4,8,0,12,1.9666666666666668,8,13
"['0011', '010', '1', '1110']",1,4,5,7,2,12,2.942857142857143,15,12
"['0010', '100011', '10']",1,3,7,5,0,12,1.7666666666666666,9,6
"['110001', '010010', '1011', '1101', '01011']",1,5,11,14,4,25,6.263131313131313,24,32
"['00', '1100000', '01000']",1,3,11,3,0,14,1.6825396825396823,11,14
"['01101', '0010010', '111110']",1,3,8,10,0,18,1.5198135198135199,10,7
"['0010010', '110', '0110', '01000']",1,4,12,7,0,19,3.9844155844155846,15,24
"['1101101', '1100', '101110']",1,3,6,11,0,17,2.0965034965034963,9,8
"['10111', '101', '00', '01001', '0101']",1,5,9,10,2,19,6.436507936507937,22,26
"['010010', '0010011', '010110', '0111', '0000']",1,5,16,11,4,27,6.294522144522144,25,34
"['0', '0110000', '0101001']",1,3,10,5,2,15,1.2142857142857144,15,9
"['1101', '011', '111010', '000']",1,4,7,9,2,16,2.8793650793650793,17,13
"['0111000', '010', '111', '101', '0000', '001001', '01100']",1,7,18,13,3,31,11.617476967476968,59,56
"['1100', '0001110', '10011']",1,3,8,8,0,16,1.8787878787878787,10,6
"['11110', '1001', '010010', '1010', '1101', '0100011']",1,6,14,16,3,30,8.708119658119658,40,40
"['000110', '0011', '1']",1,3,6,5,0,11,1.4857142857142858,10,5
"['0', '11010', '110']",1,3,4,5,0,9,1.5833333333333333,8,9
"['00010', '1', '011', '1001101']",1,4,8,8,0,16,2.85,22,10
"['0010', '10101', '1']",1,3,5,5,0,10,1.4,9,4
"['100', '001', '100000', '1111']",1,4,9,7,2,16,2.549206349206349,20,17
"['0001110', '111', '1111101', '011110', '0000', '1011']",1,6,12,19,4,31,7.797985347985348,51,38
"['11110', '10110', '1010', '100000', '000000', '0001010', '0110001']",1,7,25,15,6,40,12.047419247419247,65,71
"['111', '01110', '00001']",1,3,6,7,2,13,1.4,10,4
"['11010', '000011', '0111011', '0011', '10100', '01010', '0110010']",1,7,20,19,5,39,12.743734043734044,59,68
"['01', '001', '10', '1111']",1,4,4,7,2,11,2.6523809523809523,14,13
"['01', '0001', '10110', '1000', '000001', '1001001']",1,6,18,10,2,28,8.541552891552891,44,50
"['101', '0100111', '100']",1,3,6,7,2,13,1.8666666666666667,9,7
"['1001', '1', '1001010', '1111011']",1,4,7,12,2,19,2.744155844155844,25,21
"['0010', '0001110', '11000', '1100001', '011101', '10', '000111']",1,7,20,17,4,37,12.601792651792652,75,62
"['00101', '1110011', '111011', '00', '10010', '0011100']",1,6,15,17,4,32,8.925402375402376,52,42
"['0000111', '010', '110', '11']",1,4,7,8,2,15,3.111111111111111,19,16
"['01', '101000', '0001', '100111', '011111']",1,5,11,13,3,24,5.266666666666667,36,27
"['0', '0100000', '0110', '10011']",1,4,11,6,0,17,2.6954545454545453,24,13
"['00001', '01111', '0000000', '0101', '0100']",1,5,17,8,4,25,4.710606060606061,31,36
"['0', '010', '1100']",1,3,5,3,0,8,1.4714285714285715,7,8
"['0001', '0010', '1']",1,3,6,3,2,9,1.55,8,5
"['111110', '1101011', '10']",1,3,4,11,0,15,1.4059829059829059,12,9
"['001', '1', '0110111', '0000']",1,4,8,7,0,15,2.085064935064935,23,12
"['100', '110', '000']",1,3,6,3,3,9,1.6666666666666665,4,8
"['1001', '1', '01110', '1011111']",1,4,5,12,0,17,2.63989898989899,24,13
"['0', '11011', '111', '001001', '0101', '1100']",1,6,10,13,2,23,7.535137085137085,42,39
"['1000001', '011', '1111', '1010', '00', '0101100']",1,6,14,13,4,27,7.026984126984127,53,32
"['1011', '00010', '1011001', '000']",1,4,11,8,0,19,3.274098124098124,19,15
"['000111', '1', '10', '10010']",1,4,7,7,0,14,2.6525974025974026,21,14
"['000110', '00010', '10010', '10110']",1,4,13,8,3,21,4.5636363636363635,9,28
"['0', '11111', '0100']",1,3,4,6,0,10,0.6222222222222222,12,4
"['000001', '001', '001101']",1,3,10,5,2,15,1.8333333333333333,8,14
"['10100', '01', '000100', '0100110']",1,4,13,7,0,20,3.5251970251970253,19,19
"['0110000', '0111011', '000011']",1,3,11,9,2,20,1.6483516483516483,10,13
"['110011', '0011', '0010', '1111101']",1,4,8,13,2,21,3.492657342657343,19,19
"['00010', '100', '11']",1,3,6,4,0,10,1.1857142857142857,9,5
"['1110010', '01101', '1']",1,3,5,8,0,13,1.25,13,6
"['011111', '101', '1001011', '0100']",1,4,8,12,0,20,3.022866022866023,21,13
"['10100', '100001', '0100']",1,3,10,5,0,15,2.0343434343434343,6,8
"['1010111', '011', '0001000']",1,3,9,8,2,17,1.4285714285714286,14,5
"['0', '001000', '1001', '11']",1,4,8,5,0,13,2.2023809523809526,20,8
"['1101', '100', '1110100', '0100']",1,4,9,9,2,18,3.983116883116883,15,18
"['10100', '100', '010']",1,3,7,4,2,11,2.1666666666666665,6,9
"['01', '0111011', '101011', '0110', '1111110', '11101', '10011', '000000', '0110010', '1100']",1,10,23,30,9,53,23.968487068487068,151,122
"['101111', '0110', '1000111']",1,3,6,11,0,17,1.9146853146853147,9,7
"['1000100', '1', '1111001']",1,3,7,8,2,15,1.0714285714285714,16,8
"['011101', '0011111', '000', '111011']",1,4,8,14,2,22,3.1307692307692307,21,15
"['0', '0110', '1111110', '01110']",1,4,6,11,0,17,3.084343434343434,21,27
"['1011', '01', '10', '0111100']",1,4,6,9,2,15,3.2676767676767673,20,12
"['0', '101', '0001110']",1,3,6,5,0,11,1.15,13,4
"['01', '001', '1010110', '00001', '1100', '111001']",1,6,14,13,0,27,8.32137307137307,46,43
"['1000', '001110', '0100110']",1,3,10,7,0,17,1.8965034965034966,9,11
"['1010', '01', '0111010', '010110']",1,4,9,10,0,19,3.753768453768454,18,22
"['01', '10110', '1111001', '0000000', '1100101', '0100']",1,6,18,14,3,32,7.398989898989899,58,33
"['011011', '1001', '110', '01011', '1101010']",1,5,10,15,0,25,6.477022977022977,27,31
"['11110', '001', '110', '000']",1,4,7,7,3,14,2.583333333333333,16,17
"['1000001', '00100', '100', '010110', '0111']",1,5,15,10,0,25,5.399272949272949,32,24
"['1111100', '000101', '00', '100000', '011111', '1101', '011000']",1,7,19,18,4,37,10.227078477078477,79,67
"['010100', '101100', '1', '10011']",1,4,9,9,2,18,3.0108225108225106,23,13
"['01', '011', '1110']",1,3,3,6,0,9,1.7047619047619047,6,8
"['101010', '001100', '1000']",1,3,10,6,2,16,1.9,8,9
"['01', '00', '011110', '0000111', '110']",1,5,10,10,2,20,4.870940170940171,35,28
"['011', '010010', '00', '101111', '0001000', '1110']",1,6,15,13,2,28,7.1730991230991235,55,40
"['00100', '100', '1011', '0100']",1,4,10,6,2,16,4.011904761904762,12,20
"['10', '10011', '11']",1,3,3,6,2,9,1.6428571428571428,7,11
"['10111', '0011', '10101', '1001', '000', '01010', '1011', '1101', '110']",1,9,16,21,9,37,22.735714285714284,73,103
"['1001100', '101000', '00111', '11']",1,4,10,10,0,20,3.1615606615606615,21,18
"['110000', '101', '001001', '0100']",1,4,12,7,2,19,3.5825396825396822,18,14
"['1111001', '000011', '11']",1,3,6,9,0,15,1.4059829059829059,14,13
"['1', '001', '010001', '0111']",1,4,7,7,0,14,3.0238095238095237,18,15
"['0', '100001', '011100', '111110', '001100', '1101', '0100101']",1,7,18,18,4,36,10.561155511155512,75,48
"['00101', '1001', '0101011', '10010', '1011000', '1010001']",1,6,19,16,5,35,9.998412698412698,42,46
"['1101001', '11010', '001', '0010111', '011', '011111']",1,6,12,19,4,31,8.658763458763458,49,50
"['0110', '0011010', '000', '1111']",1,4,9,9,2,18,2.944155844155844,19,15
"['0', '0010', '0100111', '11']",1,4,7,7,0,14,1.9732323232323232,23,12
"['01', '00000', '10111', '100', '100010']",1,5,13,8,2,21,4.896536796536797,31,24
"['0', '01001', '11011', '1100']",1,4,7,8,2,15,3.0,17,13
"['0110101', '0011', '1010', '00']",1,4,9,8,2,17,3.55050505050505,17,14
"['1', '00001', '100', '0110', '1110100']",1,5,11,9,0,20,4.477994227994228,36,22
"['010001', '111010', '11', '1101100', '00']",1,5,11,12,4,23,4.773504273504273,39,25
"['00110', '1001', '1100', '111']",1,4,7,9,2,16,3.7261904761904763,15,13
"['01101', '001', '011101', '00010', '0101']",1,5,12,11,2,23,6.675974025974026,20,35
"['0', '001', '0110', '1111111']",1,4,5,10,0,15,2.035064935064935,25,10
"['0', '111111', '1100', '10']",1,4,4,9,0,13,2.3833333333333333,21,12
"['10111', '111000', '1', '0000']",1,4,8,8,0,16,1.9867243867243867,24,16
"['1001', '1010', '00', '11111', '000100']",1,5,11,10,2,21,4.854040404040404,32,21
"['11001', '1111010', '011', '11']",1,4,5,12,0,17,3.3825396825396825,20,23
"['0010110', '00', '10011', '00001']",1,4,12,7,2,19,3.3539682539682536,19,15
"['1001000', '01', '1', '000']",1,4,9,4,0,13,2.361111111111111,21,14
"['1000010', '00110', '00', '101110']",1,4,12,8,0,20,3.5251970251970253,20,21
"['0000', '0010', '0111111', '100010']",1,4,12,9,2,21,3.2031468531468534,21,19
"['1101', '110', '1100100', '0110']",1,4,8,10,2,18,4.3370129870129865,15,18
"['01101', '001111', '1100100', '111']",1,4,8,13,0,21,3.872144522144522,20,20
"['01', '0010', '101111', '0000']",1,4,9,7,2,16,2.85,19,12
"['01111', '1100', '000001', '11']",1,4,8,9,0,17,2.696176046176046,21,18
"['010', '1001101', '10', '000', '001001', '1111111']",1,6,13,15,4,28,7.118315018315018,56,31
"['111010', '11', '0110', '0101100', '0100100', '0000111', '000']",1,7,20,16,3,36,11.408180708180709,74,69
"['0010', '0011101', '11', '101', '100', '1101100', '1010111', '010101']",1,8,17,22,5,39,16.145887445887446,91,79
"['0010', '0110', '10', '1111']",1,4,6,8,3,14,3.1666666666666665,13,13
"['1011011', '0101', '1100', '10']",1,4,7,10,2,17,3.3686868686868685,18,14
"['101', '1111', '00', '0111', '011110']",1,5,6,13,2,19,5.170634920634921,26,23
"['101', '01001', '11']",1,3,4,6,0,10,2.1214285714285714,6,9
"['1001', '1', '0100']",1,3,5,4,2,9,1.55,8,4
"['1000100', '100100', '110', '111011']",1,4,11,11,2,22,3.3957264957264957,19,20
"['00111', '111000', '1']",1,3,5,7,0,12,1.1645021645021645,14,9
"['1000010', '11010', '1001']",1,3,9,7,0,16,2.0606060606060606,8,10
"['00100', '1010', '1']",1,3,6,4,0,10,1.4,9,4
"['00', '1', '0010100', '11010']",1,4,9,6,0,15,2.265873015873016,23,14
"['0', '0101010', '0001']",1,3,8,4,0,12,1.0136363636363637,12,8
"['1000100', '001000', '101', '0100001', '11100']",1,5,18,10,2,28,5.9426462426462425,34,26
"['1011110', '101', '1011001', '1100110']",1,4,9,15,3,24,3.942857142857143,22,24
"['101010', '10100', '0001011']",1,3,10,8,0,18,2.0244755244755246,8,10
"['1101111', '011', '101', '1010001', '0101']",1,5,9,15,4,24,6.443290043290043,31,35
"['01', '100', '111010', '11111']",1,4,5,11,0,16,2.8296536796536795,19,16
"['1011', '1010', '0101011']",1,3,6,9,2,15,2.2045454545454546,7,11
"['0100111', '001', '1010', '001010', '0010010', '0110011']",1,6,19,15,3,34,9.914019314019313,45,48
"['1100010', '01', '00', '10010']",1,4,10,6,2,16,3.365079365079365,19,15
"['010011', '10101', '101110', '1']",1,4,7,11,2,18,3.0259740259740258,22,16
"['00', '110', '100111', '11']",1,4,5,8,2,13,2.6444444444444444,17,15
"['01', '01110', '1101']",1,3,4,7,0,11,1.9047619047619047,8,6
"['010', '001', '010101', '1011011', '110']",1,5,10,12,3,22,5.591452991452991,30,23
"['1100111', '1', '10']",1,3,3,7,0,10,1.3611111111111112,12,8
"['010100', '01', '10001', '100111', '110111', '1011000', '01011']",1,7,17,20,5,37,12.7001221001221,67,60
"['0100000', '10', '1001101']",1,3,10,6,2,16,1.4603174603174602,14,5
"['010', '010110', '0111']",1,3,6,7,0,13,1.838095238095238,7,13
"['00111', '10101', '1011100']",1,3,7,10,2,17,1.9333333333333331,8,9
"['010101', '100', '11']",1,3,5,6,0,11,1.5666666666666667,9,6
"['0', '10100', '0100101']",1,3,8,5,0,13,1.25,13,6
"['011', '1010', '11101', '111110', '0111', '1001100']",1,6,10,19,2,29,9.088400488400488,42,43
"['01', '0011', '00100', '10', '1110']",1,5,9,8,4,17,5.253968253968254,26,25
"['0', '0111101', '0101001']",1,3,7,8,2,15,1.0714285714285714,14,8
"['110', '10110', '011000']",1,3,7,7,0,14,2.143939393939394,8,8
"['0110100', '1001010', '10001', '100', '1111', '0111', '010011', '0101', '1100']",1,9,21,23,6,44,21.989305139305138,97,102
"['1101101', '1', '010110', '000']",1,4,8,9,0,17,2.3716117216117216,24,8
"['101011', '101', '100', '100110', '010111', '0101100']",1,6,14,17,5,31,10.285470085470084,43,43
"['0110001', '0010', '1', '0100101']",1,4,11,8,2,19,3.0298701298701296,24,12
"['1110011', '10000', '1100101', '0111', '0000', '0011011']",1,6,17,17,5,34,8.276695526695526,53,48
"['0', '1010110', '100100', '0010101']",1,4,12,9,2,21,3.0384615384615383,25,14
"['00111', '010011', '1']",1,3,5,7,0,12,1.3463203463203464,11,7
"['110011', '101011', '10110']",1,3,6,11,2,17,2.106060606060606,7,13
"['0', '0010', '1110']",1,3,5,4,2,9,1.3,8,9
"['10010', '1100', '1', '00000']",1,4,10,5,2,15,2.444444444444444,19,12
"['0', '100001', '011', '111110', '110111']",1,5,8,14,3,22,4.246031746031746,38,24
"['0', '10101', '011101']",1,3,5,7,0,12,1.1645021645021645,11,6
"['0100010', '11000', '00', '1010']",1,4,12,6,0,18,3.5613275613275612,18,18
"['011101', '0110000', '0110', '0110100']",1,4,13,11,2,24,4.496303696303697,14,34
"['110010', '1010110', '010', '1010101', '0101100']",1,5,15,15,3,30,6.587545787545787,30,28
"['00111', '01', '11001']",1,3,5,7,2,12,1.7428571428571429,10,8
"['0010001', '1101', '011010', '100111']",1,4,11,12,2,23,3.661072261072261,20,12
"['0010101', '1101', '010111', '01001', '110']",1,5,11,14,0,25,6.01021201021201,26,30
"['0010', '0001', '100', '011111', '000100']",1,5,14,9,4,23,5.515079365079365,30,34
"['0', '01', '10011']",1,3,4,4,0,8,1.5714285714285714,8,4
"['1100', '1001000', '1']",1,3,7,5,0,12,1.1954545454545453,12,7
"['00', '111110', '0001111']",1,3,6,9,0,15,1.3098290598290598,14,11
"['0', '0011', '111110', '01110']",1,4,6,10,0,16,2.812987012987013,20,18
"['0', '1100010', '10101', '0001', '00110', '1110100', '11100']",1,7,18,16,5,34,10.694083694083695,72,54
"['10100', '00', '0001111']",1,3,8,6,0,14,1.349206349206349,13,11
"['010100', '1111101', '101', '01001', '101110', '101001']",1,6,14,19,3,33,9.89079254079254,43,48
"['001101', '101010', '0110', '010011', '111000']",1,5,14,14,4,28,5.9,29,24
"['1000001', '1110010', '11', '1111110', '010101']",1,5,12,17,3,29,4.646520146520146,42,30
"['01', '1', '0010000', '001100', '0010010']",1,5,16,7,2,23,5.236874236874237,37,33
"['1100011', '01', '001001', '111000']",1,4,11,10,2,21,3.0790598290598292,24,16
"['001', '00011', '1111', '10100', '10', '000001', '01100']",1,7,17,13,3,30,9.902164502164503,66,57
"['0', '111', '1000', '01010', '1100011']",1,5,10,10,0,20,4.262987012987013,35,20
"['101', '0101', '1110']",1,3,4,7,2,11,1.9285714285714284,6,8
"['100110', '00', '011001', '0101', '11100']",1,5,12,11,2,23,6.021933621933622,31,24
"['001', '11', '101101', '110001', '011111']",1,5,8,15,3,23,5.288888888888889,34,35
"['01', '0100010', '100', '1010011', '111000', '1011111']",1,6,15,17,3,32,7.799450549450549,58,38
"['1110000', '1001', '0010100', '1111', '10', '1001100', '1010001']",1,7,20,18,6,38,11.784271284271284,75,62
"['001100', '1', '000011']",1,3,8,5,2,13,1.2380952380952381,14,6
"['0', '100', '1011000']",1,3,7,4,0,11,1.35,12,8
"['1111', '1000', '0', '111011']",1,4,5,10,2,15,2.1357142857142857,21,16
"['001', '0111010', '1']",1,3,5,6,0,11,1.15,12,4
"['101', '1101', '0010', '111011']",1,4,6,11,2,17,3.795238095238095,15,16
"['1100111', '11011', '0']",1,3,4,9,0,13,1.4166666666666667,12,9
"['0', '111', '1100100']",1,3,5,6,0,11,0.85,13,6
"['001', '0011100', '1010100', '100', '01000']",1,5,16,9,4,25,6.164285714285715,30,41
"['0', '1111100', '1011110', '100', '110111', '1011']",1,6,9,19,2,28,7.88040848040848,53,41
"['01', '0011001', '10111', '1000000', '010111', '10011']",1,6,16,16,4,32,8.418048618048617,53,45
"['00', '101001', '11']",1,3,5,5,2,10,1.0,10,4
"['0001000', '100', '010010', '00110', '000111', '111000', '110', '101001', '111001']",1,9,27,21,7,48,22.362276612276613,111,108
"['00111', '00010', '00101']",1,3,9,6,3,15,2.2,5,10
"['0001001', '111', '00101', '101000', '0110', '011111']",1,6,15,16,2,31,8.12915972915973,49,39
"['0010', '001', '1101000', '1111', '1000010']",1,5,14,11,4,25,5.146103896103896,35,27
"['0', '00011', '1111001', '0011011', '000111']",1,5,12,14,2,26,4.997002997002997,39,32
"['101', '10100', '111', '1010011']",1,4,7,11,2,18,3.75,16,28
"['011', '00100', '1111110', '1011', '00010']",1,5,11,13,2,24,4.9763347763347765,34,25
"['111', '0011', '1001', '1000000', '0101']",1,5,12,10,3,22,5.437012987012987,32,28
"['0', '101', '0001', '110']",1,4,6,5,2,11,2.9238095238095236,14,11
"['001101', '01', '0110100', '111001']",1,4,10,11,2,21,3.3290598290598292,22,15
"['0000111', '01', '001101', '0001011']",1,4,12,10,2,22,3.7844932844932844,21,18
"['00111', '1110011', '100111', '001110', '0110010', '0111110', '01100']",1,7,18,25,7,43,14.524242424242424,61,69
"['010001', '1000110', '0110', '011101', '100000', '0010010', '0101', '110']",1,8,25,18,7,43,17.796198246198248,85,84
"['10001', '01111', '10']",1,3,5,7,2,12,1.2571428571428571,11,7
"['0', '10101', '10010', '0111']",1,4,7,8,2,15,2.977777777777778,18,11
"['11001', '1101', '010', '0']",1,4,6,7,0,13,3.1936507936507934,15,11
"['0001', '1', '01100']",1,3,6,4,0,10,1.1777777777777778,10,5
"['000110', '1010', '00', '11101']",1,4,9,8,0,17,3.264502164502164,19,13
"['01', '001', '0000010']",1,3,9,3,0,12,1.8444444444444446,10,8
"['010100', '001', '0010011', '0110000', '10011', '1101']",1,6,18,14,2,32,8.93030858030858,47,41
"['0', '01001', '00011']",1,3,7,4,2,11,1.4666666666666668,10,6
"['11110', '010', '0011001', '0001', '10110', '1101']",1,6,13,15,4,28,8.732251082251082,41,38
"['11011', '0110011', '00111', '1100100', '1111', '0010010', '01110', '0100']",1,8,20,24,8,44,17.655483405483405,82,89
"['0000', '1001001', '00010', '11']",1,4,12,6,0,18,3.012987012987013,20,12
"['0', '11101', '0100110', '11']",1,4,6,9,0,15,2.265873015873016,24,10
"['0101', '110', '0000100', '11']",1,4,9,7,0,16,3.2057720057720056,20,12
"['01', '0011101', '00', '10010']",1,4,9,7,2,16,3.198412698412698,21,15
"['1101111', '101010', '101', '0001', '110', '1110']",1,6,10,17,4,27,7.837967587967587,45,46
"['0101101', '0011011', '000']",1,3,9,8,2,17,2.057142857142857,10,8
"['1000100', '0110', '1110']",1,3,8,7,2,15,1.4772727272727273,9,8
"['01', '1010010', '000101']",1,3,9,6,0,15,1.7136752136752138,12,7
"['010100', '0111011', '11', '100', '1001000', '110']",1,6,14,14,4,28,8.17985347985348,52,40
"['001111', '1', '011', '110001', '1111010']",1,5,8,15,2,23,4.563308913308913,42,30
"['1001111', '111010', '001011']",1,3,7,12,2,19,1.8846153846153846,9,10
"['1011', '11110', '100']",1,3,4,8,0,12,1.5158730158730158,7,8
"['100100', '010', '001']",1,3,8,4,2,12,2.0,8,7
"['00100', '1101', '1', '00101']",1,4,8,7,2,15,2.977777777777778,17,16
"['101100', '01', '1']",1,3,4,5,0,9,1.4523809523809523,10,6
"['11110', '10', '10011', '101101']",1,4,6,12,2,18,3.4974025974025973,17,19
"['1101001', '1000110', '1000', '1']",1,4,10,9,2,19,2.601298701298701,25,17
"['11101', '000', '1110']",1,3,5,7,0,12,1.4246031746031744,8,7
"['100', '110100', '011100', '0100']",1,4,11,8,2,19,4.457142857142857,13,28
"['101', '100111', '00001']",1,3,7,7,0,14,1.712121212121212,9,10
"['100001', '1', '1000010', '011010', '110', '0100']",1,6,16,11,2,27,7.587884337884338,51,36
"['01101', '111100', '1001010', '000', '1011', '01000']",1,6,16,14,2,30,8.122505272505272,45,38
"['0', '100', '1111111']",1,3,3,8,0,11,0.7,15,4
"['011101', '00', '01001', '11']",1,4,7,8,2,15,2.87012987012987,18,12
"['010000', '0101110', '0011', '101', '00100', '10111', '00', '011111']",1,8,19,19,4,38,15.135098235098235,87,78
"['11001', '10111', '10000', '101111']",1,4,8,13,3,21,3.418181818181818,16,28
"['1011010', '111010', '101101', '10001', '00', '001100']",1,6,16,16,3,32,9.782772782772783,43,42
"['11000', '010', '100', '0010011']",1,4,11,7,2,18,3.6166666666666667,19,16
"['001', '00011', '010011', '110', '110101']",1,5,11,12,4,23,5.9267676767676765,29,31
"['0010101', '000101', '0101001']",1,3,12,8,2,20,2.241758241758242,5,12
"['0', '1011', '100', '1011111']",1,4,5,10,0,15,2.8487012987012985,21,16
"['11010', '110001', '100011', '10']",1,4,9,10,2,19,3.495670995670996,18,20
"['1001', '1', '001011']",1,3,5,6,0,11,1.2857142857142856,11,8
"['0', '101100', '1010111']",1,3,6,8,0,14,1.151098901098901,14,6
"['001101', '101', '011', '00011']",1,4,8,9,2,17,3.977272727272727,15,17
"['0011', '01', '00', '01110']",1,4,7,6,2,13,3.642857142857143,13,17
"['10111', '00', '100', '1100110']",1,4,8,9,0,17,3.2968253968253967,20,14
"['00100', '10', '000']",1,3,8,2,0,10,1.7214285714285715,7,12
"['00', '1', '10110']",1,3,4,4,0,8,0.9047619047619047,9,4
"['0', '0011', '001101', '011110']",1,4,8,9,2,17,3.038095238095238,21,17
"['1010110', '01', '10']",1,3,5,6,2,11,1.3888888888888888,12,8
"['110', '111010', '11']",1,3,3,8,0,11,1.9666666666666668,8,12
"['1010', '011', '000']",1,3,6,4,2,10,1.476190476190476,6,6
"['11110', '1000101', '011', '0111011', '111', '0100100', '0101', '011000']",1,8,19,23,5,42,16.81854256854257,90,82
"['0100111', '000001', '0111', '1101', '1100']",1,5,12,13,3,25,5.201748251748252,32,32
"['11110', '001', '000111', '0000']",1,4,10,8,0,18,2.8557720057720055,20,21
"['1001', '1110101', '1010', '0000', '111001']",1,5,12,13,3,25,6.2912587412587415,27,29
"['100', '10000', '0000000', '111111', '001110', '10', '1011100', '01100']",1,8,23,18,6,41,13.573909423909424,102,92
"['010011', '100001', '10', '0101001']",1,4,12,9,2,21,3.4957264957264957,20,17
"['110010', '001', '1010', '0000', '110']",1,5,12,8,4,20,5.566666666666666,24,28
"['11', '10', '00011']",1,3,4,5,2,9,1.3571428571428572,8,8
"['0', '101100', '1110', '1001101']",1,4,8,10,0,18,3.2322177822177824,21,11
"['0', '0101111', '010', '011']",1,4,6,8,2,14,3.1166666666666667,19,19
"['0', '1101011', '111']",1,3,3,8,0,11,0.85,13,8
"['0010010', '000100', '111']",1,3,10,6,0,16,1.3914529914529914,13,6
"['01', '0000100', '01111', '000', '01100']",1,5,14,8,2,22,4.9373015873015875,33,41
"['01101', '1', '010001', '10101', '00110', '11101', '100000']",1,7,17,16,6,33,10.553246753246754,66,55
"['1110111', '00', '10110', '011']",1,4,6,11,0,17,3.2103174603174605,20,12
"['0', '00100', '110010']",1,3,8,4,0,12,1.3463203463203464,12,8
"['0', '10010', '0100110']",1,3,8,5,0,13,1.4166666666666667,12,9
"['010', '110', '001101', '010111']",1,4,8,10,4,18,3.944444444444444,16,16
"['1010', '11101', '1000011', '110', '0100']",1,5,11,12,2,23,5.578210678210678,29,23
"['0', '110100', '10', '1100', '111001']",1,5,9,10,2,19,5.571428571428571,30,24
"['1011010', '100', '0000']",1,3,9,5,0,14,1.7168831168831167,10,9
"['01', '1111', '010111', '0000', '11100']",1,5,9,12,2,21,4.108946608946609,33,31
"['0', '1111101', '101101', '0000001', '111011']",1,5,11,16,4,27,4.177655677655678,42,28
"['0001001', '1', '00011', '1100101', '0000']",1,5,15,9,2,24,4.987012987012987,37,31
"['111100', '1110000', '00000', '00001', '111101', '100011', '000010', '01001', '1100', '1110']",1,10,30,24,9,54,25.806798756798756,137,156
"['0000111', '1101', '0110', '11']",1,4,7,10,2,17,3.436868686868687,20,15
"['101', '11110', '010001', '1101100']",1,4,9,12,0,21,3.245687645687646,20,14
"['00', '1100', '0110']",1,3,6,4,2,10,2.083333333333333,6,10
"['1001001', '00', '1111101']",1,3,7,9,2,16,1.0952380952380951,14,5
"['0000100', '1111', '11101', '010111', '01100']",1,5,12,15,2,27,5.267599067599067,32,30
"['110', '0111', '11111']",1,3,2,10,0,12,1.7380952380952381,7,13
"['110', '011', '01110', '110101']",1,4,6,11,2,17,4.045454545454545,15,18
"['10001', '00', '11010', '11']",1,4,7,7,4,14,2.8857142857142857,17,12
"['0', '110', '0111']",1,3,3,5,0,8,1.4714285714285715,7,7
"['0011', '00110', '100011', '11']",1,4,8,9,0,17,4.154256854256854,15,20
"['0001011', '1100001', '001']",1,3,10,7,2,17,1.7714285714285714,12,10
"['11', '00', '101100', '0010011']",1,4,9,8,2,17,2.5042735042735043,24,17
"['10000', '0011010', '10100', '00', '1100']",1,5,15,8,2,23,6.303463203463203,27,38
"['0', '1101101', '10000', '110100', '1111', '0100100', '01110']",1,7,17,18,4,35,9.97913197913198,74,51
"['11001', '0110101', '1100010', '110111', '11111', '1010010', '111001']",1,7,16,27,7,43,14.935830835830837,50,91
"['1', '01011', '000011']",1,3,6,6,0,12,1.3463203463203464,11,8
"['1', '111010', '1110', '00000']",1,4,8,8,0,16,2.0715728715728714,23,14
"['010', '1000101', '001', '11', '1000']",1,5,11,8,2,19,5.3145743145743145,29,23
"['010001', '1111101', '11101', '0111']",1,4,7,15,0,22,3.3167832167832167,18,27
"['0', '0111000', '0011000', '10001', '1010', '0111101']",1,6,17,14,3,31,7.762554112554112,57,40
"['011', '1111000', '010111']",1,3,6,10,0,16,1.528205128205128,13,11
"['0011110', '100', '10', '000']",1,4,9,6,2,15,3.311111111111111,18,21
"['0010101', '110', '1']",1,3,5,6,0,11,1.15,12,6
"['00100', '10010', '1']",1,3,7,4,2,11,1.4666666666666668,10,4
"['1101011', '101', '1', '00000']",1,4,8,8,0,16,1.9333333333333333,26,12
"['01', '0010', '1']",1,3,4,3,0,7,1.7333333333333334,6,4
"['11011', '001', '10', '1100100']",1,4,8,9,0,17,3.1825396825396823,20,16
"['10101', '000111', '011']",1,3,6,8,0,14,1.962121212121212,8,7
"['01101', '110', '000', '011000']",1,4,10,7,2,17,3.643939393939394,15,21
"['1110111', '010', '001010', '1111']",1,4,7,13,0,20,2.941192141192141,22,18
"['01100', '1', '110100', '0111']",1,4,7,9,0,16,3.012987012987013,20,15
"['0000101', '100', '0']",1,3,8,3,0,11,1.15,13,7
"['01', '11000', '10', '1101', '00010']",1,5,10,8,4,18,5.544444444444444,27,24
"['0010110', '010001', '1', '1010100', '1000']",1,5,15,10,2,25,4.867832167832168,38,22
"['0001001', '11010', '101', '11111', '1011', '010011']",1,6,12,18,2,30,8.742030192030192,43,49
"['01', '1101000', '1111001', '1011100', '0111', '1010010', '01100']",1,7,18,21,4,39,13.165223665223664,69,56
"['0101010', '010011', '010', '0011100']",1,4,13,10,2,23,3.9655677655677657,20,26
"['0011', '111010', '0000']",1,3,8,6,2,14,1.3,10,9
"['1001', '1', '011000']",1,3,6,5,0,11,1.2857142857142856,11,4
"['000001', '0101000', '0010100', '00001']",1,4,19,6,2,25,3.6893106893106893,15,31
"['111', '00111', '000', '110', '1001111']",1,5,8,13,3,21,4.983333333333333,30,34
"['010100', '000110', '001000', '101', '1111', '00', '1011', '00010']",1,8,21,15,5,36,14.237373737373737,84,80
"['10000', '10', '10011']",1,3,7,5,2,12,1.7428571428571429,8,10
"['010000', '10', '01000', '11']",1,4,10,5,2,15,3.016233766233766,18,16
"['0011000', '0011010', '00', '1000', '110111', '1001011']",1,6,18,15,3,33,8.63901098901099,55,48
"['0', '0011000', '10', '1101', '1110']",1,5,9,9,2,18,5.335353535353535,32,20
"['1111100', '101', '10', '111']",1,4,4,11,2,15,3.311111111111111,18,19
"['1100111', '101', '101100', '00101']",1,4,9,12,0,21,3.844172494172494,19,19
"['1000', '1001', '0110']",1,3,7,5,3,12,1.75,7,6
"['010001', '001', '100111', '0111']",1,4,9,10,2,19,3.9714285714285715,16,18
"['110110', '101', '100', '0101011', '1000', '01100']",1,6,14,14,2,28,9.687196137196137,41,38
"['1100001', '01', '111']",1,3,5,7,0,12,1.4444444444444444,11,11
"['0001001', '0010', '1000000', '10', '0100']",1,5,18,6,4,24,6.231962481962482,33,31
"['01', '1000', '111', '1001010']",1,4,8,8,0,16,2.790764790764791,20,14
"['100001', '1', '1001010', '0011', '1101']",1,5,11,11,2,22,5.25949050949051,34,30
"['001', '010', '110', '10']",1,4,6,5,3,11,3.6666666666666665,10,15
"['0', '0110010', '11']",1,3,5,5,0,10,0.6944444444444444,13,4
"['010', '00', '1101', '101001', '1110']",1,5,9,10,2,19,5.526190476190476,25,19
"['11001', '00110', '11010', '001']",1,4,9,9,3,18,4.0,16,17
"['0', '0001100', '001', '00101']",1,4,11,5,0,16,3.1,21,21
"['101100', '011101', '1010111', '01010', '011001']",1,5,13,17,3,30,6.861305361305361,27,25
"['0110000', '0011011', '100', '100111']",1,4,12,11,2,23,3.468864468864469,24,16
"['01', '00', '110']",1,3,4,3,2,7,1.3,5,6
"['01', '1010', '0110110', '000']",1,4,9,7,0,16,3.40981240981241,18,16
"['001', '1011001', '0101011', '10000', '1101']",1,5,13,13,2,26,5.178210678210678,32,29
"['01', '1001', '000010']",1,3,8,4,0,12,1.7666666666666666,9,5
"['0010', '11011', '111100', '00100', '0110', '00', '1010011', '000111', '1110', '0110011']",1,10,24,26,9,50,26.43806193806194,139,145
"['01', '10', '1111']",1,3,2,6,2,8,1.1666666666666665,8,6
"['0101010', '01111', '1100', '10']",1,4,8,10,0,18,3.0533910533910533,20,15
"['10100', '0100100', '11']",1,3,8,6,0,14,1.6825396825396823,10,7
"['101100', '001111', '00000', '11', '1000']",1,5,13,10,2,23,4.2272727272727275,35,32
"['00', '1000101', '010110', '110100']",1,4,12,9,2,21,3.1880341880341883,22,12
"['1', '10000', '000010']",1,3,9,3,0,12,1.3463203463203464,11,7
"['1011', '1001', '0111010', '1110']",1,4,7,12,3,19,3.5681818181818183,17,13
"['0101', '110', '1100100']",1,3,7,7,0,14,1.7168831168831167,10,8
"['00110', '10', '1110100', '000', '1100']",1,5,12,9,0,21,5.697907647907648,30,34
"['001', '1111101', '10111', '100', '0110010', '011010', '110', '01000']",1,8,18,21,7,39,15.828576978576978,89,70
"['0011011', '0111111', '111']",1,3,4,13,2,17,1.9142857142857141,10,13
"['11110', '111010', '1001000', '1110101', '0000111']",1,5,14,18,3,32,5.6558441558441555,34,38
"['010100', '11001', '11010', '0010111', '111', '111011', '00', '10011', '01000']",1,9,20,24,6,44,20.41143301143301,108,110
"['1000001', '010', '011', '00110', '11101', '100011', '000000', '1010001']",1,8,25,17,8,42,15.346142746142746,90,68
"['101', '01111', '1111111', '00001']",1,4,6,14,2,20,2.6333333333333333,23,21
"['010', '011100', '00100', '10', '11111', '0100001', '110', '1110']",1,8,17,18,4,35,15.85968475968476,83,77
"['11001', '0000110', '1110']",1,3,8,8,0,16,1.712121212121212,10,7
"['0110', '11101', '10', '011110', '000111', '0110001']",1,6,13,17,2,30,9.063308913308914,49,42
"['0110101', '101010', '101', '0001', '1011011', '01011']",1,6,14,18,2,32,9.216022866022866,40,46
"['0', '001100', '000100', '011001']",1,4,13,6,3,19,3.1904761904761907,21,23
"['001', '10100', '10011', '000', '1100111']",1,5,12,11,4,23,6.016666666666667,29,26
"['00', '01101', '01100']",1,3,7,5,2,12,1.9428571428571428,7,13
"['1011101', '100', '01010', '11']",1,4,7,10,0,17,3.4325396825396823,19,11
"['0', '0101000', '101011', '1101110', '1111']",1,5,10,15,2,25,4.050849150849151,40,21
"['01', '11000', '100011', '0111', '001001', '1101010']",1,6,15,15,2,30,8.59022089022089,51,40
"['0001', '111000', '1110100']",1,3,9,8,0,17,1.8867132867132868,10,13
"['101011', '00110', '0110110', '100010']",1,4,12,12,2,24,4.018648018648019,15,16
"['01', '1', '001000']",1,3,6,3,0,9,1.4523809523809523,10,4
"['0', '0010000', '11', '011101', '111101']",1,5,10,12,2,22,3.646214896214896,42,22
"['1100', '10', '111011']",1,3,4,8,0,12,1.7666666666666666,9,8
"['0101', '000101', '10', '1101100']",1,4,10,9,0,19,3.418104118104118,21,16
"['00011', '000', '1111']",1,3,6,6,0,12,1.1944444444444444,9,10
"['11001', '11011', '111100', '0001', '1001', '10000', '1010111', '00110', '1110110']",1,9,21,27,8,48,21.958691308691307,103,115
"['0110', '111', '111001']",1,3,4,9,0,13,1.838095238095238,8,8
"['0', '0110010', '1010101', '1000010']",1,4,13,9,3,22,2.607142857142857,28,14
"['0001011', '0111001', '0']",1,3,8,7,2,15,1.0714285714285714,15,6
"['01101', '1001', '0110', '101001']",1,4,9,10,2,19,3.778787878787879,13,19
"['0101', '10011', '1101110']",1,3,6,10,0,16,1.8787878787878787,10,7
"['1011', '11010', '101', '000']",1,4,7,8,2,15,3.392857142857143,13,13
"['0', '1110101', '100']",1,3,5,6,0,11,1.35,12,4
"['01111', '111111', '000101', '100000']",1,4,10,13,3,23,2.621212121212121,22,20
"['1', '100101', '1011000', '1110', '0100']",1,5,11,11,2,22,4.905644355644355,34,20
"['0010001', '110110', '00000', '10111', '0101', '011000']",1,6,19,14,4,33,8.317637917637917,46,38
"['01101', '0011', '100100', '0000101', '111111']",1,5,13,15,2,28,5.407925407925408,33,27
"['0', '11011', '111', '10111', '01000']",1,5,7,12,3,19,4.35,32,26
"['001', '00000', '101011', '10', '0000111']",1,5,14,9,0,23,4.598068598068598,36,29
"['01', '010', '0010111', '1000110', '000001']",1,5,15,10,2,25,5.481684981684982,36,24
"['11', '0001', '100', '000', '011010', '101111']",1,6,12,12,4,24,7.295238095238095,45,36
"['11001', '1110010', '1', '111101']",1,4,6,13,0,19,3.198884448884449,21,23
"['111', '101', '000', '1011', '1110110']",1,5,7,13,3,20,5.041558441558442,27,29
"['0', '11011', '11100']",1,3,4,7,2,11,1.2666666666666666,11,6
"['010', '1110000', '011', '000101', '00110', '01010', '0111']",1,7,18,15,4,33,13.577289377289377,60,68
"['01', '100', '011']",1,3,4,4,2,8,1.5333333333333334,6,7
"['101100', '11011', '111', '110001', '10', '011000']",1,6,12,16,3,28,9.11031746031746,44,41
"['0011', '0110', '00', '11111', '101001']",1,5,9,12,2,21,5.2176767676767675,30,20
"['01', '100100', '010010', '1001101', '1000', '110']",1,6,16,12,2,28,8.937162837162838,44,39
"['1100001', '000011', '11']",1,3,8,7,0,15,1.7136752136752138,12,13
"['11011', '00111', '1001', '0010011', '1110101', '11100', '111110', '000111', '1100']",1,9,19,30,9,49,22.32072927072927,109,142
"['1010001', '10100', '0000010', '01010']",1,4,16,8,4,24,4.014285714285714,17,17
"['00', '100101', '10', '00011']",1,4,9,6,2,15,3.0844155844155843,18,13
"['00', '00010', '111001']",1,3,8,5,0,13,1.6168831168831168,11,6
"['0', '1000', '1001100']",1,3,8,4,0,12,1.3772727272727274,12,9
"['110000', '1110011', '01', '11011']",1,4,8,12,0,20,3.26004551004551,21,24
"['0111010', '101011', '1110101', '0000', '0000110']",1,5,16,15,3,31,5.893506493506494,35,24
"['0', '110110', '11010', '011111']",1,4,6,12,2,18,2.8593073593073592,21,18
"['100', '1', '01000']",1,3,6,3,0,9,1.5833333333333333,8,5
"['110', '001111', '001', '001000', '00100', '000111', '1100']",1,7,19,14,5,33,12.245238095238095,62,88
"['10111', '01', '0110', '01010']",1,4,7,9,2,16,3.9650793650793648,14,14
"['0100', '001001', '011000', '11']",1,4,11,7,2,18,3.6,17,14
"['0111001', '011100', '1100010', '00', '0111111', '10010']",1,6,16,18,3,34,8.572316572316572,56,49
"['1011', '100', '0011000']",1,3,8,6,0,14,1.7168831168831167,10,7
"['1010100', '100011', '01110']",1,3,9,9,0,18,1.3403263403263403,10,5
"['110000', '010', '11', '000101', '1100', '0101001']",1,6,16,12,2,28,8.618359418359418,48,42
"['1101', '001', '100000', '110']",1,4,9,7,2,16,3.0507936507936506,18,16
"['100', '110', '11']",1,3,3,5,2,8,1.8666666666666667,4,8
"['001101', '10101', '100', '0001', '011001', '1100', '1110']",1,7,16,16,5,32,13.022727272727273,50,59
"['11', '110100', '011000']",1,3,7,7,2,14,1.8333333333333335,10,7
"['010100', '101', '00', '001']",1,4,9,5,2,14,3.477777777777778,14,16
"['11', '1101', '00000']",1,3,6,5,0,11,0.8888888888888888,11,6
"['01', '10', '11']",1,3,2,4,3,6,1.5,4,6
"['10111', '11000', '001010']",1,3,8,8,2,16,1.4909090909090907,10,6
"['01', '011', '111', '00000', '1100']",1,5,9,8,2,17,4.323015873015873,28,26
"['111', '00011', '10100', '010111', '1100101', '0000', '1001001', '110', '101110']",1,9,22,24,8,46,20.39095349095349,111,103
"['0010', '001111', '011', '10010', '10011', '1010011', '0111110']",1,7,16,21,4,37,13.153807303807303,62,63
"['1000', '1111111', '100', '1000111']",1,4,8,13,2,21,2.9948051948051946,23,26
"['010001', '011', '0011', '01111', '110100', '010101', '000010', '11111']",1,8,19,22,6,41,16.076839826839826,81,85
"['01', '000011', '1101110']",1,3,7,8,0,15,1.4059829059829059,13,7
"['01', '00101', '11', '100100', '00']",1,5,10,7,3,17,4.941558441558442,27,24
"['101', '1101', '000', '0111']",1,4,6,8,4,14,3.083333333333333,13,13
"['001', '1101111', '1']",1,3,3,8,0,11,1.15,13,8
"['100001', '1101101', '01111', '10', '01100', '1110']",1,6,12,17,2,29,8.204850704850704,48,37
"['100', '1111', '000', '00010', '1110']",1,5,10,9,4,19,4.476190476190476,26,30
"['1101011', '001010', '110111', '10', '1100011']",1,5,11,17,4,28,6.169108669108669,33,38
"['111', '101101', '01111', '10', '01010']",1,5,7,14,2,21,5.728354978354979,28,25
"['011', '1001', '1100100', '10011', '001100', '0101']",1,6,15,14,2,29,10.032844932844933,42,40
"['011', '0011', '1010101', '1000', '1010010']",1,5,13,12,4,25,6.245454545454545,30,28
"['00', '100100', '110']",1,3,7,4,0,11,1.3444444444444446,9,8
"['0100010', '100110', '00', '0010']",1,4,13,6,0,19,3.9076146076146077,18,25
"['001101', '0010000', '1010100', '01111', '0110011']",1,5,17,15,3,32,5.943389943389944,31,29
"['100', '100011', '000', '000010', '0100011', '110']",1,6,18,10,5,28,8.95897435897436,43,45
"['11011', '0001110', '001', '11', '001000', '010110', '01110', '0101001']",1,8,21,20,6,41,16.13048618048618,88,80
"['01', '0111010', '1000110', '1010111', '1010', '00110']",1,6,15,17,3,32,9.221500721500721,49,45
"['1010000', '111110', '1111']",1,3,6,11,0,17,1.4713286713286715,11,12
"['1000011', '011011', '0000110']",1,3,11,9,2,20,1.934065934065934,8,6
"['0110', '00', '1101', '0110110', '0100']",1,5,11,10,3,21,6.292929292929293,26,34
"['1010', '00', '1101']",1,3,5,5,2,10,1.75,7,4
"['01', '0111001', '000011', '1101011', '10110', '0000010', '000', '0111']",1,8,22,19,3,41,14.713686313686313,99,78
"['1010', '100', '10010', '1']",1,4,7,6,0,13,3.7293650793650794,13,18
"['011110', '001011', '01000']",1,3,9,8,2,17,1.5909090909090908,9,10
"['1111100', '11000', '101', '10101', '000010', '1011', '00010']",1,7,18,17,3,35,11.60069375069375,66,62
"['0010', '1011', '01001', '000111', '01100']",1,5,13,11,4,24,6.217171717171717,27,23
"['0011001', '1010110', '1']",1,3,7,8,2,15,1.2142857142857144,16,6
"['001110', '100101', '1']",1,3,6,7,2,13,1.2380952380952381,13,4
"['010011', '1', '10']",1,3,4,5,0,9,1.4523809523809523,10,6
"['00011', '00000', '1100001', '10110', '000111']",1,5,17,11,3,28,6.0487179487179485,29,33
"['11110', '101010', '1101100', '010111', '1110']",1,5,10,18,2,28,5.8947163947163945,25,34
"['0011', '00100', '101', '110100', '10010']",1,5,13,10,2,23,6.4759740259740255,24,28
"['1001', '1', '110']",1,3,3,5,0,8,1.4714285714285715,7,8
"['00001', '000', '1011111']",1,3,8,7,0,15,1.2833333333333332,13,8
"['110000', '1000110', '1101011', '11']",1,4,10,12,2,22,3.487789987789988,23,23
"['00111', '0001', '0101', '010111']",1,4,9,10,2,19,3.9424242424242424,11,20
"['011', '11000', '1001000', '01010', '011110']",1,5,14,12,2,26,5.997086247086247,30,31
"['0', '10101', '0100101']",1,3,7,6,0,13,1.4166666666666667,12,7
"['0', '10111', '00011']",1,3,5,6,2,11,1.2666666666666666,10,5
"['01', '0011001', '001010', '10', '1100', '1110']",1,6,13,12,4,25,7.980846930846931,47,39
"['0001110', '10001', '1', '1001010']",1,4,11,9,2,20,3.0476190476190474,24,13
"['1', '1110000', '10001', '0111', '01000']",1,5,12,10,2,22,4.884343434343434,36,23
"['100', '1000111', '11101', '010110', '110', '111101']",1,6,11,19,4,30,9.074397824397824,46,47
"['111010', '100', '01111', '110011', '1011']",1,5,8,16,2,24,6.160822510822511,27,34
"['11110', '1110000', '101010', '0110', '1000', '011010']",1,6,16,16,4,32,8.957031857031858,39,49
"['101', '1', '100010']",1,3,5,5,0,10,1.4523809523809523,10,9
"['1000001', '111011', '100011', '10', '1010001']",1,5,14,14,4,28,5.885225885225886,32,46
"['1100111', '10', '011']",1,3,4,8,0,12,1.4444444444444444,11,8
"['1100', '1010101', '1']",1,3,5,7,0,12,1.1954545454545453,12,8
"['0001', '001010', '110100']",1,3,10,6,2,16,1.6666666666666665,9,9
"['101', '1000010', '00', '1100', '01100']",1,5,13,8,0,21,5.688311688311688,30,26
"['110000', '111111', '110', '00101']",1,4,8,12,2,20,2.6717171717171717,22,19
"['1010', '100100', '110100']",1,3,9,7,2,16,2.4333333333333336,5,10
"['1011', '0110', '001101', '11']",1,4,6,10,2,16,3.9833333333333334,15,12
"['0100010', '1', '10']",1,3,6,4,0,10,1.3611111111111112,12,5
"['0', '1101000', '100']",1,3,7,4,0,11,1.35,12,7
"['1000100', '1100001', '1', '10']",1,4,10,7,2,17,2.7698412698412698,26,15
"['0010', '011', '10000', '0001111', '1110101', '000', '110']",1,7,17,15,5,32,11.362337662337662,70,62
"['010', '001111', '10111', '110001', '0101011', '1111000', '0001111', '0111111', '110', '01100']",1,10,22,34,10,56,25.584282384282385,153,149
"['010100', '110000', '00']",1,3,10,4,2,14,1.6666666666666665,10,13
"['0', '110110', '1001110', '101', '111110', '110111', '1100', '0011100']",1,8,15,25,5,40,15.415706515706516,91,79
"['1010000', '1110000', '0001111']",1,3,12,9,3,21,1.7142857142857142,14,16
"['00100', '00110', '11', '0000']",1,4,11,5,2,16,3.212698412698413,15,21
"['110001', '100', '1']",1,3,5,5,0,10,1.4523809523809523,10,8
"['011011', '11110', '10', '0111100']",1,4,7,13,0,20,3.663891663891664,20,16
"['0100110', '01011', '01010', '11']",1,4,9,10,2,19,4.053968253968254,16,20
"['1101111', '101', '0011010', '0110000', '0000', '011010', '01000']",1,7,22,17,3,39,12.18951048951049,69,70
"['11110', '0111001', '001', '000010']",1,4,11,10,0,21,3.1623543123543123,22,16
"['01101', '0110', '10011']",1,3,6,8,2,14,2.1555555555555554,7,7
"['1000', '0101', '0101000', '11']",1,4,10,7,2,17,3.398989898989899,19,16
"['1000', '001', '10010', '111']",1,4,8,7,2,15,3.329365079365079,13,15
"['0111000', '110110', '1111000', '10', '1100']",1,5,12,14,2,26,6.398013098013098,32,32
"['010111', '111', '0011100', '011000']",1,4,10,12,2,22,3.7495726495726496,20,17
"['01', '111100', '01011']",1,3,5,8,0,13,1.185064935064935,12,8
"['11000', '1011100', '11111', '1011', '0100']",1,5,10,15,4,25,5.298989898989899,29,30
"['010', '111', '0001', '0010011', '0111111', '0000', '1000011', '011010']",1,8,21,20,7,41,14.324558774558774,95,78
"['0010101', '0011111', '000']",1,3,9,8,2,17,1.7142857142857144,11,12
"['101', '111110', '0001000']",1,3,8,8,0,16,1.152136752136752,14,4
"['110000', '0010', '10011', '0000']",1,4,13,6,2,19,3.6065656565656568,14,20
"['101', '10100', '010', '1100']",1,4,8,7,2,15,4.198412698412699,11,14
"['0', '001', '1110100', '1101100']",1,4,9,9,2,18,2.657142857142857,26,17
"['11011', '001111', '10111', '0001', '1001', '10011', '01010', '0101']",1,8,16,22,7,38,18.32323232323232,63,84
"['0', '11010', '1001', '1110110', '001011', '01100']",1,6,13,15,2,28,8.087462537462537,50,33
"['0001010', '10101', '011', '1101']",1,4,9,10,0,19,3.80021645021645,16,13
"['1101001', '100', '1111110', '0']",1,4,7,11,2,18,2.4285714285714284,27,11
"['001000', '1010100', '1111010', '1101', '0000110']",1,5,17,14,3,31,5.35004995004995,35,26
"['101100', '01', '0101110', '0100010', '101000', '0011', '0001111', '1010', '10100', '0111']",1,10,27,25,8,52,27.49757464757465,137,135
"['0', '101100', '01', '1111001']",1,4,7,9,0,16,2.916056166056166,23,11
"['1110000', '11', '00', '11101', '1000', '10011']",1,6,12,13,4,25,7.293939393939394,48,49
"['100', '010001', '1', '00001']",1,4,10,5,0,15,3.1948051948051948,18,16
"['00010', '11101', '1101010']",1,3,8,9,2,17,1.5666666666666667,9,7
"['11010', '001', '100001', '1', '0110', '000111']",1,6,13,12,2,25,7.6337662337662335,49,33
"['010100', '11100', '1', '1000010']",1,4,11,8,0,19,2.557858807858808,25,12
"['100', '110', '10']",1,3,4,4,2,8,2.2666666666666666,3,8
"['00', '110100', '0001000']",1,3,11,4,0,15,1.5598290598290598,12,16
"['1000101', '111010', '00111', '00', '1100011']",1,5,13,14,2,27,5.927017427017427,35,26
"['01', '0100000', '000']",1,3,10,2,0,12,1.4444444444444444,11,13
"['1011', '101', '111']",1,3,2,8,2,10,2.095238095238095,3,16
"['0', '000110', '00100', '01010']",1,4,12,5,2,17,3.206926406926407,19,27
"['00011', '00100', '1100001', '01111', '1111', '0100101']",1,6,16,17,5,33,8.794083694083694,46,45
"['0', '111110', '001']",1,3,4,6,0,10,1.007936507936508,12,6
"['1100', '110111', '0111']",1,3,4,10,2,14,1.9,8,14
"['01', '00100', '11110']",1,3,6,6,2,12,1.2571428571428571,10,6
"['11001', '01', '011', '1111']",1,4,4,10,0,14,3.4428571428571426,14,21
"['00111', '0010', '1000101']",1,3,9,7,0,16,2.0606060606060606,8,6
"['011011', '001100', '10010', '0000000']",1,4,16,8,2,24,3.3624708624708624,21,18
"['0011', '000111', '101101']",1,3,7,9,2,16,2.0666666666666664,8,8
"['0', '00100', '1110']",1,3,6,4,0,10,1.1777777777777778,10,8
"['11001', '0001110', '100101', '10', '0111', '000']",1,6,14,13,0,27,8.138184038184038,49,34
"['0010', '111010', '10011']",1,3,7,8,0,15,1.6303030303030304,8,7
"['001', '10111', '10100', '00', '110']",1,5,9,9,4,18,4.9904761904761905,26,26
"['0111000', '00001', '10001', '1010000', '00010']",1,5,20,9,5,29,6.614285714285714,29,35
"['101100', '010101', '0000', '0001010', '1100']",1,5,17,10,4,27,6.042191142191142,28,35
"['0100111', '10101', '10', '1011', '111001']",1,5,9,15,0,24,6.408025308025308,30,35
"['11001', '01', '10', '0100100']",1,4,9,7,2,16,3.198412698412698,21,12
"['00', '001', '110']",1,3,5,3,2,8,1.5333333333333334,6,8
"['0010', '1100', '001010', '10110']",1,4,11,8,2,19,3.9606060606060605,14,23
"['1010100', '1', '0100011']",1,3,8,7,2,15,1.0714285714285714,16,6
"['11001', '1110', '10101', '1000010', '100011', '1101', '101001', '1111011']",1,8,18,26,8,44,18.23031968031968,70,123
"['10100', '11110', '010111']",1,3,6,10,2,16,1.4909090909090907,8,8
"['011101', '011100', '0110', '101001']",1,4,10,12,3,22,4.2,14,19
"['010', '10010', '01011']",1,3,7,6,2,13,2.1,7,10
"['101', '10100', '011', '1110']",1,4,6,9,2,15,3.503968253968254,13,15
"['00100', '1', '00001']",1,3,8,3,2,11,1.2666666666666666,10,6
"['1100010', '001', '1011', '11111']",1,4,7,12,0,19,2.7295093795093797,20,19
"['1001000', '10111', '001111', '11']",1,4,8,12,0,20,3.2046842046842046,22,22
"['00111', '00010', '1000', '11']",1,4,9,7,2,16,2.9015873015873015,18,16
"['01', '1001', '0010101', '10100', '000000']",1,5,16,8,0,24,5.19034854034854,33,27
"['110000', '11110', '10001', '1']",1,4,8,9,2,17,2.625108225108225,22,15
"['1000100', '1000', '00101', '01110']",1,4,13,8,2,21,3.216161616161616,19,18
"['1100010', '0000010', '10', '1001100', '1101', '1110']",1,6,17,14,5,31,8.546536796536797,53,43
"['11011', '0001', '0100001', '1001001', '110']",1,5,14,12,2,26,5.433838383838384,32,32
"['0', '111100', '0001', '1100100', '01001']",1,5,13,10,0,23,4.9308968808968805,37,27
"['0111000', '01', '011', '11111']",1,4,6,11,0,17,3.13015873015873,21,16
"['0100001', '010', '01111', '00000']",1,4,13,7,2,20,2.966666666666667,20,18
"['1', '10011', '000']",1,3,5,4,0,9,0.8333333333333333,10,4
"['001', '1010', '1100111', '110', '01100']",1,5,10,12,2,22,5.8049783549783545,30,23
"['0011', '000110', '100110']",1,3,9,7,2,16,2.4333333333333336,5,11
"['01', '1100101', '10011', '000', '1001001', '0010010']",1,6,18,13,3,31,9.366666666666667,49,35
"['10100', '10101', '000111', '1']",1,4,8,9,2,17,2.6614718614718615,21,18
"['01', '000011', '11', '0011', '1001011']",1,5,10,11,2,21,5.864879564879565,30,36
"['0111000', '0001000', '0110000', '1011', '1100', '0011100']",1,6,22,14,6,36,9.798701298701298,48,64
"['0011000', '00', '10', '01000', '0110011']",1,5,15,8,4,23,5.634920634920634,35,37
"['0', '11101', '1101111', '1000111']",1,4,6,14,2,20,2.7142857142857144,25,20
"['0000110', '11110', '010111']",1,3,8,10,0,18,1.6608391608391608,10,10
"['11001', '1', '000', '110100']",1,4,8,7,0,15,2.290764790764791,20,14
"['1100111', '000110', '1']",1,3,6,8,0,14,1.151098901098901,14,4
"['11010', '00101', '00001', '110111', '10011', '1010000', '01001', '110', '0100']",1,9,24,21,5,45,21.16933066933067,98,100
"['0', '00110', '10000']",1,3,8,3,2,11,1.2666666666666666,11,9
"['1011001', '00', '0110']",1,3,7,6,0,13,1.8383838383838382,10,4
"['0', '110101', '110', '0010011']",1,4,8,9,0,17,2.717765567765568,25,14
"['1100011', '1', '10']",1,3,4,6,0,10,1.3611111111111112,12,8
"['0011', '0001', '000010', '1011111']",1,4,11,10,2,21,3.366783216783217,20,15
"['01001', '010', '0100101', '00000']",1,4,14,6,2,20,3.5833333333333335,16,23
"['0', '0111010', '011011', '101000', '0001', '1110']",1,6,14,14,4,28,6.846953046953047,54,38
"['010011', '01101', '011', '01100']",1,4,9,10,2,19,4.239393939393939,13,24
"['1', '110100', '1101110']",1,3,5,9,0,14,1.304945054945055,13,9
"['1011010', '101100', '1111', '010110', '001011', '1110']",1,6,13,20,5,33,9.863752913752915,39,44
"['11', '10101', '1001', '10', '000', '1101', '1100']",1,7,11,13,5,24,12.443650793650793,42,61
"['11000', '1101101', '0111111', '000', '11111', '011111', '0110010']",1,7,14,26,5,40,11.855938505938505,69,81
"['1011', '110', '10']",1,3,3,6,0,9,2.038095238095238,5,9
"['0011', '011', '10', '1011111']",1,4,5,11,0,16,3.1803751803751803,19,17
"['1101', '10000', '101101']",1,3,7,8,0,15,1.7898989898989899,8,12
"['000110', '010011', '1', '0110']",1,4,9,8,2,17,3.204761904761905,20,14
"['1', '0010000', '00100', '1010101', '000', '01110', '1111011']",1,7,19,16,5,35,9.428571428571429,81,53
"['010001', '1110000', '11', '1001', '0101100', '0101']",1,6,16,14,4,30,9.352941502941503,50,42
"['11001', '100101', '1', '0100']",1,4,8,8,0,16,3.012987012987013,19,13
"['11', '10101', '01111', '001110', '001100', '01000']",1,6,14,15,5,29,8.316450216450216,44,36
"['10101', '1010100', '1100100']",1,3,10,9,2,19,2.357142857142857,7,13
"['010011', '010', '0011111']",1,3,7,9,0,16,1.682051282051282,11,9
"['0', '010011', '0001101', '100010']",1,4,12,8,2,20,2.85989010989011,25,12
"['010100', '111100', '011', '0000', '00010']",1,5,15,9,2,24,5.1614718614718615,28,40
"['101101', '11', '100011', '01010', '1100']",1,5,10,13,2,23,6.044155844155844,30,26
"['00110', '111110', '110001']",1,3,7,10,2,17,1.5909090909090908,11,7
"['1101', '01001', '1110', '11']",1,4,5,10,2,15,3.765873015873016,14,20
"['1101001', '0010111', '000']",1,3,9,8,2,17,1.5714285714285714,12,7
"['011111', '01111', '011']",1,3,3,11,0,14,2.3257575757575757,6,19
"['010100', '00100', '01001', '101001']",1,4,14,8,4,22,4.906060606060606,10,20
"['00001', '11011', '10', '11']",1,4,6,8,4,14,2.6142857142857143,18,18
"['1', '110', '000']",1,3,4,3,2,7,0.8333333333333333,7,4
"['11110', '1111101', '011', '00000', '100000', '01001']",1,6,16,15,3,31,6.7480963480963485,54,43
"['0', '011011', '101000', '1101000', '0000110']",1,5,16,11,4,27,4.615384615384616,43,32
"['001', '00100', '1110101', '0110000', '0111', '00010', '0000110']",1,7,23,15,5,38,12.201443001443002,70,71
"['1010111', '00010', '001']",1,3,8,7,0,15,1.65,10,5
"['11110', '10100', '01111', '10']",1,4,6,11,3,17,3.0285714285714285,18,17
"['1000001', '101000', '000111', '1000011']",1,4,16,10,4,26,3.9725274725274726,16,23
"['010001', '100', '0110', '010010', '111111', '0111110', '1110']",1,7,15,21,5,36,11.849111999111999,65,65
"['0', '110001', '11']",1,3,4,5,0,9,0.7857142857142857,11,6
"['0011', '1001', '110', '11']",1,4,5,8,2,13,4.026190476190476,12,19
"['11010', '100', '01001']",1,3,7,6,2,13,2.1,7,6
"['101', '10111', '1100', '1011010']",1,4,7,12,0,19,3.9264790764790765,16,22
"['011010', '110', '101110', '0111']",1,4,7,12,2,19,4.338095238095238,14,19
"['01', '11010', '10111', '11101', '00010']",1,5,9,13,4,22,5.685714285714286,28,25
"['0', '111010', '11111', '010011', '1010011']",1,5,9,16,2,25,4.284132534132534,36,33
"['101', '100', '10', '011']",1,4,5,6,3,11,3.6666666666666665,10,15
"['0011', '1111010', '0101', '000101']",1,4,10,11,2,21,3.7206293706293705,19,17
"['00100', '1011', '0100100', '11']",1,4,10,8,0,18,3.22005772005772,20,15
"['01111', '010', '10110']",1,3,5,8,2,13,1.85,8,8
"['1101', '00', '001011']",1,3,6,6,0,12,1.4333333333333333,10,7
"['0010', '01', '001000', '01111', '111111', '1010', '0101100', '1100110']",1,8,19,22,6,41,15.18936618936619,93,79
"['1011', '11110', '11101', '0110']",1,4,5,13,4,18,3.9944444444444445,12,16
"['00', '010000', '111']",1,3,7,4,0,11,0.7222222222222222,12,6
"['0110101', '0111010', '1', '0000']",1,4,10,9,2,19,2.448051948051948,26,12
"['0111101', '10000', '1001']",1,3,8,8,0,16,1.3636363636363635,11,9
"['0010', '111', '101', '10010', '000', '1101']",1,6,11,11,5,22,8.769841269841269,30,36
"['1010110', '010', '01110']",1,3,7,8,0,15,2.0166666666666666,8,13
"['10001', '100', '1100', '110100', '1110110', '11100']",1,6,14,16,2,30,10.681929181929181,35,54
"['00110', '001', '1110']",1,3,6,6,0,12,1.7023809523809523,7,10
"['11110', '0011', '000', '0101001', '0111110', '01110']",1,6,14,17,4,31,8.361544011544012,46,54
"['110000', '101100', '0110', '111000', '110', '0101001', '110101']",1,7,19,19,4,38,14.1998001998002,57,57
"['01', '1011', '1000']",1,3,5,5,2,10,1.5,7,7
"['0', '1010', '001']",1,3,5,3,0,8,1.4714285714285715,7,6
"['010100', '1101101', '0111011', '0111100']",1,4,11,16,3,27,4.0,17,18
"['0', '001011', '11']",1,3,4,5,0,9,0.7857142857142857,11,6
"['101100', '11', '101', '1000110', '1010101', '1000', '001010', '011001', '010011']",1,9,24,23,6,47,23.04196914196914,112,98
"['01101', '1', '10111', '10101', '00010']",1,5,9,12,4,21,5.133333333333333,30,24
"['11111', '10', '1111011']",1,3,2,12,0,14,1.5634920634920635,11,16
"['0100000', '000001', '0111', '0110011']",1,4,15,9,2,24,3.446953046953047,20,21
"['0110101', '1001', '0', '11']",1,4,6,8,0,14,2.124747474747475,21,11
"['010', '111100', '111', '0101101', '10100', '0111110', '111001']",1,7,14,23,6,37,12.834093684093684,65,56
"['111010', '01111', '000001', '001100', '0101001']",1,5,16,14,3,30,5.6491841491841495,33,27
"['0', '10100', '0011000']",1,3,9,4,0,13,1.25,13,10
"['0011', '0010', '100']",1,3,7,4,2,11,1.8928571428571428,6,10
"['101101', '1001111', '111']",1,3,4,12,0,16,2.0358974358974358,9,17
"['0111000', '0010', '111', '101', '100100']",1,5,12,11,2,23,5.595759795759796,32,20
"['110110', '0101000', '11', '00011', '00']",1,5,12,10,2,22,4.6925851925851925,36,29
"['10000', '1100100', '000']",1,3,11,4,0,15,2.1833333333333336,8,13
"['000100', '11011', '1001010', '11000', '010010', '1010', '001001']",1,7,23,16,5,39,13.72051282051282,55,57
"['1', '011', '010111']",1,3,3,7,0,10,1.4523809523809523,10,8
"['1011', '01', '101100']",1,3,5,7,0,12,1.9666666666666668,8,9
"['1111010', '010011', '00000']",1,3,10,8,0,18,1.1585081585081585,12,7
"['101', '010101', '01000', '11']",1,4,8,8,0,16,3.47965367965368,17,14
"['11110', '010', '0101110', '011', '101']",1,5,8,13,3,21,6.133333333333333,28,28
"['111100', '101101', '0011', '010101', '1011', '0100']",1,6,13,17,6,30,9.35,38,43
"['101010', '01', '10011', '000']",1,4,9,7,0,16,3.365367965367965,17,11
"['01', '1', '000101', '000011']",1,4,9,6,2,15,3.071428571428571,21,15
"['1101001', '11', '10110', '000101', '110011']",1,5,11,15,2,26,5.686036186036186,33,36
"['0000101', '000', '1110']",1,3,9,5,0,14,1.2493506493506494,12,10
"['100', '010010', '011110', '0000']",1,4,12,7,2,19,3.349206349206349,17,22
"['110', '100101', '001101']",1,3,7,8,2,15,1.9444444444444444,8,8
"['0111001', '100', '1111000', '1010', '00', '1100', '1110']",1,7,15,16,5,31,13.555555555555555,56,58
"['0010110', '11000', '111', '000']",1,4,10,8,2,18,2.75,20,19
"['101', '0101', '111100', '1111']",1,4,5,12,2,17,3.5730158730158728,15,22
"['101', '001', '1011001', '0100111']",1,4,9,11,4,20,3.780952380952381,21,20
"['01', '011', '00001', '0000000', '0100']",1,5,16,5,0,21,5.0064935064935066,32,35
"['0011', '1100001', '1001', '1000010', '10']",1,5,14,10,4,24,6.041486291486291,33,30
"['0001', '1', '0100']",1,3,6,3,2,9,1.3,8,5
"['110000', '00', '1010', '10011', '1011']",1,5,11,10,2,21,5.922438672438672,26,28
"['0', '010', '11000', '1010', '01110']",1,5,10,8,2,18,5.384920634920634,26,31
"['0110101', '0101', '000', '01110']",1,4,10,9,0,19,3.898701298701299,16,21
"['11001', '00011', '11', '100011', '01110']",1,5,10,13,3,23,6.196103896103896,29,32
"['01101', '0011001', '00', '0001011', '110']",1,5,13,11,2,24,5.657936507936508,33,27
"['1000011', '010', '1110']",1,3,7,7,0,14,1.335064935064935,12,6
"['0100110', '011', '0010101', '0000', '110']",1,5,14,10,4,24,5.425108225108225,34,28
"['10011', '010', '10', '010000']",1,4,10,6,0,16,3.5835497835497834,17,14
"['010100', '01', '0110']",1,3,7,5,0,12,1.9666666666666668,8,11
"['101', '01011', '11']",1,3,3,7,0,10,2.1214285714285714,6,10
"['0', '1010', '11010']",1,3,5,5,0,10,1.6222222222222222,8,9
"['010', '111100', '00', '10', '1011']",1,5,8,9,2,17,5.515873015873016,25,23
"['11', '00', '10110', '00011']",1,4,7,7,4,14,2.8857142857142857,17,14
"['0001100', '11011', '101110', '1111011']",1,4,9,16,2,25,3.71994671994672,20,17
"['00101', '00011', '101', '0000', '1110', '1101010']",1,6,15,13,4,28,8.236940836940837,44,41
"['100', '1', '01011', '011110']",1,4,6,9,0,15,2.6089466089466087,20,11
"['01', '1101', '000']",1,3,5,4,0,9,1.3523809523809525,7,5
"['0001101', '00', '1000', '1']",1,4,9,5,0,14,2.3065656565656565,22,16
"['00100', '10100', '10010', '1010110']",1,4,13,9,3,22,4.566666666666666,12,22
"['1110', '000', '1011111']",1,3,5,9,0,14,1.0311688311688312,13,6
"['0001011', '10010', '111']",1,3,7,8,0,15,1.5666666666666667,10,8
"['0000101', '101', '110101']",1,3,8,8,0,16,1.882051282051282,10,15
"['011111', '11010', '1100', '000000']",1,4,11,10,2,21,2.5828282828282827,21,18
"['0111000', '001', '000011', '010010', '0011010', '0110001']",1,6,22,14,5,36,9.731868131868133,47,52
"['0', '101011', '111011', '1111', '1010']",1,5,6,15,4,21,4.904761904761905,29,35
"['0110101', '0111001', '111', '011010']",1,4,9,14,2,23,4.273260073260073,17,20
"['011010', '001101', '1110']",1,3,7,9,2,16,2.033333333333333,7,7
"['10111', '011', '111', '0101100']",1,4,6,12,2,18,3.833333333333333,16,18
"['1101001', '0', '010001', '101011', '1101100', '011101', '0110000', '1100111']",1,8,22,25,7,47,15.833333333333334,102,74
"['101010', '1001110', '001011']",1,3,9,10,2,19,2.051282051282051,7,8
"['011011', '0001', '00110', '111110', '0111', '0100']",1,6,13,16,5,29,8.05050505050505,41,45
"['0', '1111000', '111111', '0111', '1010011', '00010']",1,6,12,18,2,30,6.045010545010545,61,44
"['011111', '1011', '0111111', '101']",1,4,4,16,0,20,3.77011877011877,18,27
"['010', '011101', '10', '0001010', '011010']",1,5,13,11,2,24,6.395726495726496,31,40
"['00111', '100100', '000', '01110']",1,4,11,8,2,19,3.375757575757576,17,19
"['0010110', '001111', '000', '01100']",1,4,12,9,0,21,3.525796425796426,18,28
"['01000', '1010', '001001', '0111']",1,4,11,8,2,19,3.5383838383838384,16,14
"['01101', '01', '001', '11']",1,4,5,7,2,12,3.342857142857143,12,16
"['11100', '100101', '011100']",1,3,8,9,2,17,1.9545454545454546,8,8
"['1', '100', '0111', '01001', '01100']",1,5,9,9,2,18,5.485714285714286,26,24
"['011101', '00010', '110', '11001']",1,4,9,10,2,19,3.789393939393939,16,14
"['1000010', '00', '0101']",1,3,9,4,0,13,1.6565656565656566,11,6
"['000110', '01', '101', '100', '1100000', '0010100', '1101', '1110110']",1,8,21,18,5,39,15.994372294372294,96,75
"['0', '101', '000111', '01111']",1,4,6,9,0,15,2.790764790764791,20,12
"['01001', '0101', '1111000', '00000']",1,4,13,8,2,21,3.0969696969696967,19,19
"['0011', '10011', '000', '00010', '1001111']",1,5,13,11,2,24,6.437590187590187,26,32
"['01', '0011101', '01100', '10000', '01001', '1001011']",1,6,17,14,5,31,8.531746031746032,52,39
"['1100011', '1', '010100', '01110']",1,4,9,10,0,19,2.7117049617049616,26,9
"['0', '0111001', '011000']",1,3,8,6,0,14,1.304945054945055,13,10
"['011011', '10000', '11']",1,3,6,7,0,13,1.1493506493506493,12,8
"['0', '0011', '0001', '1001']",1,4,8,5,3,13,3.45,13,13
"['011', '0001', '100011', '01001', '11100']",1,5,12,11,2,23,6.494155844155844,27,28
"['101', '100', '1101100', '00', '0101', '111101']",1,6,11,14,2,25,8.728299478299478,43,42
"['0110101', '1001', '10', '111011']",1,4,7,12,0,19,3.3439782439782437,19,16
"['0', '111100', '00101', '1111101']",1,4,7,12,0,19,2.501914751914752,25,16
"['1', '110001', '010010', '10011', '110']",1,5,10,11,2,21,5.137085137085137,32,25
"['1000001', '011', '11', '100', '101111']",1,5,9,12,2,21,5.05042735042735,35,35
"['0011', '00', '010', '1111']",1,4,6,7,2,13,2.8238095238095235,14,14
"['0', '1111010', '001000']",1,3,8,6,0,14,0.9972527472527473,15,8
"['0', '01011', '01110']",1,3,5,6,2,11,1.2666666666666666,10,9
"['00', '110', '0110', '1110']",1,4,6,7,2,13,3.8642857142857143,10,21
"['0101000', '100111', '1']",1,3,7,7,0,14,0.9972527472527473,16,4
"['10101', '00', '1100']",1,3,6,5,0,11,1.9047619047619047,7,6
"['010', '00000', '11']",1,3,7,3,0,10,0.9,10,4
"['001000', '111010', '00011']",1,3,10,7,2,17,1.4090909090909092,10,10
"['0', '100001', '11']",1,3,5,4,0,9,0.7857142857142857,11,4
"['001', '1', '1111101']",1,3,3,8,0,11,1.15,13,9
"['0010', '11', '1001', '01001', '101001']",1,5,11,10,2,21,6.686075036075036,24,31
"['11110', '101', '0010011', '00', '0111']",1,5,9,12,0,21,4.68037518037518,33,24
"['0000111', '101110', '001000']",1,3,11,8,2,19,1.576923076923077,11,9
"['0010', '001', '1', '110100']",1,4,8,6,0,14,3.087301587301587,18,14
"['010011', '00010', '010', '1']",1,4,9,6,0,15,3.081168831168831,18,14
"['101', '0011', '11']",1,3,3,6,0,9,2.038095238095238,5,10
"['0000110', '1001111', '01110', '1110']",1,4,10,13,2,23,3.8845598845598843,18,19
"['00100', '1101000', '110001', '10000', '1101']",1,5,16,11,2,27,6.391452991452992,26,32
"['0010', '11', '100', '0001101', '1110110']",1,5,11,12,2,23,5.0378066378066375,37,24
"['10100', '00010', '0000110', '011']",1,4,13,7,2,20,3.3666666666666667,19,19
"['0', '0111011', '00001']",1,3,7,6,0,13,0.9166666666666666,14,6
"['110000', '111', '11101', '001010', '000111']",1,5,12,14,3,26,5.608585858585858,35,36
"['0', '01', '1110010', '01100']",1,4,8,7,0,15,2.9325396825396823,22,15
"['0010', '01111', '0000101', '10100', '0100001', '0100']",1,6,20,12,6,32,9.020851370851371,46,46
"['1001010', '001', '01100', '1011111']",1,4,10,12,2,22,2.9285714285714284,22,12
"['111110', '010', '1001000', '1111']",1,4,8,12,0,20,2.8014874014874014,22,17
"['010000', '0110111', '101', '1111110', '01010', '1011', '11100', '0110001', '0100']",1,9,22,26,7,48,20.845027195027196,114,101
"['00011', '00000', '1001001', '1100', '1001011']",1,5,17,11,4,28,5.9369408369408365,29,33
"['01111', '001101', '01010']",1,3,7,9,2,16,2.0545454545454547,7,7
"['10001', '1100', '01000']",1,3,9,5,2,14,2.1333333333333333,6,5
"['0', '00101', '0100', '110101']",1,4,9,7,0,16,3.012987012987013,19,14
"['0010110', '01101', '001', '1111', '010101', '0000']",1,6,15,14,2,29,7.966777666777666,43,39
"['0101', '001', '10', '011110']",1,4,7,8,0,15,3.1825396825396823,16,15
"['01', '010000', '0001110', '0011101', '10100', '0111100']",1,6,19,15,3,34,8.61005661005661,53,52
"['100011', '1100110', '00000']",1,3,11,7,0,18,1.8146853146853146,9,5
"['111100', '1110011', '1111', '1010', '10010', '0111', '1011', '1101']",1,8,12,26,5,38,17.865190365190365,68,112
"['01', '1', '001101']",1,3,4,5,0,9,1.4523809523809523,10,7
"['001', '101', '010110', '101111', '1101010']",1,5,10,15,4,25,5.94017094017094,30,23
"['1010', '01', '011']",1,3,4,5,0,9,2.038095238095238,5,7
"['11', '10101', '1001', '10000', '0100100', '000']",1,6,16,10,2,26,8.772510822510823,41,38
"['00010', '01001', '111', '11010']",1,4,9,9,3,18,3.5,16,14
"['001', '100111', '0000111', '1011', '010011']",1,5,12,14,2,26,7.022011322011322,26,34
"['0', '0011111', '01101', '101010']",1,4,8,11,0,19,2.5427072927072927,25,12
"['0110', '011', '0111']",1,3,4,7,2,11,2.4642857142857144,3,13
"['11110', '111010', '101011', '1100100', '1000010', '00', '011001']",1,7,19,20,5,39,11.691919191919192,70,54
"['0100000', '001', '111', '0100010', '1000']",1,5,16,8,4,24,5.102164502164502,34,26
"['01', '11', '1011101', '100', '00', '1010010']",1,6,11,12,5,23,7.180952380952381,50,35
"['1011101', '0010100', '0111', '1101', '0100']",1,5,12,14,5,26,5.8896103896103895,30,25
"['0', '01111', '1100100', '0110', '010111', '010110', '111000', '110101']",1,8,18,23,4,41,15.096819846819846,94,84
"['0', '0010', '11010']",1,3,6,4,0,10,1.4,9,10
"['0001001', '101', '011101', '10100', '1001001', '0101', '110']",1,7,18,17,4,35,13.533150183150184,57,67
"['1000101', '00101', '1110101', '110011', '00', '001110']",1,6,16,17,4,33,9.565046065046065,49,44
"['00011', '0111', '1111']",1,3,4,9,2,13,1.8611111111111112,6,13
"['10100', '001', '11']",1,3,5,5,0,10,1.4714285714285715,8,7
"['0', '1011', '1010', '10011']",1,4,6,8,2,14,3.4388888888888887,14,16
"['11000', '1', '011']",1,3,4,5,0,9,1.3333333333333333,10,7
"['1101011', '10011', '01011', '1110', '0100']",1,5,10,15,4,25,6.27979797979798,26,34
"['0010', '0000100', '1111', '1101110', '0111', '0101', '110', '01110']",1,8,17,21,6,38,16.368326118326117,79,86
"['110', '10010', '1', '0111100']",1,4,7,9,0,16,2.683333333333333,22,11
"['1', '00101', '0111100']",1,3,6,7,0,13,0.9166666666666666,14,5
"['0100011', '011', '1001101', '11']",1,4,8,11,2,19,3.6031746031746033,22,21
"['011101', '0010100', '10']",1,3,8,7,0,15,1.5598290598290598,12,6
"['101000', '100', '1', '111110']",1,4,7,9,2,16,2.515873015873016,22,14
"['1000100', '111', '0111011', '0101011', '1011']",1,5,11,17,3,28,5.828571428571428,34,39
"['10101', '0110', '0011010', '101110', '01000', '110101']",1,6,16,17,4,33,9.937451437451438,39,38
"['0110010', '0011', '01', '11110']",1,4,8,10,0,18,2.886724386724387,21,15
"['011111', '01', '110', '10011']",1,4,5,11,0,16,2.961327561327561,19,16
"['1111100', '00011', '1011101', '1100', '0110110']",1,5,12,18,3,30,5.777777777777778,35,26
"['110011', '110', '1100110', '0111']",1,4,7,13,0,20,3.9066267066267066,17,29
"['11100', '01001', '1']",1,3,5,6,2,11,1.2666666666666666,11,6
"['11110', '0111011', '1100000', '10100', '1010', '00', '1011000']",1,7,19,18,5,37,11.956277056277056,71,63
"['1010', '010101', '100', '11']",1,4,7,8,0,15,3.8904761904761904,14,13
"['010000', '1', '1001', '10', '001011']",1,5,11,8,2,19,5.004761904761905,34,20
"['1000', '1100100', '11']",1,3,7,6,0,13,1.505050505050505,11,9
"['0101010', '010011', '010111']",1,3,9,10,2,19,2.371794871794872,5,14
"['1011', '01001', '001111']",1,3,6,9,0,15,1.812121212121212,8,7
"['1001000', '10', '111']",1,3,6,6,0,12,1.2444444444444445,12,7
"['0101101', '001111', '000', '00001']",1,4,12,9,0,21,3.4424630924630923,18,20
"['0', '0111010', '100', '0011110', '100101', '1001111']",1,6,14,17,3,31,8.230952380952381,59,35
"['11001', '01', '0100111', '0011', '0001', '0111']",1,6,12,14,3,26,9.864357864357864,38,46
"['010011', '001', '000101', '11']",1,4,9,8,2,17,3.4,18,16
"['110011', '10101', '100']",1,3,6,8,0,14,2.143939393939394,8,9
"['1101111', '0110110', '0001101', '0101010', '000010', '0100011', '101111']",1,7,22,25,7,47,12.915750915750916,59,57
"['1', '1100', '101111']",1,3,3,8,0,11,1.0857142857142859,12,9
"['0', '1001', '01011']",1,3,5,5,0,10,1.4,9,4
"['01', '010', '01111', '1101100', '001100', '1101', '101110', '0100']",1,8,17,20,4,37,17.43240093240093,76,80
"['10110', '1101100', '11100', '00', '01010', '110']",1,6,13,14,3,27,9.692063492063491,40,47
"['0', '100101', '110']",1,3,5,5,0,10,1.2301587301587302,10,4
"['011111', '1100', '01010', '0']",1,4,7,9,0,16,2.6311688311688313,21,16
"['01', '1101100', '10010', '01010', '110', '01011']",1,6,13,14,3,27,8.492063492063492,42,43
"['1011001', '1', '0111']",1,3,4,8,0,12,1.3772727272727274,12,8
"['0001010', '01101', '1', '010000']",1,4,12,7,0,19,2.6965534465534464,24,13
"['01111', '1010110', '110']",1,3,5,10,0,15,1.6,10,9
"['1110111', '0010', '10101', '1101101', '01011']",1,5,10,18,4,28,6.732900432900433,28,27
"['0111001', '011', '0011', '1010', '01011']",1,5,10,13,2,23,6.425036075036075,25,30
"['110110', '101000', '1001', '0000', '1011']",1,5,13,11,5,24,5.766666666666667,26,27
"['1', '1000110', '1100', '1101']",1,4,7,9,2,16,2.8909090909090907,21,16
"['110011', '001', '0000000']",1,3,11,5,0,16,1.3743589743589744,13,6
"['11001', '10101', '0100110', '0']",1,4,9,9,2,18,3.05,23,9
"['010101', '111010', '1001010']",1,3,9,10,2,19,2.2051282051282053,8,9
"['1', '0111', '0100']",1,3,4,5,2,9,1.3,8,5
"['101', '0011', '10']",1,3,4,5,0,9,1.7047619047619047,6,7
"['10101', '000010', '11']",1,3,7,6,0,13,1.3668831168831168,11,4
"['0001', '11101', '0110', '000']",1,4,9,7,2,16,3.2896825396825395,15,15
"['010101', '001', '0110001', '11']",1,4,9,9,0,18,3.0042735042735043,20,17
"['101101', '011011', '10111', '0001', '00110', '11111', '1010001', '0101', '0000110', '0100']",1,10,25,28,10,53,26.468559218559218,125,122
"['1010', '00', '0100']",1,3,7,3,2,10,2.083333333333333,6,10
"['1', '1111110', '01110']",1,3,3,10,0,13,1.25,13,7
"['111', '0001', '10110', '0010101', '10', '0000110']",1,6,15,13,2,28,7.744155844155844,50,39
"['1010110', '0010111', '00101', '10011', '0111', '0101', '1110']",1,7,15,21,7,36,14.292063492063491,53,63
"['0001110', '1000', '1000011', '1011', '110']",1,5,13,12,4,25,5.902597402597403,32,31
"['11', '101', '0001', '1111001', '00', '01010']",1,6,11,12,2,23,7.643073593073593,44,34
"['1111101', '0101101', '11000', '100010', '0101']",1,5,13,16,2,29,5.681807081807082,33,31
"['010', '011', '1101101', '0011010', '010101', '011111', '111000', '0011100', '111001']",1,9,22,29,9,51,22.131746031746033,115,104
"['1011', '11000', '011']",1,3,5,7,0,12,1.8015873015873014,8,10
"['1111100', '1011', '011110']",1,3,5,12,0,17,1.732867132867133,9,5
"['0', '1011', '100011', '00101']",1,4,8,8,0,16,3.212987012987013,19,13
"['0', '110110', '0010111', '01111']",1,4,7,12,0,19,2.6965534465534464,23,16
"['01111', '001000', '1', '0100']",1,4,9,7,0,16,2.627128427128427,21,13
"['11010', '01101', '11', '101', '0110000', '000111']",1,6,13,15,2,28,9.099345099345099,49,40
"['0', '010', '0010100', '1111010', '001110']",1,5,13,11,2,24,5.108424908424908,39,39
"['00', '0100111', '11111']",1,3,5,9,0,14,0.9444444444444444,13,8
"['01', '100100', '000', '1101', '001011']",1,5,12,9,2,21,5.552380952380952,30,25
"['001100', '1', '0000100', '0100']",1,4,13,5,0,18,3.2322177822177824,21,24
"['11', '1110001', '1010', '0010010', '0111100']",1,5,13,14,3,27,5.4935064935064934,39,21
"['111010', '00000', '011010', '101', '0001', '001010', '011111', '000100', '110']",1,9,25,20,7,45,20.07330447330447,106,115
"['011', '010010', '000']",1,3,8,4,2,12,1.6666666666666665,8,9
"['1101', '001010', '10000', '1011111']",1,4,10,12,0,22,3.112043512043512,22,13
"['01', '111', '101', '1010011', '110', '011000']",1,6,10,14,3,24,8.115384615384615,45,39
"['00110', '00', '1110']",1,3,6,5,0,11,1.5714285714285714,8,12
"['1011001', '10000', '000', '00001']",1,4,14,6,2,20,3.8666666666666667,16,24
"['0101', '110', '1']",1,3,3,5,0,8,1.4714285714285715,7,6
"['0001100', '1101', '0110']",1,3,8,7,2,15,2.0227272727272725,9,4
"['010000', '11', '0101101', '10100', '1101', '101110']",1,6,14,16,2,30,8.832306582306582,48,38
"['1010001', '0101100', '00011']",1,3,11,8,2,19,2.0476190476190474,9,5
"['1000100', '10001', '0011', '001101']",1,4,13,9,0,22,4.0062937062937065,16,22
"['1111101', '011', '000011', '10110', '1110101', '1100', '111101']",1,7,13,25,4,38,12.305333555333554,66,78
"['110', '0001', '010110', '10', '11100', '0100']",1,6,13,11,2,24,8.683621933621934,39,43
"['0', '10001', '100001']",1,3,8,4,0,12,1.528138528138528,10,10
"['110110', '00110', '1001']",1,3,7,8,0,15,1.993939393939394,8,7
"['00111', '101000', '0000001', '1111010', '100110', '1011']",1,6,18,17,4,35,8.172893772893772,52,43
"['100', '1001000', '001010', '00000']",1,4,16,5,0,21,3.7631701631701633,16,27
"['11011', '101', '10000', '1111', '011101']",1,5,8,15,2,23,5.89011544011544,27,33
"['11011', '1101', '00', '100111']",1,4,6,11,0,17,3.335209235209235,17,19
"['1001', '0110', '000', '0101100']",1,4,11,7,2,18,3.3155844155844156,18,15
"['01', '010', '00111', '00100', '1101101', '1000', '0001011', '110']",1,8,19,17,6,36,15.864718614718614,87,75
"['111000', '011', '111']",1,3,4,8,2,12,1.7777777777777777,8,13
"['11001', '1', '101101']",1,3,4,8,0,12,1.3463203463203464,11,13
"['0101011', '000101', '11']",1,3,7,8,0,15,1.5598290598290598,11,8
"['0010', '00101', '01111', '1000', '0101']",1,5,12,10,5,22,6.377777777777777,23,29
"['0', '10111', '011111', '01001', '0111101']",1,5,8,16,2,24,5.331518481518481,34,27
"['0', '00110', '100101', '0011010']",1,4,11,8,0,19,3.198884448884449,23,17
"['110000', '110110', '01', '1111000']",1,4,10,11,2,21,3.0235042735042734,22,18
"['00', '0011111', '11']",1,3,4,7,2,11,0.8888888888888888,12,8
"['10111', '111111', '1001000']",1,3,6,12,0,18,1.3531468531468531,11,13
"['0110100', '0001', '110100', '1111', '00', '1100']",1,6,14,13,3,27,7.8872183372183375,46,54
"['1110010', '0101101', '11101', '0000010', '011001', '111101']",1,6,17,21,5,38,10.017316017316018,41,52
"['011', '01010', '111011']",1,3,5,9,0,14,1.962121212121212,8,8
"['0001', '11100', '001101']",1,3,8,7,0,15,1.5898989898989897,9,10
"['00100', '1010', '0100000']",1,3,12,4,0,16,1.8787878787878787,9,10
"['010100', '11100', '1']",1,3,6,6,0,12,1.3463203463203464,11,6
"['0010', '10010', '11']",1,3,6,5,0,11,1.7936507936507935,7,7
"['0011', '001001', '111', '01000']",1,4,10,8,0,18,3.237590187590188,17,16
"['0000111', '10100', '0111']",1,3,8,8,0,16,1.505050505050505,11,10
"['111', '0101101', '101', '01111', '110']",1,5,6,15,3,21,6.216666666666667,26,32
"['11011', '00', '100']",1,3,5,5,0,10,1.5857142857142859,8,6
"['01', '011', '011100', '100010']",1,4,9,8,2,17,3.411111111111111,20,16
"['0111001', '100', '010111', '0111', '1101']",1,5,9,15,2,24,5.871517371517371,29,31
"['11110', '01', '0000001', '1111', '1100', '01110']",1,6,12,15,4,27,7.202597402597402,50,43
"['0010', '1', '1110100']",1,3,6,6,0,12,1.1954545454545453,13,5
"['101100', '0101', '11']",1,3,5,7,0,12,1.7666666666666666,9,6
"['0', '000111', '00011']",1,3,7,5,0,12,1.528138528138528,10,11
"['0010', '00001', '1001', '0010011', '011010']",1,5,16,10,2,26,6.416899766899767,25,27
"['101010', '1011', '111', '000']",1,4,7,9,2,16,2.9904761904761905,15,14
"['0111', '1000', '1010101', '1110']",1,4,8,11,3,19,3.3181818181818183,17,15
"['001000', '010110', '11']",1,3,8,6,2,14,1.4166666666666665,12,4
"['10100', '0111001', '10', '0010011']",1,4,11,10,2,21,3.507936507936508,22,14
"['001100', '0010', '11100', '01100']",1,4,12,8,2,20,4.125252525252526,11,35
"['1010', '1001', '111']",1,3,4,7,2,11,1.8928571428571428,6,9
"['0001011', '100001', '10', '11']",1,4,9,8,2,17,3.0042735042735043,22,17
"['110', '10', '101111']",1,3,3,8,0,11,1.7444444444444445,9,9
"['0', '00100', '1001000']",1,3,10,3,0,13,1.4166666666666667,12,10
"['110000', '1011', '01001']",1,3,8,7,0,15,1.612121212121212,9,7
"['11', '010110', '101101']",1,3,5,9,2,14,1.8333333333333335,10,4
"['0', '100110', '1100', '1111']",1,4,6,9,2,15,2.185714285714286,20,12
"['1010110', '000011', '100', '110001', '1111']",1,5,12,14,2,26,5.104051504051504,34,29
"['1011010', '001', '001111', '11', '1000', '1011100', '1011']",1,7,14,19,4,33,11.713597513597513,67,68
"['1000100', '010001', '101', '00110', '111001']",1,5,15,12,2,27,6.01996891996892,33,24
"['001', '1', '101', '101011', '0000101', '0000010']",1,6,16,11,4,27,7.697557997557998,54,41
"['01', '11010', '1101']",1,3,4,7,0,11,2.126984126984127,6,10
"['0111101', '010000', '011000']",1,3,11,8,2,19,1.9102564102564104,8,14
"['010', '1010101', '110100', '1111']",1,4,8,12,0,20,3.648884448884449,18,12
"['1001010', '011100', '0111011', '11000', '1010', '00', '01100']",1,7,19,17,4,36,12.976368076368075,65,72
"['011100', '0111011', '0101010', '0111', '111000']",1,5,13,17,4,30,7.171395271395272,26,40
"['0010', '11011', '10', '111110']",1,4,6,11,0,17,3.127994227994228,18,15
"['0101', '1001', '1111']",1,3,4,8,3,12,1.5,6,9
"['01', '0001', '001', '000']",1,4,9,3,2,12,4.247619047619048,8,23
"['00111', '11011', '10010']",1,3,6,9,3,15,1.7999999999999998,8,8
"['00100', '001', '00101', '10011']",1,4,11,7,3,18,4.45,12,20
"['00', '010', '0110111', '11']",1,4,6,8,2,14,2.688888888888889,19,13
"['110110', '11010', '01101', '0110100', '101000', '1010100', '01111', '1111', '1000']",1,9,22,27,9,49,23.206288156288156,93,110
"['0', '10001', '0000111']",1,3,8,5,0,13,1.25,13,4
"['001', '0010100', '11111', '1101', '0111110']",1,5,10,16,2,26,5.317099567099567,35,22
"['1000100', '10110', '0110', '1010111', '10', '000', '1100']",1,7,17,15,4,32,12.046825396825396,64,59
"['1', '01011', '011100']",1,3,5,7,0,12,1.1645021645021645,12,5
"['1011001', '1', '000010']",1,3,8,6,0,14,1.151098901098901,15,4
"['0', '11', '1101010']",1,3,4,6,0,10,0.6944444444444444,13,6
"['110011', '10011', '0110001']",1,3,8,10,0,18,2.344988344988345,6,13
"['1', '000011', '00000', '101', '00100']",1,5,14,6,2,20,4.3862193362193365,33,28
"['001', '10101', '0011111', '1011100', '11100', '0101001']",1,6,15,19,5,34,8.914285714285715,49,48
"['0', '000111', '0110']",1,3,6,5,0,11,1.2857142857142856,11,8
"['0', '101', '0010']",1,3,5,3,0,8,1.4714285714285715,7,4
"['111000', '10', '010000']",1,3,9,5,2,14,1.6666666666666665,10,8
"['010', '01111', '0000']",1,3,7,5,0,12,1.2936507936507935,9,9
"['101100', '0111010', '1101011', '10']",1,4,9,13,2,22,3.333943833943834,24,12
"['00001', '11', '10101', '1010010', '110100', '0110000', '1011100', '1101', '111000']",1,9,25,24,7,49,21.69083139083139,111,109
"['0011', '1', '10', '1010000']",1,4,8,6,0,14,2.458080808080808,23,14
"['01', '011', '110001', '1010000', '001100']",1,5,14,10,2,24,5.806837606837607,35,23
"['000110', '00101', '100', '1100', '1000000', '001110', '010011', '110']",1,8,24,16,5,40,16.903951603951604,85,88
"['01101', '111', '10000', '00110', '1110']",1,5,10,12,3,22,5.734920634920635,26,25
"['110000', '010001', '0110000', '11101', '10']",1,5,15,11,2,26,5.783938283938284,31,26
"['110000', '00101', '10010', '0000011', '01100', '0100']",1,6,21,11,3,32,9.086091686091686,44,47
"['1110010', '1111', '10', '000010', '0101', '1110']",1,6,12,15,3,27,8.176495726495727,47,47
"['0', '010010', '010101', '0001011', '001100', '000111']",1,6,19,13,4,32,8.636446886446887,51,46
"['00', '0101000', '1']",1,3,7,3,0,10,0.6944444444444444,13,6
"['110000', '10', '1101010']",1,3,8,7,0,15,1.7136752136752138,11,9
"['01', '00000', '0011010', '10010', '0111', '1001011']",1,6,17,13,4,30,8.333044733044733,49,38
"['01', '1110100', '11']",1,3,4,7,2,11,1.3888888888888888,11,8
"['11010', '0110', '11']",1,3,4,7,0,11,1.9047619047619047,7,7
"['0', '110', '001010']",1,3,6,4,0,10,1.2301587301587302,10,9
"['11001', '1101111', '111010', '1101', '1111111', '011000']",1,6,10,25,4,35,9.420923520923521,43,65
"['011', '101', '0001', '111101', '1100111', '0101', '1100011']",1,7,13,21,6,34,12.832622932622932,61,81
"['1000001', '01101', '1101110', '00001']",1,4,13,11,4,24,3.1619047619047618,22,18
"['01', '01101', '0010100', '01110', '1110']",1,5,11,12,2,23,5.973160173160173,29,30
"['101', '1', '01100']",1,3,4,5,0,9,1.3333333333333333,9,4
"['011', '1101011', '1000', '00', '0111', '000100']",1,6,14,12,2,26,7.334193584193584,50,45
"['0', '1000101', '011']",1,3,6,5,0,11,1.35,12,4
"['001100', '01', '001']",1,3,7,4,0,11,1.9666666666666668,8,10
"['1001', '10', '011100']",1,3,6,6,0,12,1.7666666666666666,10,5
"['100001', '1', '11000', '011010', '1110']",1,5,11,11,2,22,4.925974025974026,33,20
"['011', '101101', '10111', '10001', '100', '10100', '001110', '1101010']",1,8,18,22,7,40,17.438034188034187,76,80
"['1010', '10000', '1101']",1,3,7,6,2,13,1.8611111111111112,7,7
"['11001', '0101', '010110']",1,3,7,8,0,15,2.012121212121212,7,8
"['01000', '0101100', '0010101']",1,3,12,7,2,19,2.2142857142857144,8,13
"['000111', '10010', '0000001', '1']",1,4,12,7,0,19,2.52988677988678,25,14
"['1', '01011', '101111']",1,3,3,9,0,12,1.3463203463203464,11,9
"['0', '0010011', '10010', '11111', '110']",1,5,9,12,2,21,3.8833333333333333,37,24
"['010', '00', '1000', '10011', '110']",1,5,10,7,2,17,5.914285714285715,21,24
"['11', '1101', '010011', '0000']",1,4,8,8,2,16,2.216666666666667,19,15
"['01001', '000', '101111']",1,3,7,7,0,14,1.2676767676767677,10,4
"['0', '01', '1111', '1100101', '110111']",1,5,6,14,0,20,4.5766622266622266,35,32
"['000110', '01', '111100', '00111', '110001', '1000000', '10011', '1110']",1,8,21,20,5,41,15.40031635031635,97,79
"['000011', '00', '11111', '00010', '0110110']",1,5,13,12,2,25,4.434987234987235,36,29
"['001', '11', '00', '10', '1101']",1,5,6,7,3,13,4.838095238095238,18,23
"['011', '0011000', '100', '1000', '00', '01010', '011111']",1,7,17,13,2,30,11.465218115218114,65,70
"['001100', '0010', '010', '000']",1,4,12,4,2,16,4.514285714285714,11,35
"['11110', '01', '111', '101001']",1,4,5,11,0,16,2.966017316017316,18,19
"['01101', '0101', '001', '1']",1,4,6,7,0,13,3.1936507936507934,13,17
"['0', '0101', '1000010']",1,3,8,4,0,12,1.1954545454545453,13,6
"['11000', '000100', '110100']",1,3,11,6,2,17,2.121212121212121,6,16
"['1110101', '1001', '011', '1111']",1,4,5,13,2,18,3.4974025974025973,16,26
"['111000', '001', '100101', '0010100']",1,4,13,9,2,22,3.7623931623931623,21,17
"['110001', '1', '010111', '110']",1,4,6,10,2,16,2.6825396825396823,22,18
"['101010', '101100', '0']",1,3,7,6,2,13,1.4047619047619047,12,8
"['0', '11101', '10', '1011000']",1,4,7,8,0,15,2.9325396825396823,22,11
"['11010', '001', '011', '1001', '10110', '10100']",1,6,12,13,5,25,9.545238095238094,32,39
"['00001', '000101', '1111110', '001100', '011000']",1,5,17,13,3,30,5.215617715617715,34,35
"['1011011', '10', '011', '000']",1,4,7,8,2,15,2.577777777777778,20,13
"['001', '0110', '10', '0000']",1,4,9,4,2,13,3.0428571428571427,13,17
"['010', '0000001', '0000', '110', '1111111']",1,5,13,11,4,24,3.5939393939393938,44,27
"['1100010', '111111', '0111']",1,3,5,12,0,17,1.606993006993007,12,13
"['0101', '111', '01110']",1,3,4,8,0,12,1.9880952380952381,6,5
"['1000100', '000101', '1101', '00', '00110', '0011111', '0010010', '0110011']",1,8,25,20,4,45,16.867954267954268,96,86
"['0111000', '10001', '00110', '1010', '1011', '000100', '01011']",1,7,20,16,5,36,13.511849261849262,58,53
"['01', '001', '00111', '011101', '01100']",1,5,10,11,2,21,6.1918470418470415,26,31
"['010', '100', '10110', '0010101', '0010010', '000100', '110', '111001']",1,8,23,17,7,40,17.584143634143633,83,79
"['010', '011', '1110']",1,3,4,6,2,10,1.8095238095238093,5,9
"['010', '000001', '0111']",1,3,8,5,0,13,1.4158730158730157,10,7
"['110111', '010', '100', '10000']",1,4,9,8,2,17,3.169191919191919,19,13
"['11010', '11', '1111110', '001100', '000111', '0100101']",1,6,14,19,4,33,8.159784659784659,55,41
"['0', '11110', '010', '110010', '10111']",1,5,8,12,2,20,4.80995670995671,31,26
"['0', '1000100', '1010100', '111110', '110']",1,5,12,12,2,24,4.224908424908425,38,27
"['1010000', '001', '10']",1,3,8,4,0,12,1.2444444444444445,12,8
"['01', '0010', '00101', '10000', '100111', '000100']",1,6,18,10,4,28,9.124819624819624,40,43
"['1100010', '10101', '001100', '111101', '0100']",1,5,14,14,2,28,5.900466200466201,30,22
"['111', '011100', '101', '1101', '0100']",1,5,8,12,4,20,6.249206349206349,22,23
"['101010', '10101', '000000', '1001100', '1101', '111000', '0100']",1,7,22,16,5,38,12.429603729603729,58,59
"['11001', '00001', '00100', '1110100', '10', '1011']",1,6,15,13,3,28,7.885137085137084,47,41
"['010', '100', '011', '1110']",1,4,6,7,3,13,3.380952380952381,12,15
"['01', '101011', '01001', '101001']",1,4,9,10,2,19,4.041125541125541,15,24
"['0001101', '1010', '110001', '1']",1,4,9,9,0,18,2.6965534465534464,25,15
"['01101', '111', '0001', '100101', '000']",1,5,11,10,2,21,5.497907647907648,24,26
"['0010111', '0001', '100', '0111111', '101110']",1,5,11,16,2,27,5.1032301032301035,36,26
"['11110', '011', '0000001', '11111', '110', '0100']",1,6,12,15,4,27,6.823160173160173,52,45
"['1011', '01', '0010']",1,3,5,5,2,10,1.8333333333333333,6,4
"['0011', '1101011', '011110', '1101', '1110']",1,5,8,17,3,25,6.211538461538462,29,33
"['001', '00101', '11', '0000001', '1010', '11101', '0110110', '1110']",1,8,18,19,6,37,14.687229437229437,88,77
"['1001', '110', '1110', '1111011']",1,4,5,13,2,18,3.801298701298701,17,22
"['01', '1100010', '1010100', '100', '001100', '00010', '1011']",1,7,20,14,2,34,12.117082917082916,66,61
"['1011', '110010', '11']",1,3,4,8,0,12,1.7666666666666666,9,13
"['001', '11', '00011', '1101101', '1110110', '1101', '0111101', '1001011']",1,8,15,27,4,42,16.05750360750361,94,104
"['1110011', '1', '10010']",1,3,5,8,0,13,1.25,13,8
"['1000011', '001011', '1110', '11']",1,4,8,11,0,19,2.9901320901320902,22,24
"['1000', '0101', '001110', '0111']",1,4,9,9,3,18,3.3,17,14
"['1001', '0110', '0101001', '11']",1,4,8,9,2,17,3.7323232323232323,18,14
"['00', '11101', '100', '01010']",1,4,8,7,2,15,3.507142857142857,16,12
"['0110000', '100100', '110', '000']",1,4,13,6,2,19,3.4136752136752135,19,21
"['0110101', '01101', '00101', '1001001', '1110']",1,5,13,15,4,28,6.701154401154401,25,34
"['01001', '0000000', '11111']",1,3,10,7,2,17,0.7333333333333334,14,4
"['1000001', '0111101', '01110']",1,3,9,10,2,19,1.5952380952380953,12,8
"['010', '011', '1000000', '001100', '00010', '0111110']",1,6,19,12,4,31,8.306576756576757,52,56
"['010', '0011', '11101', '010011', '0101']",1,5,10,12,2,22,6.41998556998557,23,31
"['001111', '11000', '10101', '100011', '1101']",1,5,11,15,4,26,5.963636363636364,28,37
"['01', '010', '000011', '1010111', '1011']",1,5,10,12,0,22,5.96964146964147,31,25
"['010000', '0110111', '01000']",1,3,11,7,0,18,1.8706293706293706,9,16
"['101011', '11000', '010001', '1101110']",1,4,11,13,2,24,3.836829836829837,18,16
"['0010110', '0100110', '111010', '11', '101', '011110']",1,6,13,18,4,31,8.477655677655678,48,39
"['001', '101000', '0100', '1111', '1110001', '000000', '0111', '011000']",1,8,23,17,6,40,14.513419913419913,87,88
"['1110110', '000001', '000']",1,3,10,6,0,16,1.3743589743589744,13,10
"['0011', '1010010', '001101']",1,3,9,8,0,17,1.806993006993007,9,9
"['0111010', '00011', '10000', '1111', '1000', '00', '111101']",1,7,16,17,4,33,10.545421245421245,70,62
"['0010', '10', '0101100', '0000', '11100', '101001']",1,6,17,11,2,28,8.239843489843489,43,43
"['1010', '001', '000', '0100']",1,4,10,4,4,14,3.702380952380952,10,19
"['0', '110', '111100']",1,3,4,6,0,10,1.4523809523809523,10,7
"['00', '1010101', '1011000']",1,3,9,7,2,16,1.6031746031746033,13,8
"['01101', '001101', '10111', '100', '1111110', '00']",1,6,11,17,2,28,8.121711621711622,49,40
"['0011110', '1011100', '0111']",1,3,7,11,2,18,2.168831168831169,8,7
"['1011110', '1011', '010011']",1,3,6,11,0,17,2.1426573426573428,9,11
"['100001', '011', '101', '11101', '0000', '1001100', '11100', '0100001']",1,8,22,18,6,40,16.717920967920968,85,84
"['001', '1', '011', '0010000', '101010', '01000']",1,6,16,9,2,25,7.822816072816073,48,36
"['0', '10000', '1011', '011']",1,4,7,6,0,13,2.784920634920635,17,13
"['0001011', '010011', '010']",1,3,9,7,0,16,2.0358974358974358,9,10
"['0', '100110', '1101010']",1,3,7,7,0,14,0.9972527472527473,13,7
"['0001', '1', '010010']",1,3,7,4,0,11,1.4857142857142858,10,4
"['0111101', '111', '111001']",1,3,4,12,0,16,2.0358974358974358,9,13
"['11001', '01', '1', '0100']",1,4,6,6,0,12,3.3047619047619046,15,12
"['0', '01111', '00001']",1,3,6,5,2,11,1.0666666666666667,11,6
"['100100', '110', '111']",1,3,5,7,2,12,1.5555555555555554,8,8
"['0', '0010', '0011110', '001011']",1,4,10,8,0,18,3.2322177822177824,21,26
"['010000', '101011', '100', '110111', '011110', '000', '01001']",1,7,18,17,6,35,11.795454545454545,64,53
"['1011', '010', '101100', '101111']",1,4,7,12,2,19,3.9492063492063494,15,20
"['1011', '00', '111']",1,3,3,6,0,9,0.9047619047619047,7,6
"['1001110', '11010', '0000']",1,3,9,7,0,16,1.4898989898989898,10,7
"['0101', '001', '001111', '1101110']",1,4,8,12,0,20,3.398934398934399,19,16
"['100', '00101', '111']",1,3,5,6,2,11,1.3333333333333333,8,7
"['11001', '0010', '001111', '111', '10111', '100', '11101', '1101', '0101']",1,9,14,25,8,39,22.47301587301587,85,127
"['00010', '00', '011', '111001']",1,4,9,7,0,16,2.961327561327561,20,13
"['0', '11000', '0100000']",1,3,10,3,0,13,1.25,13,10
"['1100111', '110', '1']",1,3,3,8,0,11,1.35,12,11
"['100', '01111', '01010']",1,3,6,7,2,13,1.6,8,7
"['110010', '01101', '0011', '01100', '001110', '0000011', '1011100', '1010011', '000111', '01110']",1,10,29,29,9,58,29.987445887445887,135,141
"['1001', '0000000', '1100100', '011010', '0101001']",1,5,20,11,3,31,5.98961038961039,33,24
"['1110001', '1000', '11']",1,3,6,7,0,13,1.505050505050505,11,10
"['001', '110', '0110']",1,3,5,5,2,10,1.7619047619047619,6,8
"['00', '10', '00010', '000111', '111101']",1,5,11,10,4,21,4.733766233766234,35,28
"['011110', '1', '000010']",1,3,7,6,2,13,1.0714285714285714,13,5
"['0', '00111', '010010', '010101', '00010']",1,5,14,9,4,23,5.398701298701298,30,32
"['01101', '001', '0110', '11']",1,4,6,8,0,14,3.598412698412698,12,14
"['111000', '001', '111']",1,3,5,7,2,12,1.4444444444444444,9,11
"['1101', '01101', '1111']",1,3,3,10,2,13,2.3055555555555554,4,13
"['001110', '010', '1']",1,3,5,5,0,10,1.4523809523809523,10,5
"['1011010', '0001', '001111']",1,3,8,9,0,17,1.579020979020979,10,7
"['10100', '1000110', '0101', '00111']",1,4,11,10,2,21,3.4454545454545453,17,14
"['11', '10001', '00110', '010110', '000']",1,5,12,9,2,21,5.864069264069264,28,21
"['000000', '1001', '1011', '110100']",1,4,12,8,4,20,2.8833333333333333,19,14
"['00101', '0101101', '1001', '0110000', '100011', '000', '1011', '11100']",1,8,22,19,6,41,16.924997224997224,85,76
"['1110111', '01', '000011', '100', '100010', '000', '1001111']",1,7,17,17,6,34,10.934798534798535,75,60
"['0110101', '010', '1110000', '101000', '0110', '1010111', '00', '1100', '1110']",1,9,22,22,6,44,21.767316017316016,110,104
"['0', '010001', '11']",1,3,5,4,0,9,0.7857142857142857,11,4
"['1010111', '1101111', '10', '111101']",1,4,5,17,2,22,3.3229548229548227,21,28
"['0111010', '101010', '000101', '00110', '10010']",1,5,16,13,4,29,6.5762237762237765,23,34
"['11011', '1', '00101', '100', '0010100', '010101']",1,6,14,13,2,27,8.126157176157177,48,40
"['100101', '1101', '1101011']",1,3,6,11,0,17,2.2965034965034965,7,18
"['01', '0011010', '1101', '1100', '01110']",1,5,10,12,2,22,6.387085137085137,27,24
"['1000010', '1010001', '1']",1,3,9,6,2,15,1.2142857142857144,14,9
"['0', '11000', '0110100', '0110001']",1,4,12,8,2,20,3.357142857142857,22,18
"['111100', '011', '1111001', '001110', '01011']",1,5,10,17,2,27,5.89048174048174,33,31
"['1001110', '1010110', '0010', '011', '0111011', '0011', '1111011']",1,7,15,24,6,39,13.877272727272727,65,67
"['0', '010000', '111', '10011', '110']",1,5,9,9,2,18,3.9978354978354975,32,21
"['01111', '10', '011000']",1,3,6,7,0,13,1.331168831168831,11,8
"['0001001', '01', '001010', '11']",1,4,10,7,2,17,3.158119658119658,22,12
"['00', '000101', '11']",1,3,6,4,2,10,1.0,10,6
"['0010001', '01111', '111110', '010110', '0000', '1110', '111001']",1,7,17,21,5,38,11.532595182595182,67,66
"['111010', '00011', '101010', '01010', '1010011', '11100']",1,6,16,18,5,34,9.817948717948719,37,52
"['0', '111100', '11000', '10000', '1110101', '0011011']",1,6,15,16,4,31,7.47016317016317,56,42
"['11', '001', '0010011']",1,3,6,6,0,12,1.4444444444444444,11,10
"['010', '1', '000011', '110011', '0111']",1,5,9,11,2,20,4.798412698412698,33,26
"['111111', '001', '011', '0111']",1,4,4,12,2,16,3.3619047619047615,16,21
"['110', '11011', '1111', '110011', '100011', '110111', '000000', '0001010', '11100', '01110']",1,10,23,30,7,53,26.146914196914196,136,165
"['0', '001', '1111111', '110101']",1,4,5,12,0,17,2.0455433455433454,26,13
"['0', '001111', '11101', '011001', '101111']",1,5,8,16,3,24,5.372294372294372,33,27
"['0010', '11011', '0001110', '101', '0000101', '10011']",1,6,16,15,4,31,9.484704184704185,44,37
"['00111', '110', '011110']",1,3,5,9,0,14,1.893939393939394,8,9
"['0111001', '1', '0000']",1,3,7,5,0,12,0.6136363636363636,14,4
"['0010001', '100', '110']",1,3,8,5,2,13,1.6666666666666665,10,7
"['001000', '10110', '1111', '10', '001001', '1110']",1,6,13,14,4,27,7.979004329004329,44,42
"['1111100', '10000', '000010']",1,3,11,7,0,18,1.534965034965035,11,11
"['110', '11011', '001', '0110011', '010111', '1101', '1100', '1011111']",1,8,13,26,6,39,17.324730824730825,80,101
"['111110', '0101110', '00101', '111']",1,4,7,14,0,21,3.566200466200466,19,17
"['0', '0111001', '101110', '111011']",1,4,7,13,2,20,3.0265567765567765,24,10
"['101', '10111', '11111']",1,3,2,11,2,13,1.85,6,18
"['11', '101', '1010', '000111', '0011100']",1,5,10,12,0,22,5.827383727383728,33,24
"['101111', '000', '110101']",1,3,6,9,2,15,1.3333333333333333,12,5
"['0001', '0010111', '0110', '101111']",1,4,9,12,2,21,3.36013986013986,19,13
"['001', '0111010', '1100010', '10110', '11101', '001110', '11100']",1,7,17,21,5,38,13.66020646020646,59,58
"['1', '01011', '01110', '0100']",1,4,7,8,2,15,3.0,17,14
"['00001', '101001', '000010', '0101', '01100']",1,5,17,9,4,26,5.938383838383839,24,29
"['0100000', '010', '1', '1001111']",1,4,10,8,2,18,2.4285714285714284,28,10
"['001', '00000', '1010100', '0001111', '01110']",1,5,16,11,4,27,4.661904761904762,35,33
"['0011', '00', '10', '1101']",1,4,6,6,4,12,3.0,14,13
"['1101001', '01001', '0', '1010011']",1,4,10,10,2,20,3.357142857142857,22,15
"['010100', '0', '111100', '0110', '10000', '100011']",1,6,16,12,3,28,7.519769119769119,52,39
"['11011', '1100', '111']",1,3,3,9,0,12,1.9880952380952381,6,17
"['000110', '1111011', '00110', '111111', '110111', '111000', '1011111']",1,7,13,30,6,43,12.142024642024642,64,94
"['001', '011', '1110011', '100', '010110']",1,5,10,12,3,22,5.859829059829059,31,23
"['1101001', '0010110', '1101111', '0001111', '00', '010101', '110']",1,7,17,22,4,39,11.583516483516483,77,62
"['11110', '01', '010', '101101', '10100', '000010', '0000110']",1,7,19,15,4,34,11.753685203685203,66,60
"['10101', '10', '1110']",1,3,4,7,0,11,1.6825396825396823,7,8
"['0101', '010', '001']",1,3,6,4,2,10,2.095238095238095,4,9
"['110110', '010', '00111', '10111', '100100', '0001000']",1,6,17,15,4,32,8.605516705516706,45,40
"['00', '0111101', '11']",1,3,4,7,2,11,0.8888888888888888,12,4
"['1010011', '0110', '0010011']",1,3,9,9,2,18,1.948051948051948,9,9
"['01', '010', '001000']",1,3,8,3,0,11,1.9666666666666668,8,9
"['101011', '00', '011110']",1,3,6,8,2,14,1.5,11,4
"['1000', '100', '1101000', '100011']",1,4,12,8,0,20,4.266466866466867,17,25
"['100110', '10', '00000']",1,3,9,4,0,13,1.331168831168831,11,8
"['0', '001101', '11']",1,3,4,5,0,9,0.7857142857142857,11,4
"['0', '111111', '1001']",1,3,3,8,0,11,0.8,13,4
"['010', '1', '100', '110100', '0001000']",1,5,13,7,2,20,5.351098901098901,34,24
"['01', '001', '1011100']",1,3,6,6,0,12,1.6444444444444444,11,8
"['0', '110110', '001', '0011010']",1,4,9,8,0,17,2.8493894993894995,24,17
"['010', '101101', '100010', '10', '0101100', '0000', '011111']",1,7,18,16,3,34,10.89959484959485,72,55
"['000110', '01', '0001', '000', '010011', '1111111']",1,6,14,14,2,28,7.487678987678987,53,43
"['11', '1100100', '0010100', '11101', '1011', '0100']",1,6,14,15,4,29,8.316017316017316,50,46
"['111111', '100', '011']",1,3,3,9,2,12,1.0,12,8
"['011', '1001', '100101', '10', '10010', '0111101']",1,6,12,15,0,27,9.17945387945388,43,52
"['100', '01110', '1111']",1,3,4,8,0,12,1.4523809523809523,8,4
"['1001110', '10100', '110111', '1100110']",1,4,10,15,2,25,4.107725607725608,15,18
"['01', '0101011', '1100110']",1,3,7,9,2,16,1.6031746031746033,13,8
"['10101', '10110', '0110100']",1,3,8,9,2,17,2.1333333333333333,8,6
"['01', '000011', '1011101', '01111', '111011', '0000', '1100']",1,7,15,19,4,34,10.413308913308914,71,62
"['01', '0100111', '11']",1,3,4,7,2,11,1.3888888888888888,11,9
"['10101', '01101', '110', '011']",1,4,6,10,4,16,4.016666666666667,12,17
"['0', '011', '011100']",1,3,5,5,0,10,1.4523809523809523,10,10
"['1101000', '001', '1']",1,3,6,5,0,11,1.15,13,7
"['1111010', '1000', '010000', '1']",1,4,10,8,0,18,2.742707292707293,24,12
"['1001110', '1111101', '00100', '00', '1101', '0110110']",1,6,14,18,3,32,7.9603174603174605,55,36
"['11010', '01', '100001', '00001', '0010100', '1101110', '111101', '0000110', '1110']",1,9,25,24,7,49,19.59195249195249,122,104
"['010', '11', '1011', '0010010', '0001000']",1,5,14,9,2,23,5.270995670995671,36,22
"['01', '110', '1110']",1,3,3,6,0,9,1.5904761904761904,6,9
"['0000001', '00', '1000', '0011111', '01110']",1,5,15,10,2,25,4.909090909090909,40,32
"['1010', '1000', '1']",1,3,5,4,2,9,1.55,7,7
"['1001110', '1000110', '1010', '1000', '111000']",1,5,15,13,4,28,7.147002997002997,27,37
"['00', '111', '011110']",1,3,4,7,0,11,1.1666666666666665,10,4
"['101', '1001', '000']",1,3,6,4,2,10,1.7619047619047619,5,6
"['1110111', '1000100', '0010', '00011', '1001', '00', '0001010', '1110']",1,8,22,18,6,40,15.682178932178932,94,82
"['01', '110010', '1111011']",1,3,5,10,0,15,1.5598290598290598,12,8
"['011011', '1100', '1111000', '10']",1,4,8,11,0,19,3.3999222999223,21,16
"['0', '0111001', '11']",1,3,4,6,0,10,0.6944444444444444,13,4
"['110001', '100', '011000', '10', '000', '011111', '111001']",1,7,16,16,6,32,11.838888888888889,65,54
"['00100', '0001', '001', '01000']",1,4,13,4,2,17,4.2404761904761905,12,27
"['11011', '001', '000101', '0001111', '000', '011000']",1,6,17,13,4,30,8.382789432789433,50,55
"['1010111', '1111010', '1001111', '000']",1,4,9,15,3,24,3.2,25,18
"['001', '011', '1011', '011010', '0001000']",1,5,13,10,2,23,5.785370185370185,30,24
"['110110', '11110', '01', '00101', '0110100', '1001010', '100010', '100110', '000']",1,9,25,22,7,47,21.302664002664002,106,104
"['0101000', '1', '110']",1,3,6,5,0,11,1.15,12,4
"['0001', '1000', '110']",1,3,7,4,2,11,1.6071428571428572,7,8
"['010', '00001', '10111', '10', '10011']",1,5,10,10,3,20,5.5285714285714285,26,23
"['1010', '011010', '111']",1,3,5,8,0,13,2.038095238095238,7,7
"['10101', '0000110', '11']",1,3,7,7,0,14,1.349206349206349,12,4
"['010', '1100000', '110', '01110']",1,4,10,8,2,18,3.6666666666666665,19,21
"['0111010', '00011', '101', '100100', '1111', '011101', '1100101', '01110']",1,8,18,25,6,43,17.47141747141747,82,79
"['0', '101101', '1001000', '0111111', '110']",1,5,10,14,2,24,4.268864468864469,43,20
"['110111', '101011', '10110', '000001']",1,4,10,13,3,23,3.3181818181818183,17,18
"['1100010', '01101', '000']",1,3,9,6,0,15,1.7666666666666666,11,6
"['100110', '001', '1', '00000']",1,4,10,5,0,15,2.4978354978354975,21,12
"['000110', '0010', '0011', '10101', '111000', '110', '101110']",1,7,17,17,5,34,13.177705627705627,59,62
"['0010', '0011', '11000', '100100', '1001', '011101', '110']",1,7,17,15,5,32,13.375901875901876,54,56
"['10001', '111110', '00']",1,3,6,7,0,13,1.185064935064935,12,4
"['1001001', '1000', '001', '1111']",1,4,9,9,2,18,2.97987012987013,19,19
"['0000', '10001', '100', '11111']",1,4,9,8,2,17,2.638095238095238,18,14
"['011', '0001', '100', '001110', '0111', '1101', '0100']",1,7,14,14,6,28,11.7015873015873,49,55
"['00011', '10111', '1100100', '1111', '11101', '0000']",1,6,13,17,5,30,7.65050505050505,45,56
"['11011', '1111101', '00111', '101010', '0101']",1,5,9,18,2,27,6.1797202797202795,28,30
"['110010', '1011001', '000011', '0001', '100', '1010', '000000', '11111', '110', '1110']",1,10,25,23,8,48,23.3992118992119,141,135
"['0100111', '001111', '0011', '10101', '1111010', '010111', '0111']",1,7,14,25,6,39,14.284165834165835,57,78
"['1110101', '00', '00001']",1,3,8,6,0,14,1.349206349206349,12,7
"['000110', '011', '10', '1011', '110']",1,5,8,10,2,18,6.395238095238095,23,27
"['1000001', '0110111', '00001', '101', '1111000', '1010', '0111']",1,7,18,19,5,37,11.285425685425684,77,65
"['110', '001010', '00001']",1,3,9,5,0,14,1.2398989898989898,9,8
"['01', '0100111', '0110100']",1,3,8,8,2,16,1.4603174603174602,13,9
"['0100111', '111', '0011', '1101000', '0101']",1,5,11,14,4,25,6.027922077922078,34,34
"['00111', '100001', '10']",1,3,7,6,0,13,1.331168831168831,11,7
"['101100', '010', '1101111', '101', '1111110', '00']",1,6,10,18,4,28,7.524420024420024,54,35
"['11110', '010', '100100', '00', '11101']",1,5,10,11,2,21,5.247186147186147,30,23
"['101011', '01', '000001', '11']",1,4,8,8,4,16,2.5833333333333335,21,17
"['0', '10101', '00101']",1,3,6,5,2,11,1.4666666666666668,9,7
"['10100', '1100001', '0101', '111101']",1,4,10,12,0,22,3.6396270396270394,18,19
"['0', '100', '110011', '0101010', '0001011', '0000110']",1,6,18,13,3,31,7.448534798534799,58,38
"['001', '10001', '110111', '000', '11111']",1,5,9,13,4,22,4.574242424242424,30,30
"['110000', '011', '111', '010010', '11101', '1001001', '0100101']",1,7,18,19,6,37,12.993156843156843,64,64
"['011111', '11111', '01', '0000']",1,4,6,11,0,17,2.228138528138528,22,19
"['110011', '000', '0011000']",1,3,10,6,0,16,1.6598290598290597,12,10
"['00111', '010', '0000']",1,3,8,4,0,12,1.5158730158730158,8,10
"['0', '101001', '111101']",1,3,5,8,2,13,1.0714285714285714,12,5
"['010001', '0111001', '1100101', '0001010', '01000']",1,5,19,13,3,32,6.742424242424242,27,30
"['0101110', '1', '000001']",1,3,8,6,0,14,0.8434065934065934,15,4
"['01101', '101', '101000', '010110', '110']",1,5,11,12,4,23,6.55050505050505,27,25
"['0010110', '1010110', '1001010', '101000', '1001', '100010', '01000']",1,7,25,17,5,42,14.655411255411256,50,73
"['011', '011100', '01110']",1,3,6,8,0,14,2.3257575757575757,6,16
"['0', '010101', '010110', '1001010']",1,4,11,9,2,20,3.1932234432234434,24,18
"['11000', '100000', '10', '1001100', '010011']",1,5,16,10,2,26,5.993728493728494,33,29
"['100100', '1101011', '10', '11']",1,4,7,10,2,17,3.0042735042735043,22,19
"['0', '110000', '01001']",1,3,8,4,0,12,1.1645021645021645,12,6
"['00', '000111', '110']",1,3,6,5,0,11,1.3444444444444446,10,9
"['011111', '001', '011', '111110']",1,4,5,13,4,18,3.2777777777777777,19,20
"['0', '00111', '11']",1,3,3,5,0,8,0.9047619047619047,9,6
"['1111000', '10', '01010']",1,3,7,7,0,14,1.5158730158730158,12,7
"['1101', '0101', '1', '01000']",1,4,7,7,2,14,2.9944444444444445,16,14
"['00', '0111001', '11111']",1,3,5,9,0,14,1.1111111111111112,13,4
"['0', '01', '1100011']",1,3,5,5,0,10,1.3611111111111112,12,4
"['011', '0111011', '11']",1,3,3,9,0,12,1.8444444444444446,10,14
"['111100', '011', '11', '100', '0100']",1,5,8,10,2,18,5.506349206349206,26,30
"['00110', '1001', '0111']",1,3,6,7,2,13,1.8333333333333333,8,4
"['0001100', '000101', '011']",1,3,10,6,0,16,2.0358974358974358,9,10
"['11110', '10101', '00', '1']",1,4,5,8,2,13,1.9238095238095236,20,10
"['1011', '1101', '100001', '11111']",1,4,6,13,2,19,3.4247474747474747,16,31
"['110110', '000111', '1', '0011100']",1,4,9,11,2,20,2.706043956043956,26,13
"['1', '1000110', '100010', '10', '1001100']",1,5,13,10,2,23,5.390720390720391,37,34
"['1010', '001001', '011010']",1,3,9,7,2,16,2.0666666666666664,8,9
"['01', '00', '10']",1,3,4,2,3,6,1.5,4,6
"['01', '00101', '111', '10001', '100000', '011010']",1,6,15,12,4,27,7.827200577200577,48,36
"['0', '0001001', '0101']",1,3,8,4,0,12,1.3772727272727274,12,7
"['0', '1001010', '1111', '001110', '110', '101110']",1,6,11,16,2,27,7.58959373959374,48,42
"['0', '110110', '101011', '1011', '0100']",1,5,9,12,4,21,5.504761904761905,31,23
"['00', '0111101', '1111']",1,3,4,9,0,13,1.1717171717171717,12,4
"['11011', '1110000', '00000', '00111', '101', '0011', '0010101', '0111', '0010010']",1,9,25,22,8,47,21.297474747474748,112,121
"['11010', '11', '00', '00010', '110101']",1,5,10,10,4,20,5.054545454545455,29,28
"['1111100', '001', '010', '101010', '1101000', '01111', '10100', '01110', '0000', '1110']",1,10,24,25,9,49,24.674420024420023,130,140
"['101100', '1101111', '1', '1100000', '00', '110101']",1,6,13,16,4,29,6.448717948717949,61,44
"['1000', '1110', '1011111']",1,3,5,10,2,15,1.4090909090909092,11,9
"['101011', '100111', '000001', '110', '0101001', '1110']",1,6,15,17,3,32,7.7524031524031525,48,44
"['110110', '0111101', '000']",1,3,7,9,0,16,1.45982905982906,12,6
"['10001', '001010', '01000']",1,3,11,5,2,16,2.0727272727272728,7,5
"['101001', '1000', '000011', '1111']",1,4,10,10,4,20,3.1166666666666667,18,19
"['11001', '1001110', '00', '0101', '1110']",1,5,10,12,2,22,5.788600288600288,31,23
"['1101001', '0011', '1001', '000', '011010', '0100101']",1,6,17,14,4,31,9.73954378954379,44,35
"['11000', '000100', '11100']",1,3,10,6,2,16,1.8909090909090909,7,14
"['011', '00001', '1110101', '100011', '1100']",1,5,12,13,0,25,5.478110778110778,31,31
"['110010', '10001', '0011110', '0001', '00010']",1,5,16,11,2,27,6.805982905982906,27,31
"['1101', '0101', '0100110', '011']",1,4,8,10,2,18,4.051298701298701,15,17
"['01', '101', '110111', '01001', '011000']",1,5,10,12,2,22,6.005266955266955,30,24
"['01', '1', '00011']",1,3,4,4,0,8,1.5714285714285714,8,6
"['01', '11110', '001110', '10', '1100', '1111111', '110101']",1,7,10,22,4,32,10.748207348207348,72,61
"['00111', '00', '01010']",1,3,7,5,2,12,1.7428571428571429,9,10
"['11011', '111', '100101', '0011011', '1001111']",1,5,9,19,2,28,7.23954378954379,27,53
"['1001110', '110', '10011', '11']",1,4,6,11,0,17,3.749206349206349,18,25
"['101000', '01', '1000']",1,3,8,4,0,12,1.6333333333333333,9,10
"['001111', '1111110', '1']",1,3,3,11,0,14,1.151098901098901,14,9
"['011011', '010000', '00000']",1,3,12,5,2,17,1.5909090909090908,8,15
"['1100111', '00', '1111110']",1,3,5,11,2,16,1.0952380952380951,14,7
"['0', '1010101', '110', '0100']",1,4,8,7,0,15,2.8487012987012985,20,10
"['01011', '1001111', '10000', '1011000']",1,4,12,12,4,24,3.3285714285714283,21,19
"['1000100', '111', '0010000']",1,3,11,6,2,17,1.3142857142857143,14,6
"['101', '11110', '100001', '1100100']",1,4,10,11,0,21,3.3995337995337995,20,17
"['10100', '01', '110', '111101']",1,4,6,10,0,16,3.1835497835497835,17,14
"['010', '111', '100', '0110', '0001100', '0000']",1,6,15,9,5,24,8.030735930735931,40,47
"['11', '1001', '111011', '100000', '0110001']",1,5,12,13,2,25,5.352486402486402,35,34
"['001', '111100', '111010', '11', '0111', '0101']",1,6,9,16,4,25,8.548412698412697,42,45
"['00010', '11011', '100', '10110']",1,4,9,9,3,18,3.55,15,13
"['0011', '010', '1110', '11']",1,4,5,8,2,13,3.376190476190476,13,16
"['01', '01011', '0010101', '0111110']",1,4,9,12,2,21,3.365079365079365,22,16
"['1', '00000', '100100', '1101', '0100']",1,5,13,7,2,20,4.379653679653679,31,23
"['1000110', '1001', '11100']",1,3,8,8,0,16,1.893939393939394,10,8
"['101100', '1', '111010', '011100', '1110100']",1,5,11,15,3,26,5.902014652014652,32,30
"['00110', '11100', '1000101', '0111100']",1,4,12,12,4,24,3.695238095238095,20,16
"['1', '00100', '11101', '100000', '001100', '01001', '1011011', '0100101']",1,8,23,19,7,42,14.728904428904428,93,72
"['00001', '001000', '1101101', '10', '000', '0111']",1,6,16,11,0,27,6.977916527916528,51,43
"['001', '101011', '1010', '110', '0110011']",1,5,10,13,2,23,5.372072372072372,29,28
"['010100', '001', '00001', '11', '0110000', '10010']",1,6,18,10,2,28,8.157686757686758,47,39
"['01100', '10', '1111111']",1,3,4,10,0,14,1.126984126984127,14,4
"['0000', '1100000', '11']",1,3,9,4,0,13,1.1717171717171717,12,12
"['01101', '111', '101010', '0110000', '000']",1,5,13,11,2,24,5.410839160839161,33,25
"['0', '00100', '0111010']",1,3,8,5,0,13,1.25,13,12
"['1000101', '00101', '0011', '1111001', '010011']",1,5,14,15,2,29,6.978266178266178,31,35
"['001', '001111', '0110', '1010', '00', '1110']",1,6,11,12,3,23,8.661904761904761,36,44
"['00', '10110', '11']",1,3,4,5,2,9,1.1428571428571428,8,4
"['0011001', '00010', '111000', '110']",1,4,12,9,0,21,3.594172494172494,20,18
"['01', '0010111', '1']",1,3,4,6,0,10,1.3611111111111112,12,6
"['1101001', '11010', '1', '000000']",1,4,11,8,0,19,2.087995337995338,26,14
"['01', '00', '111011']",1,3,4,6,2,10,1.25,10,4
"['001', '01111', '10', '11']",1,4,4,8,2,12,2.657142857142857,15,14
"['1101010', '001', '1111101', '11']",1,4,6,13,2,19,2.66031746031746,24,20
"['101000', '00', '0101']",1,3,8,4,0,12,1.7666666666666666,9,8
"['00', '1', '101101']",1,3,4,5,0,9,0.7857142857142857,11,4
"['1', '1101011', '000', '001100', '0110010', '0100011', '101001']",1,7,20,17,5,37,10.697374847374848,80,44
"['101000', '0101000', '1111000']",1,3,12,8,2,20,2.406593406593407,5,17
"['110110', '0001110', '011', '00011']",1,4,10,11,0,21,3.856993006993007,17,22
"['1110010', '111', '0011001', '10110', '100101', '1011100', '01001', '110']",1,8,19,24,7,43,17.822849372849372,84,80
"['100111', '10', '1']",1,3,3,6,0,9,1.4523809523809523,10,9
"['0', '00111', '1101011', '010101', '01011']",1,5,10,14,2,24,5.907975357975358,31,29
"['0010', '0001110', '111101']",1,3,8,9,0,17,1.7426573426573428,11,6
"['01001', '10', '000', '11']",1,4,7,5,2,12,2.5428571428571427,14,10
"['0110101', '001001', '0010111', '11111']",1,4,10,15,2,25,3.783050283050283,16,20
"['011101', '11110', '11011']",1,3,4,12,2,16,2.0545454545454547,7,8
"['01', '011011', '00100', '10', '0000', '111000', '1100']",1,7,17,12,6,29,11.105988455988456,62,64
"['111', '1110101', '010111', '1100101', '010110']",1,5,10,19,4,29,6.463125763125763,29,41
"['111110', '011', '1111']",1,3,2,11,0,13,1.8158730158730159,8,15
"['11001', '100', '1100101', '0011000']",1,4,12,10,2,22,4.164285714285715,19,17
"['0101110', '11', '101', '0001', '1001', '01110']",1,6,11,14,2,25,8.543939393939393,42,36
"['1111100', '0100000', '11011', '01111', '10']",1,5,11,15,4,26,4.6079365079365076,39,27
"['01111', '01000', '11']",1,3,5,7,2,12,1.2571428571428571,10,7
"['01', '001', '10110', '010000']",1,4,10,6,0,16,3.3613275613275615,18,15
"['1101', '10010', '10', '1010011']",1,4,8,10,0,18,3.5613275613275612,18,19
"['011011', '1111010', '01']",1,3,5,10,0,15,1.5598290598290598,12,8
"['101', '00110', '1']",1,3,4,5,0,9,1.3333333333333333,9,4
"['110010', '100101', '0111', '011111', '1001001', '1111111', '1011111']",1,7,13,30,6,43,13.05810855810856,64,98
"['000110', '000010', '0000']",1,3,13,3,2,16,2.4333333333333336,5,25
"['101101', '11', '1010111', '000000', '0101']",1,5,12,13,2,25,4.748640248640249,37,26
"['10111', '00100', '10101']",1,3,7,8,3,15,1.8,6,6
"['01', '110011', '00', '010111', '010011']",1,5,10,12,5,22,5.833333333333333,29,30
"['11001', '1', '0101110', '1010', '01000']",1,5,11,11,2,22,4.962121212121212,34,19
"['001101', '111', '100100', '1101011', '11101', '010111', '0101', '01000']",1,8,18,24,5,42,17.412842712842714,80,91
"['0100001', '1', '111101']",1,3,6,8,0,14,0.8434065934065934,15,9
"['010001', '00001', '1110001', '01000', '1011111']",1,5,16,14,4,30,6.22037962037962,30,36
"['011', '110001', '00', '00010', '001001', '0110110']",1,6,17,12,2,29,8.47896547896548,51,41
"['0010110', '1010010', '11001']",1,3,10,9,2,19,1.9047619047619047,8,5
"['1110111', '1111100', '01', '1011110', '0110000', '0001010', '01001']",1,7,19,23,5,42,11.119047619047619,84,53
"['0111000', '011', '100101', '001100', '11100']",1,5,14,13,2,27,6.424009324009324,30,28
"['11', '10111', '110001', '1101011', '1001000', '10011', '0111', '000000', '1010011', '0100']",1,10,26,27,9,53,25.233533133533133,142,157
"['101010', '1111010', '0110']",1,3,7,10,0,17,1.5608391608391607,8,11
"['0', '0111', '000011', '0100']",1,4,9,6,2,15,2.585714285714286,19,17
"['0011', '00010', '1001', '111100']",1,4,10,9,2,19,3.446969696969697,18,14
"['0010', '1001', '0001', '101110']",1,4,10,8,3,18,3.85,15,15
"['11001', '0101110', '100', '010010', '1010111', '110111', '111001']",1,7,16,24,5,40,13.935736485736486,58,63
"['0111000', '0001', '10', '011010', '1111111']",1,5,11,15,2,26,4.286613386613387,41,23
"['0', '10110', '1110']",1,3,4,6,0,10,1.6222222222222222,8,8
"['0111001', '1111011', '11']",1,3,4,12,2,16,1.6031746031746033,12,12
"['11110', '10011', '00001']",1,3,7,8,3,15,1.2,10,7
"['011101', '001101', '10']",1,3,6,8,2,14,1.8333333333333335,9,9
"['1101001', '11000', '011', '10']",1,4,8,9,0,17,3.149206349206349,20,16
"['01101', '1', '100001', '100110', '010111', '000']",1,6,14,13,3,27,7.11976911976912,53,32
"['101', '00', '011', '110111']",1,4,5,9,2,14,3.05,17,12
"['1011', '00', '1', '01000']",1,4,7,5,0,12,2.0825396825396822,18,10
"['0010000', '10001', '000101', '00', '1011']",1,5,16,8,0,24,5.488833388833389,33,27
"['010', '00101', '001000', '0001100', '00']",1,5,17,6,0,23,6.495709845709846,29,53
"['0011', '1', '10', '000000']",1,4,9,4,0,13,2.05,22,12
"['00', '1111101', '011001']",1,3,6,9,0,15,1.3376068376068377,13,5
"['10101', '1', '1100100', '1011000']",1,4,10,10,2,20,2.880952380952381,25,17
"['01', '1001', '10000', '1010', '000010']",1,5,14,7,2,21,6.129653679653679,26,28
"['000100', '001110', '011']",1,3,9,6,2,15,1.7777777777777777,9,10
"['10101', '0111101', '1']",1,3,4,9,0,13,1.0833333333333333,13,10
"['10001', '1001', '10011', '1001010']",1,4,11,10,2,21,4.971717171717172,10,35
"['011111', '001100', '0010', '0101']",1,4,10,10,4,20,3.65,17,18
"['011', '1110100', '0000011', '1101', '1001111']",1,5,12,16,3,28,5.236363636363636,41,35
"['0010', '1011001', '101101', '11', '10001', '0011110', '1001', '100', '000', '0000111']",1,10,25,23,7,48,26.853196803196802,142,132
"['11001', '1010110', '11', '10111', '000000', '1100']",1,6,14,15,2,29,7.3064158064158065,51,45
"['1001001', '00110', '0001001']",1,3,12,7,2,19,2.1904761904761902,7,10
"['010', '1110010', '000011', '010111', '0100100', '000']",1,6,19,13,6,32,8.823687423687424,50,55
"['0001101', '0010', '111']",1,3,7,7,0,14,1.612987012987013,10,5
"['011011', '1100010', '0000', '00010', '0100011', '101110']",1,6,20,15,4,35,9.087323787323788,44,47
"['01', '00001', '11', '1000', '011010']",1,5,11,8,2,19,4.654112554112554,30,22
"['1', '0000100', '00011', '100', '1101010']",1,5,14,9,2,23,4.771428571428571,40,26
"['11001', '1000100', '111010', '10111', '001110', '0111', '011111']",1,7,15,24,5,39,13.242501942501942,61,63
"['101100', '011', '101101', '0001', '110111']",1,5,10,15,3,25,6.104761904761904,28,30
"['0', '1010100', '110100', '0101100', '111001']",1,5,14,13,4,27,5.672161172161172,35,27
"['11110', '001101', '1111010', '010110', '101111', '1110']",1,6,11,23,3,34,10.462315462315463,37,54
"['00', '001', '1011000']",1,3,8,4,0,12,1.6444444444444444,11,11
"['11', '01', '0111001', '1001101']",1,4,7,11,4,18,2.849206349206349,24,18
"['101', '1110', '0100']",1,3,5,6,2,11,1.6428571428571428,6,4
"['01', '11110', '0010', '1001000', '1111000', '0101010', '1011000', '1110110', '110101']",1,9,25,27,5,52,21.31217671217671,118,105
"['1', '0100010', '0001000', '0110', '0010011', '1110', '0111100']",1,7,21,16,6,37,10.770779220779222,83,60
"['0111001', '011', '111', '101000', '1111001', '00']",1,6,12,16,4,28,7.632356532356532,52,44
"['00110', '01101', '10101', '00001']",1,4,11,9,4,20,3.4,14,15
"['11110', '010', '01101', '0011110', '100', '0011011']",1,6,13,17,6,30,9.207142857142857,47,45
"['0', '100', '1011111']",1,3,4,7,0,11,1.15,13,5
"['001101', '10101', '011']",1,3,6,8,0,14,1.962121212121212,7,8
"['11001', '110110', '0110', '10', '11111', '001001', '0100']",1,7,14,18,6,32,12.385930735930735,58,54
"['011101', '010', '000']",1,3,7,5,2,12,1.7777777777777777,8,9
"['010101', '110100', '00011']",1,3,9,8,2,17,1.5757575757575757,8,8
"['101', '010', '0101001', '00011']",1,4,10,8,2,18,3.533333333333333,19,13
"['00', '0101', '001']",1,3,6,3,0,9,2.038095238095238,4,9
"['1101001', '0111000', '001101', '11', '00']",1,5,12,12,4,24,4.722832722832723,39,24
"['001', '1110', '1111']",1,3,3,8,2,11,1.3214285714285714,7,10
"['111111', '001', '1001010']",1,3,6,10,0,16,1.2837606837606836,13,6
"['0010110', '0001001', '001', '101000', '000', '1011']",1,6,19,11,4,30,8.852702852702853,48,52
"['011001', '110', '1111']",1,3,4,9,0,13,1.838095238095238,8,8
"['0001', '1011100', '000']",1,3,9,5,0,14,1.6207792207792209,10,13
"['110', '1111001', '01000', '11']",1,4,7,10,0,17,3.13015873015873,21,15
"['01', '0100111', '100100', '01111', '1001111', '0100']",1,6,14,17,2,31,9.095704295704296,48,50
"['11', '101010', '1000110', '01111', '01001', '01011']",1,6,13,17,3,30,9.107448107448107,43,41
"['0011101', '001101', '111', '001000', '10101', '0000000', '1011', '111000', '11100']",1,9,26,23,7,49,19.55765345765346,115,129
"['010', '000100', '0110']",1,3,9,4,0,13,2.123809523809524,7,14
"['00100', '111', '111101', '1110']",1,4,6,12,0,18,3.381890331890332,17,20
"['0001110', '1100101', '011110']",1,3,9,11,2,20,1.8021978021978022,10,7
"['0', '1010110', '11011', '0101001']",1,4,9,11,2,20,3.0476190476190474,24,10
"['010', '0001110', '000001', '10']",1,4,12,6,0,18,3.154273504273504,22,19
"['1', '10001', '1101110', '010101', '1000011', '010110', '011111']",1,7,16,22,5,38,10.77006327006327,77,56
"['01101', '1110010', '100', '011101', '1000', '000']",1,6,15,13,2,28,9.386546786546786,42,44
"['001', '001101', '1111', '1000', '00010', '0100011', '01000']",1,7,20,14,4,34,11.902830502830502,61,62
"['11011', '1111101', '0011', '1010', '011001']",1,5,9,17,2,26,5.951748251748252,30,29
"['1010110', '1100010', '111110', '000', '010011']",1,5,14,15,4,29,5.386813186813187,34,27
"['0010', '011', '0101010', '00110', '00', '1011']",1,6,14,11,2,25,9.18939393939394,37,47
"['000110', '011100', '11', '1000110', '0000001']",1,5,17,11,4,28,5.366300366300367,38,27
"['11010', '0110100', '1111010', '000', '1010000', '0100']",1,6,19,14,3,33,9.471428571428572,45,55
"['11001', '0111001', '1', '01010']",1,4,8,10,2,18,3.0166666666666666,22,15
"['001', '011000', '00000']",1,3,11,3,0,14,1.4898989898989898,9,15
"['1011', '001010', '01011']",1,3,7,8,0,15,2.216161616161616,6,7
"['01', '011', '1101']",1,3,3,6,0,9,2.038095238095238,5,9
"['001', '10000', '000', '111']",1,4,9,5,3,14,2.5,15,17
"['101', '10', '10011', '0001111']",1,4,7,10,0,17,3.41031746031746,20,18
"['0', '01101', '0001', '100101', '0110010', '000111']",1,6,16,13,2,29,8.465639915639915,48,38
"['101100', '110110', '100001', '10001', '1111', '00', '001100', '101110', '110101']",1,9,22,25,6,47,21.400721500721502,107,105
"['11110', '000101', '10', '0101100', '0000111', '00010', '0001000']",1,7,24,15,5,39,11.937684537684538,72,82
"['11000', '11010', '0100101']",1,3,9,8,2,17,2.1333333333333333,7,8
"['11001', '0011111', '10', '0101', '0001000']",1,5,13,12,2,25,5.090909090909091,38,22
"['0010', '11', '00001', '1011110', '1111000', '1110001']",1,6,15,17,3,32,7.898268398268398,60,42
"['0011', '11000', '010010', '10', '1011']",1,5,11,10,2,21,5.637590187590187,28,25
"['1010000', '1000110', '11']",1,3,9,7,2,16,1.6031746031746033,13,7
"['11001', '1001010', '10110', '0110', '1101100', '0100100', '011110', '111001']",1,8,22,25,7,47,18.357919857919857,77,77
"['0', '101100', '01']",1,3,5,4,0,9,1.4523809523809523,10,6
"['11011', '100', '100010', '00', '01100']",1,5,12,9,2,21,5.764718614718615,30,26
"['001', '111010', '1101110', '100111', '10']",1,5,9,15,2,24,5.24017094017094,35,28
"['11001', '110010', '00', '0001']",1,4,10,7,0,17,3.913852813852814,15,18
"['001', '0101', '10110', '10']",1,4,7,7,0,14,3.376190476190476,14,15
"['0000100', '000000', '111']",1,3,12,4,0,16,1.123076923076923,13,12
"['1111000', '1001', '11100', '00101']",1,4,10,11,2,21,3.4454545454545453,19,18
"['11011', '001', '10001', '0100100', '000000']",1,5,17,9,2,26,5.403768453768453,32,23
"['0011', '110', '011']",1,3,4,6,2,10,2.095238095238095,6,10
"['1111100', '1110111', '10', '0000110', '1110']",1,5,10,17,3,27,5.428571428571429,39,34
"['0', '010011', '001']",1,3,6,4,0,10,1.4523809523809523,10,6
"['11110', '01', '111', '100011', '1100011']",1,5,8,15,0,23,5.2113164613164615,33,45
"['010011', '0000100', '11']",1,3,9,6,0,15,1.3376068376068377,13,6
"['010100', '0110', '1110', '1010011']",1,4,10,11,2,21,3.6283216783216785,17,14
"['0110101', '100', '1001100', '010110', '11111', '011111']",1,6,13,21,4,34,8.44128649128649,49,44
"['01', '00', '1001', '0110111']",1,4,7,8,2,15,3.2676767676767673,19,12
"['1001001', '101100', '11']",1,3,7,8,0,15,1.4059829059829059,11,9
"['11001', '10101', '0110', '1100110', '1110']",1,5,10,15,4,25,6.544949494949495,25,32
"['0', '101', '011000']",1,3,6,4,0,10,1.2301587301587302,11,4
"['010', '0110', '1001011', '0000']",1,4,11,7,2,18,3.6194805194805193,17,14
"['1000011', '10', '011100']",1,3,8,7,0,15,1.4059829059829059,14,5
"['01', '1110010', '111010', '011', '0011', '11000', '000']",1,7,15,15,2,30,11.87120102120102,63,65
"['000011', '0110', '1']",1,3,6,5,0,11,1.2857142857142856,12,4
"['01', '00000', '101010', '1000011', '01110', '0111100']",1,6,18,14,4,32,7.393950493950494,56,39
"['0111000', '0001', '10110', '1111', '10', '10011', '01100']",1,7,15,17,5,32,11.255194805194805,65,50
"['01', '0010', '011100', '0000', '1000011', '010011', '000111', '0111110', '0110011']",1,9,26,23,8,49,20.83907758907759,120,115
"['1010110', '110011', '00', '011111', '110', '0100']",1,6,12,16,2,28,8.001692751692751,50,39
"['0', '11010', '000100', '11']",1,4,8,6,0,14,1.9859307359307359,22,12
"['000011', '1100010', '01111', '0110', '10011', '0010010']",1,6,18,16,4,34,9.214319014319013,47,44
"['1000100', '01', '001', '11']",1,4,8,6,2,14,3.188888888888889,18,14
"['0101111', '001', '11', '110111', '0100']",1,5,8,14,0,22,4.808336108336109,34,30
"['001', '1010011', '11']",1,3,5,7,0,12,1.4444444444444444,11,10
"['110000', '0', '001', '0101011', '1110101']",1,5,12,12,2,24,4.167521367521368,41,23
"['1000110', '100', '11']",1,3,6,6,0,12,1.4444444444444444,11,8
"['01', '011', '1111', '0111110', '0100']",1,5,7,13,2,20,5.51002886002886,29,27
"['001000', '1000000', '00', '011110', '0101100']",1,5,19,9,4,28,5.125152625152626,36,47
"['001', '11', '1010', '10011', '01110', '0100']",1,6,11,12,4,23,8.73015873015873,36,32
"['1010', '000111', '011', '1111']",1,4,6,11,2,17,3.3095238095238093,16,19
"['1110101', '00', '1001111']",1,3,6,10,2,16,1.4603174603174602,14,6
"['0000101', '0110000', '010', '0']",1,4,13,5,2,18,2.7714285714285714,26,22
"['11110', '010000', '010010']",1,3,10,7,2,17,1.5606060606060606,8,12
"['1010010', '01000', '011000']",1,3,12,6,0,18,2.511655011655012,6,12
"['101', '01', '00000']",1,3,7,3,0,10,1.3357142857142859,9,5
"['100', '01100', '1001']",1,3,7,5,0,12,2.2738095238095237,6,8
"['11', '0010', '010', '001000']",1,4,10,5,0,15,3.307142857142857,16,18
"['011', '1011110', '1110011', '0011010', '10100', '110111', '11100']",1,7,15,25,5,40,13.084681984681984,64,66
"['0', '11010', '11011']",1,3,4,7,2,11,1.4666666666666668,9,8
"['01101', '111', '00100', '01010', '001100', '0100']",1,6,16,12,3,28,10.038239538239537,34,51
"['1', '1000110', '0010100', '1010', '000']",1,5,14,8,2,22,4.554545454545455,37,24
"['101001', '110111', '10', '101111']",1,4,6,14,3,20,3.6666666666666665,19,25
"['1001001', '010001', '110']",1,3,9,7,0,16,1.6136752136752137,11,8
"['1011', '0110', '11111']",1,3,3,10,2,13,1.6388888888888888,7,6
"['11', '101', '10100', '1100', '01110']",1,5,8,11,2,19,6.386507936507936,22,24
"['110100', '1010', '10100', '0000', '01001']",1,5,15,9,4,24,6.58080808080808,21,31
"['00', '1111110', '010110']",1,3,6,9,0,15,1.3376068376068377,13,10
"['011101', '100', '1111101', '011']",1,4,6,13,2,19,3.0136752136752136,22,19
"['1011101', '0111001', '01011', '01000']",1,4,11,13,4,24,3.7904761904761903,17,15
"['01', '0010', '00001', '01111', '011101', '100000', '11111', '0011011', '0110010']",1,9,23,24,7,47,19.555405705405704,116,104
"['01', '0101111', '001', '0111011', '1111', '00', '0011100']",1,7,13,19,5,32,10.928571428571429,73,62
"['110110', '0000010', '11100', '10']",1,4,11,9,0,20,2.8841713841713843,23,17
"['010', '11', '1001', '100010', '1100110', '011001']",1,6,14,14,2,28,9.548273948273948,45,40
"['0011101', '1100010', '101', '1111001', '00']",1,5,12,14,3,26,5.533333333333333,40,25
"['000000', '1101', '01100']",1,3,10,5,0,15,1.2303030303030302,10,6
"['101', '10', '000001']",1,3,7,4,0,11,1.4944444444444445,10,8
"['0101', '111000', '000', '11111']",1,4,8,10,0,18,2.627994227994228,20,18
"['1111100', '1100010', '01111', '1010', '01010', '011010']",1,6,15,19,4,34,9.765134865134865,43,56
"['0011001', '11000', '1']",1,3,7,6,0,13,1.25,13,7
"['010', '11000', '101', '10001', '111011', '100110', '11101', '010110', '011010', '1100']",1,10,22,27,9,49,29.227705627705628,117,120
"['00', '100011', '010010']",1,3,9,5,2,14,1.6666666666666665,11,4
"['0', '010110', '1111']",1,3,4,7,0,11,0.6857142857142857,12,4
"['0010', '11', '10100', '001110', '0111', '000', '011010', '01100']",1,8,19,16,6,35,16.9018759018759,68,95
"['101', '1100100', '00', '01001', '1100']",1,5,12,9,0,21,6.0645743145743145,28,28
"['11100', '110', '1100101', '11']",1,4,6,11,0,17,3.8325396825396822,18,24
"['101', '1000', '10']",1,3,5,4,0,9,2.038095238095238,5,9
"['11110', '011', '1100010', '01001', '1001011']",1,5,12,15,4,27,5.530952380952381,34,29
"['0011', '1111110', '10', '0111', '0101']",1,5,7,14,3,21,5.30050505050505,31,26
"['01', '11000', '1010100', '100', '1111', '110111']",1,6,11,16,0,27,7.4610556110556105,48,48
"['01101', '10', '011000']",1,3,7,6,0,13,1.7987012987012987,9,9
"['01', '1001', '1', '0000']",1,4,7,4,2,11,2.5666666666666664,15,11
"['00011', '00111', '100', '101111', '111001']",1,5,10,15,4,25,5.941414141414141,31,35
"['001', '011', '1010101', '010111', '0000011', '10011', '0101']",1,7,17,18,4,35,13.686202686202686,57,66
"['0010', '010101', '100011', '100010']",1,4,13,9,3,22,3.8333333333333335,14,17
"['0010010', '100', '01111', '111']",1,4,8,10,2,18,2.8333333333333335,21,15
"['1000', '1', '10011', '0100']",1,4,8,6,2,14,3.216666666666667,17,13
"['0001101', '1100001', '00', '010']",1,4,12,7,2,19,3.2603174603174603,24,13
"['1011', '1000', '0110110']",1,3,7,8,2,15,1.7727272727272727,9,5
"['1010000', '00011', '1', '1011111']",1,4,9,11,2,20,2.261904761904762,28,19
"['0', '100110', '111000', '001']",1,4,9,7,2,16,2.849206349206349,23,13
"['1101111', '011', '1111000', '01001', '1110']",1,5,9,17,2,26,5.61002886002886,35,34
"['0', '11100', '010111']",1,3,5,7,0,12,1.1645021645021645,13,8
"['010', '1', '110']",1,3,3,4,2,7,1.6666666666666665,5,5
"['0001', '0000', '1011', '0101', '11100', '01100', '001100']",1,7,19,13,6,32,12.286363636363635,49,73
"['11001', '010', '011', '111', '0011', '01111', '1011100', '00010']",1,8,15,20,6,35,16.528787878787877,76,78
"['10111', '00', '101110', '1111']",1,4,5,12,0,17,2.9614718614718614,16,18
"['011100', '10100', '00', '11101', '01001']",1,5,12,11,3,23,6.1103896103896105,27,26
"['101', '1001', '1', '00000']",1,4,8,5,0,13,2.4515873015873018,18,14
"['011100', '111011', '1111', '001010', '01010', '1011', '011000']",1,7,16,21,6,37,12.986868686868688,55,59
"['110000', '01', '0101000', '1000', '0000011', '001001']",1,6,22,10,4,32,8.342751692751692,52,51
"['0', '110', '011111']",1,3,3,7,0,10,1.2301587301587302,11,7
"['010', '11', '101', '00010', '110']",1,5,8,8,3,16,6.035714285714286,21,22
"['0', '01', '011000']",1,3,6,3,0,9,1.4523809523809523,10,9
"['11111', '01', '000', '1010011']",1,4,7,10,0,17,1.8634920634920635,23,12
"['011', '101010', '10100', '110111', '1100110', '000', '01001', '110']",1,8,18,20,7,38,16.62855477855478,78,76
"['101', '1000', '100', '0111']",1,4,7,7,4,14,3.202380952380952,13,17
"['01101', '11', '0100111', '00001']",1,4,9,10,2,19,3.034920634920635,20,16
"['110000', '1100', '0110']",1,3,8,6,2,14,2.15,8,10
"['000110', '011', '00111', '100', '000', '1001100']",1,6,16,11,3,27,8.824281274281274,44,52
"['01', '0111010', '001101', '1010000', '011010']",1,5,15,13,4,28,6.062881562881563,34,32
"['10010', '1', '1001']",1,3,5,5,0,10,1.6222222222222222,8,11
"['1110000', '101011', '110001', '0110', '0111']",1,5,12,15,4,27,5.984498834498835,32,27
"['11110', '1101', '100']",1,3,4,8,0,12,1.7380952380952381,7,7
"['11001', '0111000', '001100']",1,3,10,8,0,18,2.163170163170163,8,6
"['0', '0001', '110111', '1111']",1,4,5,10,2,15,1.9357142857142857,21,16
"['1001110', '0010', '0111001', '11011', '111', '0101', '01000']",1,7,16,19,6,35,12.41132756132756,64,49
"['01', '111', '0011000', '00', '100101', '0111']",1,6,12,12,2,24,7.473537573537573,49,36
"['0', '0110010', '111', '000101', '01001']",1,5,12,10,0,22,4.7433288933288935,36,20
"['00', '011010', '110111', '0111']",1,4,7,11,2,18,3.35,19,16
"['110000', '101', '1100000']",1,3,10,6,0,16,1.7675213675213675,10,14
"['1', '00001', '10010', '1110', '110101']",1,5,10,11,2,21,4.30995670995671,32,25
"['0011100', '011011', '0101011', '1111010', '111111', '10', '110', '0110001']",1,8,17,28,6,45,15.80006105006105,98,82
"['110000', '010100', '10010', '000', '1010010']",1,5,18,9,2,27,6.772299922299922,26,34
"['0100001', '00', '0110', '1010011']",1,4,12,8,2,20,3.3607503607503606,23,11
"['0011001', '101', '111110', '11101', '0000', '110']",1,6,12,16,2,28,7.854179154179154,48,40
"['111', '0110', '10000', '0010101', '000', '0001011']",1,6,17,12,4,29,8.083838383838383,49,44
"['100110', '10', '10011', '0001000']",1,4,12,8,0,20,3.5403485403485404,20,17
"['1100010', '001', '111']",1,3,6,7,2,13,1.5333333333333332,10,8
"['0', '0010', '110', '001101']",1,4,8,6,0,14,3.223809523809524,17,17
"['101', '0101', '011', '01110']",1,4,6,9,2,15,4.2976190476190474,11,16
"['0', '1100010', '1010100', '11']",1,4,9,8,2,17,1.9603174603174602,27,12
"['0', '0100110', '011110']",1,3,7,7,0,14,1.151098901098901,13,15
"['00111', '000110', '101111']",1,3,7,10,2,17,1.9545454545454546,7,7
"['101', '001', '11']",1,3,3,5,2,8,1.8666666666666667,4,9
"['1110111', '0100111', '100001', '0101000', '11', '1101110', '00', '0000010', '1110110', '0101']",1,10,27,29,8,56,23.414629814629812,169,130
"['00000', '1001', '10110', '1111110', '0000011']",1,5,15,13,4,28,4.872582972582973,39,30
"['0', '1011', '01110']",1,3,4,6,0,10,1.4,10,4
"['0111000', '110110', '11110', '11', '101101', '0011', '101110', '101001', '0100']",1,9,19,27,6,46,22.17166167166167,105,96
"['0110100', '01110', '11']",1,3,6,8,0,14,1.8492063492063493,10,6
"['0', '0011', '01010', '0111']",1,4,7,7,2,14,3.216666666666667,15,16
"['0', '0101111', '11']",1,3,3,7,0,10,0.6944444444444444,13,6
"['01', '0000001', '1101110']",1,3,9,7,2,16,1.1746031746031744,16,7
"['1000001', '111', '1110000', '011', '101', '10100', '1000', '10011', '01010', '0110010']",1,10,26,23,9,49,26.84134199134199,134,126
"['1110111', '010001', '000101', '00', '01000', '011000']",1,6,19,13,3,32,8.375235875235875,51,50
"['001', '00001', '1001', '10', '110']",1,5,10,7,2,17,5.580952380952381,23,29
"['11000', '00110', '0010', '0100']",1,4,12,6,4,18,3.7944444444444443,14,26
"['100001', '111', '00110', '1000', '00']",1,5,12,8,0,20,4.98037518037518,31,24
"['0010', '011100', '101', '1000010', '000100', '01011', '0110110']",1,7,22,16,4,38,12.827433677433678,64,62
"['010100', '1111000', '10011', '1100011', '1010010']",1,5,16,16,3,32,6.688311688311688,34,27
"['11001', '01', '001', '00000', '0011']",1,5,12,7,2,19,5.942063492063492,25,29
"['11101', '010001', '011', '10011']",1,4,8,11,2,19,3.5893939393939394,16,20
"['01', '00110', '0001010', '01001', '110', '0110011']",1,6,16,13,4,29,8.996031746031745,49,42
"['10101', '1111', '000001', '0101', '110', '1011111']",1,6,11,18,2,29,7.531357531357531,47,52
"['0', '101011', '010110', '101111']",1,4,7,12,3,19,3.0238095238095237,21,11
"['1000100', '1010110', '111100', '11']",1,4,10,12,2,22,3.333943833943834,22,17
"['011', '001000', '100100', '10000', '00', '11101', '011000']",1,7,21,12,5,33,11.614213564213564,63,70
"['1010100', '1001', '001', '11']",1,4,8,8,0,16,3.3137085137085136,17,18
"['11110', '01', '0010']",1,3,5,6,0,11,1.3968253968253967,9,7
"['110101', '1100101', '101111', '111011']",1,4,7,18,3,25,4.32051282051282,13,38
"['101', '00', '10001']",1,3,6,4,0,10,1.7214285714285715,7,6
"['11010', '0111010', '0011', '0001', '1001', '11111', '001001']",1,7,16,19,5,35,12.013869463869463,58,60
"['01', '00', '100101', '111']",1,4,6,7,2,13,2.5666666666666664,17,11
"['001011', '10000', '111001', '11']",1,4,9,10,2,19,2.8766233766233764,22,20
"['11010', '01001', '0010010']",1,3,10,7,2,17,1.9333333333333333,8,8
"['0001', '01000', '100010']",1,3,11,4,0,15,2.193939393939394,7,8
"['01', '0101111', '1110010', '10', '1010001', '01100']",1,6,14,16,5,30,7.857142857142857,60,36
"['01', '010000', '0011', '11101', '000']",1,5,12,8,0,20,4.834271284271284,31,28
"['0', '11011', '1010', '1001100', '1001111', '1110']",1,6,11,17,4,28,7.893073593073593,49,41
"['01', '10', '1111001']",1,3,4,7,2,11,1.3888888888888888,12,7
"['0010', '0101110', '0100110', '101101', '100', '01111', '0101']",1,7,17,19,4,36,13.337451437451437,57,60
"['0100111', '10000', '1110']",1,3,8,8,0,16,1.4898989898989898,11,8
"['1100100', '1110', '0100']",1,3,8,7,2,15,1.7727272727272727,8,10
"['00111', '0001', '1111', '10', '000']",1,5,9,9,2,18,4.292857142857143,27,29
"['11110', '01', '1001000', '111011', '0001101', '1101010']",1,6,15,19,3,34,7.882950382950383,54,40
"['0', '101', '1100', '010010']",1,4,8,6,0,14,3.0238095238095237,18,10
"['00111', '100', '110']",1,3,5,6,2,11,1.6666666666666665,8,8
"['0010', '100', '01111', '1101110']",1,4,8,11,0,19,3.077994227994228,20,15
"['1000', '011', '10', '1101']",1,4,6,7,2,13,3.09047619047619,13,14
"['1111101', '10111', '010010', '10', '0101', '11100']",1,6,11,18,2,29,8.529648129648129,47,40
"['1101001', '1010111', '10', '000', '001001']",1,5,13,12,2,25,5.354456654456655,36,26
"['001', '111', '0101001']",1,3,6,7,2,13,1.5333333333333332,10,8
"['0111001', '111111', '00', '100011', '111101']",1,5,9,18,3,27,4.707264957264957,37,30
"['01', '10110', '0110000', '00110', '001001', '0111110']",1,6,17,15,4,32,8.91949161949162,50,52
"['011111', '0', '1001010', '110101']",1,4,8,12,2,20,2.552197802197802,25,11
"['11010', '1110000', '10101', '0101011', '01001']",1,5,14,15,5,29,6.485714285714286,30,26
"['111111', '0111010', '1100', '00101']",1,4,8,14,0,22,3.2174048174048173,20,13
"['0010', '010001', '011', '101', '1010100']",1,5,13,10,2,23,5.881474081474082,29,23
"['0001', '0110', '110111', '10', '0000', '110']",1,6,12,11,3,23,7.678571428571429,41,39
"['001', '11', '1000110', '100', '110001', '1101']",1,6,12,13,2,25,8.868653568653569,44,49
"['01', '110010', '110', '0001', '0000001', '0000010', '1100']",1,7,22,11,4,33,11.214296814296814,72,70
"['1010', '001010', '110101']",1,3,8,8,2,16,2.2666666666666666,7,7
"['11100', '10', '1']",1,3,3,5,0,8,1.5714285714285714,8,6
"['001', '1111110', '00', '0000011', '001011']",1,5,13,12,2,25,4.6421245421245425,41,34
"['0101', '10', '001001', '000111']",1,4,10,8,2,18,3.4833333333333334,19,14
"['01', '011000', '11101', '100101', '101110', '0100']",1,6,14,15,3,29,9.015873015873016,46,35
"['0', '111111', '01010']",1,3,4,8,0,12,0.696969696969697,14,4
"['101', '001', '000', '00001']",1,4,10,4,3,14,3.6666666666666665,11,21
"['11110', '010', '0001', '1010', '110']",1,5,9,10,4,19,5.369047619047619,22,29
"['0010', '011', '00111', '101', '00']",1,5,9,8,2,17,5.764285714285714,22,25
"['01001', '010', '00000', '11']",1,4,10,5,2,15,2.6214285714285714,17,12
"['11110', '100001', '10']",1,3,6,7,0,13,1.435064935064935,11,8
"['11110', '000101', '11010', '101111']",1,4,8,14,4,22,3.2818181818181817,16,18
"['0', '110000', '0110011']",1,3,8,6,0,14,1.151098901098901,14,7
"['000100', '011', '00111', '1111', '00', '11101', '1010010', '110']",1,8,16,19,4,35,14.379331779331778,88,80
"['001', '011', '00001']",1,3,7,4,2,11,1.9166666666666665,6,9
"['11110', '111100', '101000', '1001', '110']",1,5,10,14,2,24,6.016378066378066,26,30
"['101011', '01', '010', '111001']",1,4,7,10,2,17,3.5777777777777775,18,13
"['100', '001010', '0100']",1,3,9,4,0,13,2.3238095238095235,6,12
"['1000101', '111010', '100', '00', '101001']",1,5,13,11,2,24,6.075213675213675,32,25
"['1100101', '001010', '111101']",1,3,8,11,2,19,1.8846153846153846,9,7
"['010', '11', '10111', '000', '0011011', '0100']",1,6,12,12,2,24,7.269191919191919,44,38
"['010', '00000', '1000', '100111', '1101', '011010', '1110']",1,7,17,15,5,32,11.562265512265512,59,53
"['101010', '01101', '1010101']",1,3,8,10,0,18,1.9685314685314685,6,13
"['001', '0111010', '10', '0111', '010110', '000', '01100']",1,7,16,14,2,30,11.454057054057055,57,72
"['10001', '10', '1011000', '110', '1001111']",1,5,11,13,2,24,5.6650793650793645,36,31
"['0001001', '0100000', '0000']",1,3,15,3,2,18,2.025974025974026,9,20
"['101110', '00', '1001101', '00001']",1,4,11,9,0,20,2.841047841047841,21,14
"['110010', '1001', '110']",1,3,6,7,0,13,2.038095238095238,7,9
"['011110', '1', '000']",1,3,5,5,0,10,0.7301587301587301,12,4
"['1010111', '00', '010', '011']",1,4,7,8,2,15,3.511111111111111,17,12
"['01', '100', '01010']",1,3,6,4,0,10,1.7214285714285715,7,7
"['1101001', '0010110', '011', '11101', '0111', '0101', '01000', '1111011']",1,8,17,25,7,42,16.744227994227995,83,83
"['001', '101010', '0100010', '1111000', '0001100', '0000010', '000010', '0100001']",1,8,34,16,7,50,17.894627594627593,89,114
"['01011', '01111', '0110100', '11']",1,4,7,12,2,19,3.3539682539682536,18,19
"['11011', '1', '0110000', '1010010', '1100']",1,5,12,12,2,24,5.235497835497836,37,22
"['11000', '11101', '0101000', '11']",1,4,9,10,2,19,3.5206349206349206,19,18
"['0', '101', '111101']",1,3,3,7,0,10,1.4523809523809523,10,6
"['00111', '011101', '1100011', '001100', '110']",1,5,12,15,2,27,6.298135198135198,31,28
"['0101010', '010', '0100011', '001000']",1,4,15,8,2,23,4.119413919413919,18,26
"['01', '001', '111', '101', '10000', '10010']",1,6,11,10,5,21,8.573809523809524,33,40
"['0', '0111001', '0011101', '011', '10101', '010010', '1111', '111101']",1,8,15,24,4,39,15.411460761460761,93,76
"['01001', '11100', '1011000']",1,3,9,8,2,17,2.1,8,7
"['1101', '001', '0110', '1110000']",1,4,9,9,2,18,3.3837662337662335,19,13
"['000111', '100101', '10110']",1,3,8,9,2,17,1.7575757575757573,7,7
"['0100110', '11', '101010', '00', '01110']",1,5,11,11,2,22,4.831279831279831,33,25
"['0010001', '011', '10', '0000']",1,4,11,5,0,16,2.6089466089466087,20,14
"['01', '00', '1101', '00011']",1,4,7,6,2,13,3.087301587301587,15,14
"['0010001', '1001', '10', '000010', '11111']",1,5,13,11,0,24,4.617260517260517,37,23
"['1101001', '11010', '000011', '01111', '1100100', '0111']",1,6,15,19,4,34,9.356288156288157,49,55
"['1', '000011', '000101', '0110', '0010100', '011110']",1,6,17,13,3,30,8.067748917748919,54,40
"['1111100', '011', '110001', '10110', '011000', '0000', '0101001', '110101']",1,8,22,22,5,44,16.823304473304475,86,74
"['01', '00110', '1']",1,3,4,4,0,8,1.5714285714285714,8,4
"['1011001', '0011100', '101111', '11']",1,4,8,14,2,22,3.487789987789988,22,17
"['11', '10', '0100']",1,3,4,4,2,8,1.5,6,4
"['01', '11', '100101', '000010', '1001001']",1,5,13,10,4,23,5.344017094017094,35,27
"['0001', '10100', '1']",1,3,6,4,0,10,1.1777777777777778,10,7
"['000', '111000', '10011', '01010']",1,4,11,8,2,19,3.6075757575757574,18,15
"['1101', '111', '000']",1,3,4,6,2,10,1.1428571428571428,7,6
"['010', '00100', '000', '01110', '1110']",1,5,12,8,4,20,6.207142857142857,21,42
"['1110010', '10010', '011']",1,3,7,8,0,15,1.7333333333333334,10,11
"['00', '10', '101001', '11111']",1,4,6,9,2,15,2.331168831168831,21,11
"['0001011', '111110', '1011001', '0']",1,4,9,12,2,21,2.28021978021978,28,11
"['00', '10', '0101100']",1,3,7,4,2,11,1.3888888888888888,11,10
"['111', '011101', '1010', '100111', '01001', '011010', '01000', '111001']",1,8,18,23,6,41,17.963852813852814,77,80
"['0100010', '000101', '11']",1,3,9,6,0,15,1.7136752136752138,12,4
"['0', '1011', '111']",1,3,2,6,0,8,0.9714285714285714,7,6
"['100101', '01', '011', '1110100']",1,4,8,10,0,18,3.2726495726495726,21,15
"['010101', '110', '011']",1,3,5,7,2,12,1.7777777777777777,8,8
"['10101', '0010011', '111011', '01001', '0101', '101111']",1,6,13,20,4,33,10.447940947940948,36,52
"['010', '1111101', '11', '0000101', '100101']",1,5,11,14,2,25,5.268742368742369,37,30
"['101100', '11000', '1110011', '111011', '10', '1100110', '01001', '0101']",1,8,18,24,6,42,18.056021756021757,82,82
"['0000', '100', '11']",1,3,6,3,0,9,0.9714285714285714,8,6
"['01100', '0011110', '1111', '00110', '01110']",1,5,11,15,3,26,7.016161616161616,22,38
"['1110011', '0111010', '000']",1,3,8,9,2,17,1.7142857142857144,12,4
"['110', '0111', '11']",1,3,2,7,0,9,2.038095238095238,5,11
"['001', '1110000', '001101', '110011', '1110101', '100111']",1,6,15,20,5,35,9.232234432234433,49,57
"['000110', '010', '1']",1,3,6,4,0,10,1.4523809523809523,10,5
"['1111100', '1101', '000100', '01110']",1,4,10,12,0,22,3.285780885780886,21,14
"['10100', '0101110', '00000']",1,3,11,6,2,17,1.5666666666666667,9,10
"['11010', '1', '1011110', '0000', '1100']",1,5,10,11,2,21,4.225757575757576,35,23
"['0101101', '0010111', '0']",1,3,7,8,2,15,1.3571428571428572,14,6
"['0110000', '1', '101101']",1,3,7,7,0,14,1.151098901098901,15,4
"['1101000', '111101', '000']",1,3,8,8,0,16,1.4376068376068376,12,9
"['11011', '111', '0011', '1001', '100011']",1,5,8,14,2,22,6.747907647907648,21,51
"['0101101', '00', '011', '0111']",1,4,7,9,0,16,3.362193362193362,18,17
"['1100', '1', '1100000']",1,3,7,5,0,12,1.3772727272727274,12,10
"['0010110', '1001010', '11', '10010', '0100011', '11100']",1,6,17,16,5,33,9.052380952380952,51,42
"['111100', '100', '011010', '1110', '0100']",1,5,11,12,4,23,6.5285714285714285,23,32
"['10100', '01', '1101011', '1010011']",1,4,9,12,2,21,3.817460317460317,20,21
"['1010110', '000', '1010011', '101001', '0100']",1,5,15,12,2,27,6.81986901986902,25,29
"['000', '110', '10', '101001']",1,4,8,6,2,14,2.922222222222222,15,12
"['0', '1010', '1010110', '11001']",1,4,8,9,0,17,2.8772727272727274,22,14
"['010', '1101010', '1000', '000000', '011111', '1011111']",1,6,16,17,4,33,7.243167943167943,59,43
"['11110', '111011', '00', '000100', '1001011']",1,5,12,14,2,26,4.622349872349872,38,28
"['0', '0101', '11100', '11']",1,4,5,7,0,12,2.4158730158730157,17,12
"['1000001', '0100000', '0101111', '0110', '1101110', '00', '11100']",1,7,21,18,4,39,11.316738816738816,80,57
"['010', '11', '0011', '0110', '1111000', '10', '01110']",1,7,12,15,4,27,12.524963924963924,56,59
"['0', '001010', '01110']",1,3,7,5,0,12,1.3463203463203464,11,13
"['10100', '0110100', '0011000']",1,3,12,7,2,19,2.357142857142857,7,16
"['101', '00', '000001', '01100']",1,4,11,5,0,16,2.7795093795093795,19,16
"['00000', '100', '1001100', '010111', '0001011', '1100011']",1,6,20,15,3,35,8.741414141414142,54,48
"['010001', '000011', '10100', '000111', '1100', '01110']",1,6,18,14,5,32,8.961616161616162,45,42
"['0100010', '100', '1']",1,3,7,4,0,11,1.35,12,4
"['001', '1111101', '1011110', '0001100', '01010']",1,5,13,16,3,29,5.59047619047619,35,22
"['111110', '001100', '0101', '110', '01011']",1,5,10,14,2,24,5.884559884559884,28,28
"['1111100', '1001010', '00011', '1000', '0101100']",1,5,16,14,3,30,6.008658008658008,33,32
"['10', '111', '0111100', '00000']",1,4,9,8,0,17,2.0634920634920633,24,12
"['0010110', '01011', '111', '0011000']",1,4,11,11,2,22,3.5142857142857142,20,15
"['00101', '1000', '1100110', '000', '11100', '101001']",1,6,17,13,2,30,9.587484737484738,40,42
"['11111', '00100', '101', '10000', '10', '1011000', '01110']",1,7,16,16,4,32,10.777777777777777,65,52
"['101', '11000', '100', '0101', '110']",1,5,9,9,3,18,6.444444444444445,19,26
"['0101', '1010011', '0100', '11']",1,4,8,9,2,17,3.648989898989899,17,14
"['1100001', '11110', '111', '000000']",1,4,11,10,0,21,2.647202797202797,24,17
"['0', '1010', '000010', '111111']",1,4,8,9,2,17,1.8523809523809525,26,12
"['0010', '10', '0111', '111']",1,4,5,8,2,13,3.0428571428571427,13,15
"['01001', '1101000', '00000']",1,3,12,5,2,17,1.5666666666666667,8,10
"['1010000', '0110010', '1110011', '101110']",1,4,13,14,3,27,3.857142857142857,18,13
"['10101', '000', '1101010']",1,3,8,7,0,15,1.9333333333333333,9,4
"['101', '110100', '10', '1110']",1,4,6,9,0,15,3.8047619047619046,14,15
"['110110', '011', '00', '11101', '10010']",1,5,9,12,2,21,5.478354978354979,30,22
"['01', '1110000', '111', '111000', '101110']",1,5,10,14,2,24,5.510683760683761,35,35
"['00', '001', '001011', '110101']",1,4,9,8,2,17,3.5777777777777775,18,18
"['010', '1', '10011', '00001']",1,4,8,6,2,14,2.7666666666666666,18,10
"['101100', '01', '1001', '0010010', '001011']",1,5,14,11,2,25,6.0896658896658895,33,25
"['100', '1101100', '110', '101110', '0001000']",1,5,14,12,4,26,6.002197802197802,33,31
"['10001', '010', '00011']",1,3,8,5,2,13,1.8,8,4
"['10100', '00', '1', '0101001']",1,4,9,6,0,15,2.4325396825396823,22,12
"['11', '011101', '00', '01010', '0101']",1,5,9,10,2,19,5.892352092352092,25,25
"['001', '11', '011101', '1000000', '100000', '10']",1,6,16,10,4,26,6.569658119658119,56,44
"['00100', '1001', '011']",1,3,7,5,0,12,1.7380952380952381,8,4
"['1', '100110', '000', '0100011', '0100']",1,5,13,8,0,21,4.87031302031302,34,23
"['11110', '110', '0110100', '000']",1,4,9,9,2,18,2.8333333333333335,19,19
"['110', '1100110', '0111100', '00011']",1,4,10,12,2,22,3.438095238095238,23,19
"['1010', '0010', '0100']",1,3,8,4,3,12,2.25,5,11
"['1110000', '101', '00', '0111', '110', '01011']",1,6,11,13,2,24,7.754184704184704,46,38
"['0', '1001010', '11']",1,3,5,5,0,10,0.6944444444444444,13,4
"['001101', '11', '01111', '010010', '0111', '000']",1,6,12,14,2,26,8.335425685425685,43,41
"['101011', '00', '010000', '1110']",1,4,10,8,2,18,2.6333333333333333,22,13
"['1', '010101', '100011', '01001', '1100', '01011']",1,6,13,14,4,27,8.521933621933622,43,44
"['11011', '0111001', '001111', '0110100', '111010', '1001', '0010101', '1000', '0100001', '1011']",1,10,27,30,9,57,28.05717615717616,135,127
"['0', '100110', '011', '111011']",1,4,6,10,2,16,3.071428571428571,21,13
"['11', '10', '10011', '0110011']",1,4,6,10,2,16,3.365079365079365,19,23
"['001', '10110', '000001', '10', '1011011']",1,5,12,11,0,23,4.737201687201687,35,30
"['1', '0011100', '000', '1110']",1,4,8,7,0,15,2.262987012987013,22,14
"['0010', '0110111', '1111001', '1000010', '10010', '1100']",1,6,17,17,5,34,9.263347763347763,52,44
"['000110', '01', '01100']",1,3,8,5,0,13,1.7987012987012987,10,10
"['0001', '10', '000', '110101', '111001']",1,5,11,10,2,21,5.3126984126984125,30,27
"['00110', '0001', '101101']",1,3,8,7,0,15,1.793939393939394,7,6
"['0011', '011', '101000', '1111001']",1,4,9,11,0,20,3.2624264624264625,22,17
"['00', '01001', '001111', '010']",1,4,9,7,0,16,3.6113275613275615,17,18
"['0010', '00101', '111010', '000101', '1010']",1,5,14,11,4,25,7.06010101010101,22,36
"['011101', '0000001', '01010']",1,3,11,7,0,18,1.3682983682983683,10,8
"['01', '00111', '01111', '0010101', '100111', '0000', '110', '0100']",1,8,18,18,4,36,15.404584304584304,81,79
"['0', '010100', '1101101', '0111', '0100001']",1,5,13,12,2,25,4.860639360639361,38,24
"['10110', '001111', '1111000']",1,3,7,11,0,18,1.8275058275058274,11,10
"['010100', '010', '00101', '101', '0111', '0000', '000111', '110']",1,8,19,15,7,34,15.906132756132756,71,79
"['010', '101010', '0011', '1111', '1011', '1100']",1,6,10,15,4,25,8.516666666666666,35,43
"['1111100', '10001', '10']",1,3,6,8,0,14,1.5158730158730158,13,7
"['0010111', '0011001', '10001', '10', '1010011']",1,5,14,14,3,28,5.428571428571429,35,30
"['0', '001001', '11']",1,3,5,4,0,9,0.7857142857142857,11,4
"['000001', '0010100', '0']",1,3,11,3,0,14,0.9972527472527473,14,10
"['10101', '00010', '00']",1,3,8,4,2,12,1.7428571428571429,9,6
"['00110', '00', '1']",1,3,5,3,0,8,0.9047619047619047,9,6
"['1', '0110100', '0100001', '000111', '111101']",1,5,13,14,4,27,4.2967032967032965,43,23
"['11110', '01101', '0001110', '011011', '10110', '1101100', '0001011', '0101']",1,8,20,26,6,46,18.653846153846153,81,84
"['11010', '011', '11', '001010', '100111', '01100']",1,6,12,15,4,27,9.174675324675324,42,41
"['00010', '000101', '011', '110100']",1,4,12,8,2,20,3.5656565656565657,17,19
"['0010110', '10111', '101', '0000001', '10']",1,5,13,11,2,24,5.216666666666667,38,25
"['1101', '110', '110010', '1101010']",1,4,8,12,0,20,4.574159174159174,14,29
"['0', '0011111', '0000100', '0110001']",1,4,13,9,3,22,2.321428571428571,30,16
"['10111', '111110', '0100101', '00011']",1,4,9,14,2,23,3.1501165501165502,17,16
"['0111', '0011', '10', '01100']",1,4,7,8,2,15,3.321428571428571,15,16
"['0', '001101', '011', '111']",1,4,5,8,2,13,2.7857142857142856,17,12
"['1000010', '0011', '000101', '01010']",1,4,14,8,0,22,4.008624708624708,16,15
"['00', '1100', '0010']",1,3,7,3,2,10,1.8333333333333333,7,13
"['10101', '0111001', '100', '010']",1,4,9,9,2,18,4.033333333333333,17,13
"['1', '0110011', '000101', '1111001', '10000', '0100']",1,6,16,14,2,30,7.730769230769231,57,35
"['00111', '0001101', '000001', '000000', '001100', '111001']",1,6,23,13,4,36,8.976689976689977,42,64
"['00100', '010001', '100000']",1,3,13,4,2,17,1.9393939393939394,8,8
"['00110', '0011110', '1']",1,3,6,7,0,13,1.4166666666666667,12,9
"['0', '11000', '10', '001101']",1,4,8,6,0,14,2.9025974025974026,21,13
"['0', '1110', '011000']",1,3,6,5,0,11,1.2857142857142856,11,8
"['1101', '00', '110']",1,3,4,5,0,9,1.5904761904761904,6,6
"['010', '111011', '1000', '10010', '1100011', '0101']",1,6,14,15,2,29,9.332650682650682,43,39
"['1010', '00010', '10110', '0111']",1,4,9,9,4,18,3.7666666666666666,13,18
"['11010', '0010100', '11111']",1,3,7,10,2,17,1.5999999999999999,10,6
"['110', '10010', '000000', '11']",1,4,10,6,0,16,2.639105339105339,20,13
"['10001', '1101', '11101', '011']",1,4,6,11,2,17,3.726984126984127,13,26
"['001001', '0110', '00', '01010', '111000', '0110110', '0100']",1,7,20,14,4,34,13.768359418359418,57,85
"['01', '010', '0111011', '10000', '110100', '110']",1,6,13,13,2,26,8.124331224331224,48,39
"['110000', '11', '100', '000', '001011']",1,5,12,8,4,20,4.844444444444444,32,34
"['1', '101010', '10100', '001010', '1011']",1,5,11,11,2,22,5.841125541125541,28,30
"['1011110', '00110', '011', '10']",1,4,7,10,0,17,3.4325396825396823,19,17
"['1100', '111', '1101010']",1,3,5,9,0,14,1.8987012987012988,9,12
"['000110', '01', '111']",1,3,5,6,0,11,1.3444444444444446,10,4
"['011', '00111', '0001', '011101', '1000', '11111', '011111']",1,7,12,21,6,33,11.67027417027417,58,72
"['0010001', '01011', '0']",1,3,8,5,0,13,1.25,13,6
"['001100', '0011', '101']",1,3,7,6,0,13,1.8158730158730159,8,8
"['10101', '100', '0110', '111101']",1,4,7,11,0,18,3.3557720057720055,16,13
"['111', '011', '001000', '100', '01010', '001100', '110']",1,7,16,13,6,29,12.343434343434343,54,59
"['0111', '10101', '011110', '0']",1,4,6,10,0,16,2.8493506493506495,20,13
"['01', '001000', '1111', '100101', '0111', '1011111']",1,6,11,18,4,29,7.884887334887335,51,45
"['11001', '01111', '010010', '010111']",1,4,9,13,4,22,3.812121212121212,14,18
"['1111100', '1110111', '010', '011', '10110', '10000', '010101', '000100']",1,8,20,22,8,42,15.375663225663226,93,74
"['11110', '010011', '1']",1,3,4,8,0,12,0.9826839826839826,13,7
"['110110', '01', '1001', '00', '1011', '0111100']",1,6,11,14,4,25,8.578515928515928,46,32
"['00', '01001', '1', '010110']",1,4,8,6,0,14,2.4177489177489178,20,12
"['11010', '11000', '000101', '00', '1111011']",1,5,12,13,2,25,5.384193584193584,35,30
"['11101', '1', '10000', '011100']",1,4,8,9,2,17,2.625108225108225,21,11
"['1000011', '010011', '0011111']",1,3,9,11,2,20,1.9560439560439562,9,11
"['1100', '1', '0110']",1,3,4,5,2,9,1.55,8,4
"['1011010', '011', '11', '1101000', '10101', '100101']",1,6,13,17,2,30,9.210617160617161,46,48
"['1001110', '11011', '0110111', '011011', '101', '1111', '01010']",1,7,12,25,4,37,14.484781884781885,53,69
"['01', '11', '111011', '000', '01001']",1,5,8,10,2,18,4.310533910533911,30,24
"['1101000', '0011101', '0001', '1101010']",1,4,13,12,3,25,3.454545454545454,21,21
"['010', '001', '1010100', '0110', '00']",1,5,12,7,2,19,6.16998556998557,25,33
"['01', '1101110', '1010', '00', '011001']",1,5,10,11,2,21,5.6648795648795645,34,23
"['0', '0010', '1000111', '010011', '01011']",1,5,12,11,0,23,5.426157176157176,34,24
"['0001100', '01', '01100', '0000']",1,4,13,5,0,18,3.354256854256854,18,32
"['00', '0001', '1111']",1,3,5,5,2,10,0.9166666666666666,9,6
"['10111', '00110', '001', '11']",1,4,6,9,2,15,3.392857142857143,15,14
"['0', '1111010', '010']",1,3,5,6,0,11,1.35,12,10
"['0001', '0011010', '110100']",1,3,10,7,0,17,1.7146853146853147,10,9
"['1110010', '0001', '100', '1000111', '111011', '111110']",1,6,13,20,4,33,8.08982128982129,51,52
"['00111', '0110', '11101', '10', '01011', '0100']",1,6,11,14,5,25,9.067460317460316,37,38
"['0010', '11', '011011', '11000', '0001', '00110', '0010010', '0101', '1011111']",1,9,22,22,7,44,20.803207903207902,112,99
"['100', '10000', '011110', '000', '0101', '1001111', '01000']",1,7,19,14,4,33,12.433300033300034,63,66
"['0', '00101', '10011', '100111']",1,4,8,9,2,17,3.3887445887445886,18,15
"['0', '1000', '0111001', '1100100']",1,4,11,8,2,19,2.8870129870129873,26,13
"['0', '0110101', '0000001', '1101']",1,4,11,8,2,19,2.2766233766233768,26,14
"['000110', '101100', '0101110', '001110', '0101001']",1,5,17,15,5,32,7.188644688644689,24,40
"['00', '001', '110', '11']",1,4,5,5,4,10,2.7333333333333334,11,14
"['0001010', '1101', '000101', '10']",1,4,11,8,0,19,3.6796425796425796,19,18
"['100', '0100000', '001', '0110']",1,4,12,5,2,17,3.3549783549783547,19,18
"['0', '110', '0111', '100010']",1,4,7,7,0,14,2.6015873015873017,19,14
"['01111', '11100', '000100', '110']",1,4,9,10,2,19,3.2035353535353535,19,19
"['010001', '11', '10', '0101', '01110']",1,5,9,10,2,19,5.988311688311688,26,24
"['0010', '001101', '1110', '0100']",1,4,10,8,3,18,3.55,14,19
"['01', '0101000', '0000100', '11111']",1,4,12,9,2,21,2.388888888888889,28,14
"['0010', '100', '10']",1,3,6,3,0,9,2.038095238095238,5,9
"['0', '1110010', '100110', '1101', '000100']",1,5,13,11,2,24,4.833316683316683,38,20
"['111110', '0101', '0000']",1,3,7,7,2,14,1.1,11,6
"['1', '0110', '0100', '1000', '1100', '111101', '110101']",1,7,13,16,6,29,11.688095238095238,58,49
"['11100', '00', '110']",1,3,5,5,0,10,1.7214285714285715,7,9
"['01', '11', '11000', '100101', '0100101']",1,5,11,11,2,22,5.563048063048063,33,32
"['0', '111000', '001011']",1,3,7,6,2,13,0.9047619047619047,14,8
"['0', '0011', '01001']",1,3,6,4,0,10,1.4,9,6
"['101', '1101', '1110', '11111']",1,4,3,13,2,16,4.011904761904762,12,27
"['110100', '10000', '01110']",1,3,9,7,2,16,1.4909090909090907,9,7
"['00', '10', '1111']",1,3,3,5,2,8,0.8333333333333333,8,4
"['0', '1110101', '1010']",1,3,5,7,0,12,1.3772727272727274,12,4
"['0001001', '11010', '010', '0101110', '011']",1,5,13,12,4,25,5.888095238095238,33,31
"['101101', '0001', '0001111', '100000', '110111', '11111', '0101']",1,7,16,22,5,38,10.737762237762238,65,75
"['0010', '100001', '101', '000010', '1110']",1,5,14,9,4,23,5.787301587301587,28,24
"['0', '1001110', '1101111', '10001', '0001111', '100011']",1,6,14,19,3,33,8.408175158175158,53,46
"['0001', '010', '011']",1,3,6,4,2,10,1.8095238095238093,5,7
"['00111', '1000', '0101']",1,3,7,6,2,13,1.6111111111111112,9,7
"['100110', '00011', '0001', '100010']",1,4,13,8,2,21,4.576767676767677,11,18
"['0100', '10100', '01010', '1001011', '0110011']",1,5,15,13,4,28,7.064790764790764,27,28
"['1101001', '01', '1110010', '11', '0001111', '00']",1,6,12,15,6,27,7.0,61,41
"['01', '0001', '0001111', '10010', '000', '0111110']",1,6,15,13,2,28,8.43932178932179,50,46
"['1101', '000101', '1']",1,3,5,6,0,11,1.2857142857142856,11,10
"['001', '010', '11000', '110', '0100']",1,5,11,7,3,18,6.083333333333333,21,30
"['011', '101101', '100110', '1010', '010111', '0101']",1,6,12,17,5,29,10.711904761904762,36,43
"['101100', '00011', '001000']",1,3,11,6,2,17,1.7575757575757573,9,12
"['110000', '111100', '011100', '00111', '0001']",1,5,14,13,3,27,5.869696969696969,32,38
"['0010', '11', '110011', '001110', '01011']",1,5,10,13,2,23,6.092640692640693,30,28
"['1011', '010001', '100000', '001011']",1,4,13,9,3,22,3.466666666666667,19,17
"['1010111', '01111', '110']",1,3,4,11,0,15,1.5666666666666667,9,10
"['011101', '0001', '010011', '1101']",1,4,9,11,4,20,3.4000000000000004,15,19
"['01', '11', '1001', '10000', '111011', '001010']",1,6,12,13,4,25,7.6805194805194805,47,38
"['1011110', '01000', '0']",1,3,7,6,0,13,1.0833333333333333,14,8
"['101100', '110010', '011', '10000', '00110', '10100', '10010', '000', '1011', '1001011']",1,10,27,22,8,49,28.174442224442224,111,143
"['0001011', '011000', '110100', '0']",1,4,12,8,2,20,2.577838827838828,26,19
"['1011010', '11011', '11', '101', '100', '0101010']",1,6,11,16,4,27,9.024603174603174,46,41
"['1011', '1000', '0111110']",1,3,6,9,2,15,1.4090909090909092,11,5
"['1100', '10011', '1110', '11']",1,4,5,10,2,15,3.765873015873016,14,23
"['11010', '10', '000001']",1,3,8,5,0,13,1.185064935064935,12,7
"['0', '0011', '0111']",1,3,4,5,2,9,1.55,7,7
"['0101110', '11', '0110', '10000', '110100', '10100', '110101']",1,7,17,18,4,35,12.564679764679765,59,56
"['010', '100110', '00110', '100000', '10', '011111']",1,6,15,13,3,28,8.26031746031746,49,47
"['0', '001', '0110', '111010']",1,4,7,7,0,14,2.8015873015873014,19,15
"['00', '1110', '1111']",1,3,3,7,2,10,1.0833333333333333,8,8
"['101100', '010001', '00', '111110', '10']",1,5,11,11,5,22,4.916666666666667,36,24
"['1001111', '00', '10', '01010']",1,4,8,8,2,16,3.0317460317460316,21,12
"['01101', '101', '00', '100000', '0011011']",1,5,13,10,0,23,5.214979464979465,35,26
"['11010', '0001', '01000']",1,3,9,5,2,14,1.711111111111111,7,8
"['0010110', '1010', '10011', '0']",1,4,9,8,0,17,2.862121212121212,21,12
"['01', '0000011', '1110']",1,3,7,6,0,13,1.1414141414141414,14,7
"['11001', '1010', '00', '110', '1110']",1,5,8,10,2,18,5.983333333333333,20,26
"['1011', '0111111', '1111011']",1,3,3,15,2,18,2.1298701298701297,9,17
"['1011010', '00010', '0010000']",1,3,13,6,2,19,1.9047619047619047,9,13
"['0', '1000100', '11110', '11010', '111', '1010011']",1,6,12,16,4,28,6.780952380952381,54,41
"['010', '0100111', '010011', '00', '01001']",1,5,13,10,0,23,6.998040848040848,26,42
"['0001110', '00', '1', '0111100']",1,4,9,8,2,17,2.1031746031746033,27,17
"['0', '100011', '111']",1,3,4,6,0,10,0.7301587301587301,11,6
"['000110', '11101', '000', '00011']",1,4,11,8,2,19,3.521212121212121,18,23
"['11', '011110', '000', '001100', '1101']",1,5,10,11,2,21,4.93015873015873,31,22
"['101100', '0101', '0101000']",1,3,10,7,0,17,2.0965034965034963,8,10
"['001101', '0100010', '1011110', '0110', '110']",1,5,13,14,2,27,6.580552780552781,31,32
"['01101', '1001', '111001']",1,3,6,9,0,15,1.9717171717171718,6,13
"['111', '101101', '00100', '0010100', '00', '001110', '110']",1,7,17,15,4,32,11.456549006549006,65,68
"['01', '0111010', '0111', '000', '1110']",1,5,9,11,2,20,5.22041847041847,30,30
"['00111', '10001', '0110', '1010000', '110']",1,5,13,11,2,24,5.513708513708513,32,23
"['101', '01', '1110110', '001']",1,4,6,9,2,15,3.7111111111111112,17,15
"['0', '01101', '001', '01010', '1110']",1,5,9,9,2,18,4.7634920634920634,26,25
"['101001', '1000', '1110']",1,3,7,7,2,14,1.5,7,7
"['1101', '00', '000011', '1111']",1,4,7,9,2,16,2.3833333333333333,20,17
"['1001110', '00010', '110']",1,3,8,7,0,15,1.7666666666666666,10,10
"['01', '10101', '000']",1,3,6,4,0,10,1.4714285714285715,8,5
"['0', '00001', '101101']",1,3,7,5,0,12,0.9826839826839826,12,5
"['110011', '00', '0001']",1,3,7,5,0,12,1.7666666666666666,9,6
"['011101', '1', '10000']",1,3,6,6,0,12,0.9826839826839826,13,6
"['0', '101', '00111', '111010']",1,4,6,9,0,15,2.831168831168831,21,12
"['101100', '0100100', '0011100']",1,3,12,8,2,20,1.9560439560439562,7,17
"['001', '11', '101101', '01111', '1010', '1000']",1,6,10,14,2,24,8.102669552669553,39,40
"['011011', '0111', '0']",1,3,4,7,0,11,1.4857142857142858,10,9
"['0010', '11', '101', '00110', '1110', '0100']",1,6,11,11,3,22,8.66904761904762,32,36
"['11', '1101011', '01000', '0010011']",1,4,10,11,2,21,3.0555555555555554,24,20
"['100', '01011', '0111', '1111']",1,4,5,11,2,16,2.9325396825396823,13,20
"['1100111', '00010', '10110', '111']",1,4,8,12,2,20,2.95,19,17
"['11', '100', '00110', '0110010', '0111100']",1,5,12,12,2,24,5.6079365079365076,35,27
"['101', '0010', '001000']",1,3,9,4,0,13,1.8158730158730159,8,8
"['0', '00100', '111', '0111110']",1,4,7,9,0,16,1.9333333333333333,25,12
"['11001', '00100', '1', '01011']",1,4,8,8,3,16,2.6,20,11
"['0100111', '0110111', '101000', '0011110', '0111', '111000']",1,6,16,21,5,37,9.223942723942724,51,54
"['0', '111', '101111']",1,3,2,8,0,10,0.9523809523809523,11,8
"['10100', '1', '00011']",1,3,6,5,2,11,1.0666666666666667,12,7
"['0110', '111', '01000', '111100']",1,4,8,10,0,18,3.30021645021645,17,16
"['01', '0111000', '00', '11100']",1,4,9,7,2,16,3.079365079365079,20,20
"['01', '100011', '1', '011001']",1,4,7,8,2,15,2.9047619047619047,22,16
"['00', '1', '001011']",1,3,5,4,0,9,0.7857142857142857,11,6
"['01111', '1000101', '10110', '0000']",1,4,11,10,2,21,2.993939393939394,20,11
"['00', '0110', '111']",1,3,4,5,0,9,1.2380952380952381,7,4
"['100001', '1', '101101', '10010', '0000010', '0111', '01100']",1,7,19,15,4,34,10.633705183705183,71,49
"['01', '001', '00111', '000101', '0000000', '1011011']",1,6,18,12,2,30,7.8446719946719945,54,44
"['010100', '001001', '000001']",1,3,13,5,3,18,1.6666666666666667,6,11
"['01', '01111', '0001000', '11']",1,4,8,8,2,16,2.642857142857143,23,13
"['00011', '00111', '101', '10000', '100000', '1011', '001001']",1,7,20,14,5,34,12.364213564213564,57,74
"['0', '001111', '011', '1110']",1,4,5,9,0,14,3.0238095238095237,18,16
"['100', '010101', '10', '01001', '01011']",1,5,11,10,2,21,6.977705627705627,22,29
"['0010001', '00110', '100', '1']",1,4,10,6,0,16,2.85,22,14
"['1101110', '00', '1100101', '10', '1100110']",1,5,11,14,5,25,5.595238095238095,37,30
"['111011', '101', '0011110', '110101']",1,4,7,15,2,22,3.6435897435897435,21,16
"['00110', '11011', '00000']",1,3,9,6,3,15,1.4,9,6
"['1001010', '1011110', '101000', '0100010', '00110', '111110', '10', '1011']",1,8,21,23,5,44,15.860972360972362,87,91
"['1010111', '1011', '01', '1100101']",1,4,7,13,2,20,3.5425685425685423,21,24
"['1010', '00', '1', '0111']",1,4,5,6,2,11,2.3,16,10
"['1011', '1100001', '0111']",1,3,6,9,2,15,1.8409090909090908,11,11
"['00111', '00010', '1', '01']",1,4,7,6,2,13,3.076190476190476,17,11
"['1000010', '0100011', '11100', '1001010']",1,4,15,11,3,26,3.5,18,17
"['011101', '10', '101001', '1101110']",1,4,8,13,2,21,3.3290598290598292,23,15
"['1100010', '010101', '1']",1,3,7,7,0,14,0.9972527472527473,14,6
"['101100', '011', '101101', '0110', '00', '10', '0100']",1,7,14,13,6,27,13.311904761904762,49,59
"['0110101', '111', '0100010', '111011', '01110', '0011100']",1,6,15,20,3,35,9.78056943056943,48,37
"['01101', '00000', '11000', '00100', '0011', '110011', '10100', '1101', '0110001']",1,9,26,20,7,46,22.13993783993784,94,115
"['001', '1', '0100']",1,3,5,3,0,8,1.4714285714285715,7,5
"['0', '10', '011']",1,3,3,3,0,6,1.5666666666666667,5,6
"['01', '111110', '001101', '000']",1,4,8,9,2,17,2.5388888888888888,23,15
"['1', '00001', '101000', '101', '01011']",1,5,11,9,2,20,4.85995670995671,31,27
"['00111', '10001', '10110']",1,3,7,8,3,15,1.7999999999999998,8,7
"['101010', '01101', '110', '00011']",1,4,9,10,2,19,3.385353535353535,18,14
"['0011010', '00', '1', '011']",1,4,7,6,0,13,2.1944444444444446,21,12
"['001', '100', '11']",1,3,4,4,2,8,1.4666666666666668,6,7
"['0010110', '11', '1110011', '000', '01011']",1,5,11,13,2,24,5.031746031746032,37,27
"['0001010', '001001', '0001100']",1,3,14,6,2,20,2.3956043956043955,8,15
"['0010', '0110', '000']",1,3,8,3,2,11,2.1785714285714284,4,15
"['11', '00001', '01111', '1110101', '1111010']",1,5,9,17,4,26,5.003174603174603,37,36
"['0', '10001', '1100110', '1101110']",1,4,9,11,2,20,2.857142857142857,24,14
"['1', '1001010', '0011111', '0111101', '01000']",1,5,12,15,3,27,4.583333333333333,44,20
"['0101011', '1111', '1000', '10', '011001', '1100']",1,6,12,15,3,27,8.027195027195027,43,38
"['101011', '1101000', '01010']",1,3,9,9,0,18,2.0093240093240095,8,5
"['0', '011110', '11111']",1,3,3,9,0,12,1.012987012987013,12,4
"['01', '10110', '1001101', '001000']",1,4,11,9,0,20,3.51004551004551,20,12
"['0', '1001', '010110', '011100']",1,4,9,8,2,17,2.838095238095238,22,13
"['0011101', '0011', '0010100', '11111', '1010010']",1,5,14,16,3,30,5.944444444444445,34,29
"['10111', '000111', '100111']",1,3,6,11,2,17,2.4696969696969697,4,19
"['101011', '1100', '100111']",1,3,6,10,2,16,2.033333333333333,9,12
"['011111', '1110101', '0001', '110']",1,4,7,13,0,20,2.863025863025863,22,17
"['0101010', '1', '0001000']",1,3,10,5,2,15,1.2142857142857144,14,4
"['01101', '10010', '111010']",1,3,7,9,2,16,2.0545454545454547,7,8
"['1001111', '01', '111']",1,3,3,9,0,12,1.4444444444444444,11,12
"['0', '1101000', '110', '01']",1,4,7,6,0,13,2.861111111111111,20,14
"['0', '1010', '10011', '1001101']",1,4,8,9,0,17,3.028787878787879,20,16
"['100', '001010', '0011100', '1111']",1,4,10,10,0,20,3.267066267066267,20,17
"['0010110', '00', '111000', '1']",1,4,9,7,0,16,2.0955433455433456,26,15
"['00', '10010', '010111']",1,3,7,6,0,13,1.6168831168831168,10,6
"['1', '10011', '10']",1,3,3,5,0,8,1.5714285714285714,8,9
"['0010111', '1001000', '1110100', '110', '01011']",1,5,14,15,3,29,5.447619047619048,37,30
"['110110', '0101111', '1111', '11101', '1101']",1,5,6,20,2,26,7.243162393162393,23,52
"['00101', '100', '10', '0000', '0001011', '110101']",1,6,16,11,0,27,8.757231657231657,45,44
"['01', '111010', '00', '1000', '110']",1,5,9,8,2,17,5.138095238095238,26,24
"['1000', '0101111', '1']",1,3,5,7,0,12,1.0136363636363637,14,6
"['11011', '011011', '101', '11111', '0001011', '111001']",1,6,10,22,4,32,9.971678321678322,38,71
"['11110', '100', '100000', '1111']",1,4,8,10,0,18,2.904906204906205,19,21
"['1', '101', '1010111', '010101', '1100110']",1,5,9,15,2,24,5.251282051282051,39,31
"['011111', '100000', '1011100']",1,3,9,10,2,19,1.2435897435897436,12,8
"['0011011', '000110', '1010', '01001']",1,4,12,10,0,22,3.8086247086247087,19,14
"['0', '10', '10011', '1111']",1,4,4,8,0,12,2.349206349206349,17,13
"['1011101', '00', '010', '10011']",1,4,8,9,0,17,3.3825396825396825,19,9
"['001010', '0000011', '01110']",1,3,11,7,0,18,1.8426573426573427,10,10
"['00', '1110010', '100011', '0100']",1,4,11,8,0,19,3.371950271950272,22,13
"['0010110', '110110', '0010111', '101', '0011110', '00010']",1,6,17,18,3,35,9.405028305028305,42,54
"['0111000', '11010', '010101', '10']",1,4,10,10,0,20,3.5251970251970253,20,14
"['0010111', '1', '111100', '10001', '10110', '10100']",1,6,13,16,3,29,7.663919413919414,53,42
"['1111', '0000111', '111001', '0111100']",1,4,9,15,2,24,3.874925074925075,22,21
"['0', '1100', '111101']",1,3,4,7,0,11,1.2857142857142856,11,5
"['110011', '011', '11']",1,3,3,8,0,11,1.9666666666666668,8,17
"['111011', '1000', '1111']",1,3,4,10,2,14,1.4500000000000002,9,14
"['111100', '0110100', '0011110', '1001', '0011100']",1,5,15,16,3,31,6.8187812187812185,31,37
"['0', '1110111', '101011', '1101000', '010010', '001010', '1100110']",1,7,19,21,6,40,11.607142857142858,76,53
"['0011', '01', '00101', '111']",1,4,6,8,0,14,3.598412698412698,13,17
"['10001', '100', '001', '1110100']",1,4,10,8,2,18,3.6666666666666665,19,20
"['1110001', '0010010', '011', '0100']",1,4,12,9,2,21,3.4155844155844157,22,13
"['0010110', '011', '1110011', '00', '011000']",1,5,13,12,2,25,5.457753357753358,37,30
"['110010', '10101', '10110', '11101', '110111', '1011', '010011']",1,7,13,24,6,37,14.444444444444445,44,81
"['1101001', '00000', '11101', '001010', '01010', '1010011', '1100']",1,7,21,18,5,39,12.468720168720168,59,53
"['0', '1011010', '010001', '1010111', '1100101']",1,5,13,15,3,28,4.585164835164835,41,22
"['110', '000010', '11']",1,3,6,5,0,11,1.4944444444444445,10,7
"['111', '10000', '1111110', '101110', '0101001']",1,5,11,17,2,28,5.165784215784216,37,28
"['01', '10', '0111100']",1,3,5,6,2,11,1.3888888888888888,12,7
"['00', '01001', '01111']",1,3,6,6,2,12,1.457142857142857,9,7
"['0101101', '0010', '0100110', '0000']",1,4,14,8,4,22,3.9707792207792205,16,23
"['0001101', '100110', '1001', '1']",1,4,9,9,0,18,3.0503996003996003,22,18
"['11010', '011101', '001010', '000', '0101001', '001100', '1001011']",1,7,22,18,5,40,13.673881673881674,63,57
"['101', '10000', '0000011', '000', '1011011', '001011']",1,6,18,13,4,31,8.106310356310356,49,54
"['000110', '110', '01010']",1,3,8,6,0,14,1.893939393939394,7,12
"['010100', '110', '000']",1,3,8,4,2,12,1.222222222222222,8,10
"['101100', '01101', '1111000', '0010011', '01000']",1,5,16,14,4,30,6.201065601065601,30,30
"['100111', '000011', '11']",1,3,6,8,2,14,1.6666666666666665,10,13
"['0111000', '010', '001', '011', '00011', '000001', '0101', '01011']",1,8,21,15,5,36,17.294727494727493,73,92
"['01', '000111', '1110']",1,3,5,7,0,12,1.4333333333333333,11,8
"['11', '101011', '0000011', '0111', '1110']",1,5,9,14,2,23,5.552253302253302,33,38
"['0110', '0111011', '0001111']",1,3,7,11,2,18,1.987012987012987,10,9
"['0101000', '0110011', '0111', '1000011', '1111011']",1,5,14,18,4,32,5.792207792207792,34,36
"['0011110', '0111010', '1']",1,3,6,9,2,15,1.3571428571428572,14,5
"['11', '100010', '010111', '0100001', '1110']",1,5,12,13,2,25,5.359362859362859,36,29
"['11001', '1101101', '110', '0']",1,4,6,10,0,16,3.2666666666666666,20,17
"['01', '101101', '00111', '11', '1100001', '11101']",1,6,10,17,4,27,8.693018093018093,47,60
"['0', '0011011', '1110111', '1001010']",1,4,9,13,3,22,2.75,28,12
"['11001', '101100', '0011000', '011011', '101000', '1110']",1,6,17,17,3,34,10.014452214452215,39,40
"['000110', '11010', '011011', '00', '101001']",1,5,13,12,3,25,6.071428571428571,33,22
"['01', '100111', '0000', '00010', '111101', '011000']",1,6,16,13,3,29,7.448196248196248,51,40
"['00011', '110100', '1111']",1,3,6,9,0,15,1.408080808080808,10,12
"['01', '1110010', '11', '10011', '1100111']",1,5,8,15,4,23,5.634920634920634,35,40
"['0111000', '111100', '1011', '110', '1110']",1,5,9,15,2,24,6.437196137196137,27,28
"['0010000', '00110', '10010', '000', '110']",1,5,16,7,4,23,6.216666666666667,27,41
"['00111', '00', '011', '10000']",1,4,9,6,2,15,2.942857142857143,18,18
"['1010000', '1100', '10110', '0111']",1,4,10,10,2,20,3.590909090909091,18,16
"['101', '1010', '1100']",1,3,5,6,2,11,2.1785714285714284,5,8
"['0010', '1110011', '100', '11101', '011001', '011111', '110', '101110', '01000']",1,9,19,26,7,45,21.804784104784105,105,94
"['11', '1100000', '1010101', '1010', '00', '00010', '111001']",1,7,18,15,4,33,11.021966921966921,72,55
"['0', '0010001', '01101', '0111', '0101', '110']",1,6,12,12,2,24,8.643362193362194,42,39
"['01', '1111100', '00']",1,3,5,6,2,11,1.1666666666666665,12,8
"['0010', '011', '0001', '000', '01110', '0100']",1,6,15,8,5,23,9.36111111111111,29,58
"['001001', '101', '110011', '001110', '0100011', '11100']",1,6,16,17,3,33,9.30940170940171,49,40
"['00111', '0010', '1', '01110']",1,4,7,8,2,15,3.2,17,13
"['11000', '100', '00', '1100', '01110']",1,5,11,8,2,19,6.872222222222222,21,35
"['0001001', '1', '1010', '110', '0001000']",1,5,14,8,2,22,4.71948051948052,37,26
"['0', '10111', '10010', '10110']",1,4,7,9,3,16,3.2,16,16
"['0110000', '0001', '1010010', '100']",1,4,14,7,2,21,3.7584415584415583,20,17
"['0000110', '110', '00000']",1,3,11,4,0,15,1.6833333333333333,10,16
"['0110101', '1', '1011001', '001111', '010010', '1000010', '00010', '01110']",1,8,23,21,7,44,15.997186147186147,94,72
"['110', '111100', '10', '010111']",1,4,6,11,2,17,3.411111111111111,20,17
"['00100', '11000', '010', '1111']",1,4,9,8,2,17,2.802380952380952,18,14
"['0010', '1001', '10010']",1,3,8,5,2,13,2.5277777777777777,4,10
"['11110', '0001110', '00100', '0001', '0110', '1100101', '1011000', '01000']",1,8,25,19,8,44,17.021356421356423,84,92
"['0001001', '0001010', '1100', '10']",1,4,13,7,2,20,3.3217893217893217,22,19
"['0', '101', '11011', '111101']",1,4,4,11,0,15,3.262987012987013,18,16
"['101100', '110110', '00001', '10', '101001']",1,5,13,12,3,25,5.573593073593074,33,28
"['10111', '111110', '111101']",1,3,3,14,2,17,1.9242424242424243,6,15
"['1001001', '11010', '110', '1']",1,4,7,9,0,16,2.9,21,17
"['0001010', '00', '010', '1111000']",1,4,12,7,2,19,3.1174603174603175,24,26
"['0010', '1110010', '0110100', '0000000', '10', '0101', '01011']",1,7,22,14,5,36,11.719696969696969,72,64
"['011', '1111', '00110', '1010001', '1011']",1,5,9,14,2,23,6.162409812409813,26,28
"['010011', '110', '111', '000']",1,4,7,8,3,15,2.333333333333333,16,15
"['11011', '1110011', '100110', '00', '1110']",1,5,9,15,0,24,5.905450105450106,30,31
"['001', '111010', '011', '11', '1000', '0100']",1,6,11,11,4,22,7.872222222222222,39,37
"['101', '10110', '1001011']",1,3,6,9,0,15,2.0166666666666666,9,12
"['01', '011', '111', '0000', '1001111', '0110011']",1,6,11,15,4,26,7.216161616161616,53,44
"['0', '11101', '0110', '10000']",1,4,8,7,2,15,2.5777777777777775,19,10
"['0', '110010', '101010', '1101', '1101010']",1,5,11,13,2,24,5.861521811521811,30,34
"['00100', '100001', '000']",1,3,11,3,0,14,1.962121212121212,8,8
"['0010', '011', '11', '10', '000', '01010']",1,6,11,8,4,19,8.17142857142857,30,39
"['101', '0010', '0011101', '1']",1,4,7,8,0,15,3.0487012987012987,20,14
"['00001', '0001', '100', '1010', '1101', '11100']",1,6,14,11,5,25,8.955555555555556,36,45
"['0011101', '101101', '11101', '100011', '1000011', '0001010', '1100', '111101']",1,8,21,27,6,48,17.76969696969697,82,109
"['111', '101', '010010', '100101', '10011']",1,5,10,13,4,23,6.83080808080808,23,33
"['100', '011110', '0010011']",1,3,8,8,0,16,1.505982905982906,12,7
"['101000', '1000', '000', '1101']",1,4,11,6,2,17,3.7095238095238097,14,22
"['0', '10100', '010', '01110']",1,4,8,6,2,14,3.0666666666666664,17,20
"['01001', '010000', '110111']",1,3,9,8,2,17,1.606060606060606,9,7
"['01', '000111', '011', '010']",1,4,7,7,2,14,3.8777777777777778,14,16
"['1100', '001011', '01000', '1101110']",1,4,11,11,0,22,3.4547785547785548,20,19
"['11000', '010', '10110', '10010']",1,4,10,8,3,18,4.2,13,17
"['1001', '1101100', '1010111', '00', '110', '01110']",1,6,12,16,2,28,8.446536796536796,49,35
"['101', '000111', '10', '1111110']",1,4,6,12,0,18,2.8004273504273502,24,16
"['1010', '001', '100000', '1111']",1,4,9,8,2,17,2.6015873015873017,19,14
"['0', '11101', '101010']",1,3,5,7,0,12,1.1645021645021645,11,4
"['000110', '101', '100011', '10', '1010000', '1011111']",1,6,15,16,4,31,8.56959706959707,54,47
"['100001', '1111010', '1000', '000001', '1101', '110']",1,6,16,14,4,30,8.47052947052947,47,48
"['01', '011', '0110', '01001', '01110']",1,5,9,10,2,19,7.122222222222222,20,38
"['11010', '110010', '101', '0011', '00']",1,5,10,10,0,20,6.079725829725829,25,26
"['0011', '00', '111111', '10', '1101']",1,5,6,12,4,18,4.25,32,25
"['0', '1100100', '10010', '1011100', '101111']",1,5,12,14,2,26,4.8000333000333,38,27
"['101', '11101', '011000', '0100']",1,4,9,9,0,18,3.5557720057720057,16,12
"['110000', '0100110', '1110', '11']",1,4,9,10,0,19,3.3999222999223,20,17
"['101000', '1010', '10101']",1,3,8,7,0,15,2.416161616161616,5,15
"['000100', '1', '000111']",1,3,8,5,2,13,1.2380952380952381,12,8
"['11', '010', '0011000', '0111100']",1,4,10,9,2,19,3.2031746031746033,22,15
"['01', '001', '00000', '100', '01011']",1,5,12,6,4,18,5.123809523809523,26,27
"['0', '0111010', '11']",1,3,4,6,0,10,0.6944444444444444,13,4
"['01', '011', '0011000', '01110']",1,4,9,8,0,17,3.8325396825396822,18,18
"['01', '001111', '111', '0001', '0010101']",1,5,10,12,0,22,5.478177378177378,31,31
"['0101111', '0011000', '0001', '1001', '011101', '1011000', '01000']",1,7,22,18,5,40,12.704545454545455,63,69
"['10001', '0110', '00010', '0101', '110']",1,5,12,9,4,21,6.423015873015872,23,24
"['1111100', '00101', '10111', '0000010', '11111', '110', '111101']",1,7,14,24,5,38,10.962637362637363,70,78
"['001000', '0010011', '00110', '011110', '000']",1,5,17,10,2,27,6.313092463092463,29,54
"['110', '100001', '111']",1,3,5,7,2,12,1.5555555555555554,9,10
"['0100001', '11', '0']",1,3,6,4,0,10,0.6944444444444444,13,4
"['011011', '0000001', '01011', '00101']",1,4,13,10,2,23,3.5773892773892775,16,18
"['101', '010', '01111', '0100']",1,4,7,8,2,15,3.5396825396825395,14,14
"['00111', '1010101', '01010', '1001']",1,4,10,11,2,21,3.9383838383838383,17,12
"['1011', '01', '001', '1001000']",1,4,9,7,0,16,3.627994227994228,18,15
"['0000001', '10100', '10010', '0000', '01001', '1100']",1,6,21,9,5,30,9.268686868686869,38,47
"['0', '1011010', '111110', '110']",1,4,6,11,0,17,2.9177655677655676,22,17
"['1010', '100', '01111']",1,3,5,7,0,12,1.5515873015873014,8,7
"['10', '000011', '1111011']",1,3,6,9,0,15,1.1559829059829059,14,9
"['110110', '1110000', '00', '001010', '010111', '0100']",1,6,17,14,3,31,8.695027195027194,51,52
"['00101', '001000', '11101', '110', '001011']",1,5,13,12,4,25,5.951010101010101,27,35
"['0010', '010', '111', '100', '00110', '1011', '01100']",1,7,14,13,7,27,12.478571428571428,44,56
"['00110', '01', '001111', '10']",1,4,7,8,2,15,3.12012987012987,19,16
"['0001', '1111000', '01010', '0000', '0101']",1,5,15,9,3,24,5.704545454545454,27,36
"['11110', '01011', '01000']",1,3,7,8,3,15,1.4,8,9
"['1000110', '100', '1011100', '0000', '1100111', '000100']",1,6,20,14,3,34,8.995937395937396,49,50
"['0000', '1101', '01', '00001']",1,4,10,5,2,15,3.1547619047619047,15,19
"['1', '000010', '1000011', '000111', '101110']",1,5,14,12,3,26,5.094322344322344,37,23
"['001101', '00101', '11', '101', '10000', '011110', '000010']",1,7,18,15,5,33,11.964213564213564,65,55
"['011111', '0010', '001']",1,3,6,7,0,13,1.7015873015873015,9,8
"['00', '001011', '0111', '111']",1,4,6,9,0,15,2.734920634920635,16,19
"['011', '0001', '01010', '0101', '101001', '0110011']",1,6,15,14,2,29,10.496287046287046,35,43
"['0010', '10001', '1', '001']",1,4,8,5,0,13,3.507142857142857,15,14
"['101000', '0001', '1001', '001']",1,4,11,6,2,17,4.108730158730158,13,23
"['0011', '01111', '1111001']",1,3,5,11,0,16,1.8787878787878787,10,11
"['1101', '011010', '011']",1,3,5,8,0,13,2.038095238095238,7,7
"['00', '100', '10', '10011']",1,4,7,5,2,12,3.992857142857143,11,16
"['1100', '100', '0100110']",1,3,8,6,0,14,2.0025974025974023,9,8
"['010', '00101', '10110', '111011', '0101', '01110', '1011111']",1,7,13,22,3,35,13.767982017982018,58,55
"['001', '11', '0001', '10101', '10100', '000000', '110101']",1,7,18,13,4,31,10.508080808080807,60,68
"['11', '0011', '100', '0000010', '000']",1,5,13,6,2,19,4.643867243867244,32,31
"['0000111', '10010', '0']",1,3,8,5,0,13,1.0833333333333333,14,6
"['011', '111', '0011010', '00', '10010', '010011']",1,6,13,13,2,26,7.902974802974803,46,39
"['0', '111010', '101', '1001101', '0011111']",1,5,9,15,2,24,5.051282051282051,41,23
"['0', '010101', '1110']",1,3,5,6,0,11,1.0857142857142859,11,6
"['11010', '0100111', '000']",1,3,8,7,0,15,1.4,11,7
"['1110111', '11110', '1000', '111011']",1,4,6,16,0,22,3.5250971250971253,18,30
"['0111000', '01', '110']",1,3,6,6,0,12,1.4444444444444444,11,7
"['101', '10010', '10', '000', '1011']",1,5,9,8,2,17,6.080952380952381,20,26
"['01000', '0001', '1', '000010']",1,4,12,4,0,16,3.031168831168831,18,16
"['0011001', '001100', '00111', '011']",1,4,11,10,0,21,4.5003496503496505,14,26
"['0110000', '0010111', '000101']",1,3,12,8,2,20,1.8131868131868132,10,10
"['1010', '001', '1000', '011001']",1,4,10,7,2,17,3.7595238095238095,15,16
"['0011', '001001', '1001000']",1,3,11,6,0,17,2.114685314685315,8,10
"['00001', '110011', '00', '10', '11111', '1100011']",1,6,12,15,4,27,7.260883560883561,51,48
"['0101010', '11111', '110', '101110', '01000']",1,5,11,15,2,26,5.4601398601398605,30,26
"['0101111', '0100111', '110101']",1,3,7,13,2,20,2.087912087912088,7,12
"['1', '1100110', '01100', '0001111']",1,4,9,11,2,20,2.571428571428571,28,12
"['1101', '110', '111', '00001']",1,4,6,9,2,15,3.325396825396825,14,21
"['0', '100000', '0110']",1,3,8,3,0,11,1.0857142857142859,12,8
"['000111', '1', '101001']",1,3,6,7,2,13,1.2380952380952381,14,8
"['110', '10', '010010', '11']",1,4,6,7,2,13,3.5444444444444443,14,15
"['111000', '1111101', '0100']",1,3,7,10,0,17,1.579020979020979,11,7
"['011101', '01111', '0011', '1']",1,4,5,11,0,16,3.1948051948051948,18,16
"['0010001', '01101', '100', '1000', '1110001', '100011']",1,6,18,14,2,32,10.054334554334554,44,49
"['01', '00010', '0110', '110']",1,4,8,6,0,14,3.6619047619047618,13,19
"['00010', '111', '0111']",1,3,5,7,0,12,1.5515873015873014,8,8
"['1111010', '10001', '0000']",1,3,9,7,0,16,1.5303030303030303,11,4
"['11', '001110', '0101110', '00011']",1,4,9,11,0,20,3.8328893328893328,18,17
"['0101', '011010', '1']",1,3,5,6,0,11,1.2857142857142856,10,5
"['001110', '1110000', '11']",1,3,7,8,0,15,1.5598290598290598,14,7
"['01', '1', '1001', '0000000', '1000']",1,5,13,5,2,18,4.347979797979798,35,25
"['0011', '101011', '0110', '100011', '0000']",1,5,13,11,5,24,6.383333333333334,25,26
"['011', '111010', '11', '0011001', '10000']",1,5,11,12,0,23,4.985442335442335,37,26
"['0110101', '0110', '1110101', '11101', '100000']",1,5,13,16,2,29,5.983250083250083,30,34
"['0001', '010110', '1110']",1,3,7,7,2,14,1.4500000000000002,9,8
"['0111101', '011010', '0110111', '00000']",1,4,12,13,2,25,3.322011322011322,19,22
"['01001', '1100', '1', '011110']",1,4,7,9,0,16,2.831168831168831,20,11
"['101000', '01', '0011111', '1111']",1,4,7,12,0,19,2.7127428127428126,24,19
"['100', '100000', '000101']",1,3,11,4,2,15,1.7777777777777777,10,12
"['0', '0101110', '1111']",1,3,4,8,0,12,0.7954545454545454,13,4
"['10', '01010', '011000']",1,3,8,5,0,13,1.7987012987012987,9,10
"['0', '11001', '1100', '1001111', '0100']",1,5,10,11,2,21,5.446464646464646,34,23
"['1110001', '00101', '011', '1111']",1,4,7,12,0,19,3.3931457431457432,19,22
"['01', '100', '1001', '1101011', '100111']",1,5,9,13,0,22,6.431424131424132,28,36
"['11', '1110010', '10110', '0000']",1,4,9,9,0,18,2.6724386724386724,22,13
"['0111000', '01', '0010111', '111010', '100', '10110', '1011']",1,7,15,19,2,34,12.63949938949939,69,54
"['11010', '1110', '11']",1,3,3,8,0,11,1.9047619047619047,6,12
"['0', '1011101', '0100']",1,3,6,6,0,12,1.1954545454545453,13,4
"['01', '0110100', '1110']",1,3,6,7,0,13,1.323232323232323,11,7
"['11010', '010', '0100111', '111100', '1001', '000101', '01111', '10011', '000', '1111011']",1,10,22,29,9,51,25.735109335109335,140,134
"['011', '00011', '10', '011001', '0101']",1,5,10,10,0,20,6.32012987012987,25,27
"['0100010', '110100', '0100']",1,3,11,6,0,17,2.1426573426573428,8,14
"['1000', '000', '11']",1,3,6,3,0,9,1.1904761904761905,7,8
"['01101', '1111101', '1101111', '000011']",1,4,8,17,2,25,3.2194472194472192,20,24
"['111', '100110', '10011', '000', '10', '0110010', '0100']",1,7,16,14,2,30,11.489721389721389,60,52
"['1010000', '010', '001111', '10']",1,4,10,8,0,18,2.8465811965811967,24,15
"['110011', '1100001', '1001', '0001111']",1,4,11,13,2,24,4.0287712287712285,20,27
"['1101101', '1100100', '1111', '1110101', '1000', '10010', '01010', '1010000']",1,8,22,24,8,46,17.846392496392497,81,80
"['011010', '001', '100011', '0100']",1,4,11,8,2,19,3.3825396825396825,18,12
"['0100001', '1001', '1']",1,3,7,5,0,12,1.3772727272727274,12,10
"['001101', '00011', '10000', '111111', '00']",1,5,12,12,4,24,4.561038961038961,37,30
"['100110', '0101111', '010001']",1,3,9,10,2,19,1.8974358974358974,9,8
"['1000', '1100', '11']",1,3,5,5,2,10,1.75,6,9
"['0', '01', '01110', '1111']",1,4,4,8,0,12,2.571428571428571,17,11
"['0010', '001', '1010', '100011', '0000111']",1,5,14,10,2,24,6.323559773559773,28,26
"['010011', '000', '0111']",1,3,7,6,0,13,1.33015873015873,8,8
"['000100', '11100', '000', '011000']",1,4,14,6,2,20,3.606060606060606,17,37
"['0011', '0010010', '111', '110100']",1,4,10,10,0,20,3.380752580752581,21,19
"['1000100', '01', '1001010', '0001', '11100']",1,5,15,10,2,25,5.415584415584416,34,27
"['1101', '001', '110']",1,3,4,6,2,10,1.7619047619047619,6,9
"['00100', '01', '10', '11']",1,4,6,5,3,11,2.9285714285714284,14,10
"['000101', '100001', '1']",1,3,8,5,2,13,1.2380952380952381,12,9
"['0', '101', '1010111', '1111']",1,4,4,11,0,15,2.4668831168831167,21,18
"['0010110', '001', '0010100', '110111', '10', '011111']",1,6,14,17,4,31,7.651587301587302,54,42
"['0010110', '010', '100', '010101', '1010000', '0100101']",1,6,20,13,5,33,9.4,48,46
"['110000', '111', '01100']",1,3,7,7,0,14,1.6717171717171717,10,7
"['0111101', '110', '0100110', '0111']",1,4,8,13,2,21,3.6155844155844155,19,20
"['10101', '010101', '10000', '11']",1,4,9,9,2,18,3.4116883116883114,17,19
"['1101', '0101011', '010111', '100111']",1,4,8,15,2,23,4.117249417249417,15,25
"['110000', '011', '111', '0001111', '100111', '000000']",1,6,16,15,5,31,7.503418803418803,57,59
"['00', '01001', '0000011']",1,3,10,4,0,14,1.6825396825396823,11,8
"['011011', '0110', '10000', '0']",1,4,9,7,0,16,2.627128427128427,21,17
"['01', '111', '101', '100011', '000001', '0111100']",1,6,13,14,4,27,7.524786324786325,53,38
"['010100', '0010', '01101', '11', '101', '101000', '110001', '1000']",1,8,20,16,5,36,17.625396825396827,74,71
"['11010', '0100110', '0110', '0000000', '010101', '1000011', '01100']",1,7,25,16,5,41,12.31972471972472,68,63
"['000110', '0111', '0100']",1,3,8,6,2,14,1.5,8,10
"['010', '011', '1110101', '001010', '100000', '001011']",1,6,17,14,5,31,8.725641025641025,48,41
"['000100', '1100', '01100', '11']",1,4,10,7,0,17,3.704256854256854,16,21
"['10111', '0101111', '1']",1,3,3,10,0,13,1.4166666666666667,12,10
"['1100011', '11', '111010', '111001']",1,4,7,14,2,21,3.6623931623931627,20,33
"['00110', '1', '0100']",1,3,6,4,0,10,1.1777777777777778,9,5
"['1010', '100', '001001', '011']",1,4,9,7,2,16,3.695238095238095,15,14
"['0101', '000', '101101']",1,3,7,6,0,13,1.615873015873016,8,6
"['0100000', '0100011', '110']",1,3,11,6,2,17,1.5142857142857142,12,11
"['0', '11011', '1110000', '10010', '000001']",1,5,14,10,2,24,4.493523143523143,39,23
"['010', '0100', '1111']",1,3,5,6,2,11,1.3928571428571428,7,6
"['0', '01', '01100']",1,3,5,3,0,8,1.5714285714285714,8,9
"['0010', '010', '1110001', '1011', '101111']",1,5,10,14,2,24,5.497491397491397,33,25
"['011', '0101101', '101', '100', '001011']",1,5,10,12,3,22,6.013675213675214,31,27
"['0001', '10000', '011000', '1111', '0111', '0000111', '111000', '0100']",1,8,22,18,6,40,15.56903651903652,85,105
"['110110', '110010', '11011', '010001', '10000', '100000', '000']",1,7,22,15,6,37,13.132323232323232,56,66
"['0011', '00', '0110']",1,3,6,4,2,10,2.083333333333333,6,10
"['0111001', '111', '111010', '00001', '111011', '1011000', '1011', '1101', '01100']",1,9,19,28,8,47,22.733610833610832,100,117
"['01101', '1110000', '011000']",1,3,10,8,0,18,1.9965034965034967,8,11
"['11001', '0011001', '100', '1111', '1101100', '000001', '0111']",1,7,17,19,4,36,11.723631923631924,67,71
"['01', '10111', '00', '1000', '11100', '1111011']",1,6,10,15,4,25,7.289033189033189,50,42
"['01', '001', '00111', '00', '0011111', '1011', '01011']",1,7,12,16,4,28,13.097041847041847,54,65
"['11100', '01101', '1101011', '101']",1,4,7,13,2,20,3.783333333333333,17,18
"['1000', '11011', '0110100', '1010101']",1,4,11,12,2,23,3.7647907647907646,17,12
"['10100', '010001', '1001011', '1101110']",1,4,12,13,2,25,3.685148185148185,19,14
"['01111', '0101100', '01110']",1,3,7,10,2,17,1.9666666666666668,6,13
"['100', '101000', '110', '1']",1,4,7,6,2,13,3.0634920634920633,16,14
"['111000', '10110', '11101', '001000']",1,4,11,11,4,22,3.6303030303030304,16,17
"['01', '110010', '010', '00011']",1,4,9,7,0,16,3.5835497835497834,17,16
"['0101111', '100111', '110']",1,3,5,11,0,16,1.6136752136752137,11,10
"['001', '0111011', '1100000', '1010', '1101']",1,5,12,13,4,25,5.485064935064935,35,26
"['0100110', '110011', '111110', '0000', '011111']",1,5,12,17,3,29,5.024941724941725,33,29
"['0001', '110', '011', '0100']",1,4,8,6,4,14,3.1666666666666665,13,15
"['1100100', '0100100', '010110']",1,3,12,8,2,20,2.087912087912088,6,15
"['0011011', '10100', '100', '1100']",1,4,10,9,0,19,3.9414862914862914,17,23
"['11010', '00100', '101', '00', '11111', '01011']",1,6,11,14,4,25,7.614285714285714,42,35
"['010', '11', '10000', '001100', '010011', '1011011']",1,6,15,14,2,29,8.051837051837051,51,37
"['0011', '111110', '101111']",1,3,4,12,2,16,1.6666666666666665,9,11
"['0110', '1111110', '11']",1,3,3,10,0,13,1.6565656565656566,11,8
"['01', '010', '01101', '0100011']",1,4,9,8,0,17,3.6658730158730157,18,20
"['1110010', '0110111', '10111', '1111', '0010011', '0011011', '0111110']",1,7,15,29,5,44,12.805194805194805,59,77
"['0100110', '111', '11000', '101000', '1100000', '1000111', '111101']",1,7,20,21,5,41,12.681773781773781,70,72
"['1001000', '00010', '110']",1,3,10,5,0,15,1.5666666666666667,10,9
"['1110010', '01101', '1101111', '011', '001', '000101', '1111']",1,7,13,22,4,35,12.337312687312687,66,71
"['01', '11010', '1011101', '10100', '01000']",1,5,12,12,3,24,6.192063492063492,30,23
"['11110', '010', '0001']",1,3,6,6,0,12,1.2936507936507935,9,7
"['01111', '000', '0111']",1,3,5,7,0,12,1.4246031746031744,8,11
"['0001001', '010', '1101110', '1011', '110', '001011', '0110001']",1,7,18,19,5,37,12.356399156399156,71,57
"['011', '00111', '111111', '10', '1100110']",1,5,7,16,0,23,5.002109002109002,35,32
"['0', '110100', '1101110', '1010', '100011', '1011']",1,6,12,16,4,28,8.51058941058941,48,42
"['0101010', '0001', '11010']",1,3,9,7,0,16,1.4747474747474747,8,9
"['0010110', '111', '0101001']",1,3,8,9,2,17,1.7142857142857144,11,4
"['1', '0101101', '00110', '100000', '1110']",1,5,12,11,0,23,4.9033133533133535,36,21
"['1000010', '10', '0100']",1,3,9,4,0,13,1.6565656565656566,11,8
"['001', '011', '10000', '1000', '0011100']",1,5,14,8,2,22,5.408152958152958,30,34
"['1101', '00', '1', '101101']",1,4,5,8,0,13,2.3190476190476192,19,15
"['011101', '101', '00', '100010']",1,4,9,8,2,17,3.2333333333333334,20,13
"['0', '11101', '0110110']",1,3,5,8,0,13,1.25,13,4
"['0110100', '111', '0010101']",1,3,8,9,2,17,1.9142857142857141,10,5
"['0', '0111011', '10010', '111000', '1100']",1,5,11,12,0,23,5.123826173826174,36,24
"['01', '010', '10011', '1111110']",1,4,6,11,0,17,2.826984126984127,22,13
"['011101', '0010111', '01010']",1,3,8,10,0,18,2.0093240093240095,8,7
"['1100011', '11100', '0110']",1,3,7,9,0,16,1.8787878787878787,10,6
"['0010', '0100000', '011000']",1,3,13,4,0,17,1.9146853146853147,9,17
"['11110', '010', '00101', '00100', '1001']",1,5,12,10,3,22,5.949206349206349,26,24
"['011', '0010011', '11100', '01000', '0100']",1,5,14,10,2,24,6.22092352092352,27,38
"['1100111', '10', '0010001']",1,3,8,8,2,16,1.4603174603174602,14,6
"['01101', '1000101', '1', '1111011', '1101010', '110101']",1,6,12,21,3,33,8.557858807858809,52,58
"['0011', '01', '1010100']",1,3,7,6,0,13,1.4747474747474747,11,7
"['00011', '0001', '1001', '00', '101110']",1,5,12,9,2,21,6.255772005772005,25,28
"['100', '1', '000001']",1,3,7,3,0,10,1.2301587301587302,11,7
"['10101', '00', '100', '1000']",1,4,9,5,0,14,4.311904761904762,11,19
"['101', '0001', '100000']",1,3,9,4,0,13,1.615873015873016,9,10
"['001', '11', '101010', '0100', '0000010', '1011', '111001']",1,7,17,15,4,32,11.275024975024975,67,52
"['001', '0011', '001110', '0111', '1001011']",1,5,11,13,2,24,7.087196137196138,24,29
"['01', '1', '01000', '111001']",1,4,7,7,0,14,2.9025974025974026,20,12
"['000001', '010000', '11100', '10']",1,4,13,6,2,19,2.8971861471861473,21,17
"['1100010', '1100000', '100', '0110011']",1,4,14,10,3,24,3.9428571428571426,20,19
"['0', '1100010', '100', '1001010']",1,4,11,7,2,18,2.914285714285714,24,16
"['0', '00100', '1001010', '011110']",1,4,11,8,0,19,2.5555278055278055,23,19
"['1100111', '011101', '0']",1,3,5,9,0,14,1.151098901098901,15,4
"['100101', '011', '1111111']",1,3,4,12,0,16,1.528205128205128,12,10
"['0110101', '010001', '10011', '0']",1,4,10,9,0,19,2.7117049617049616,22,12
"['1000100', '101111', '00001']",1,3,10,8,0,18,1.491841491841492,11,8
"['10111', '001110', '1110', '0001100']",1,4,10,12,0,22,4.008624708624708,16,17
"['0011001', '101', '011011', '1001', '100111']",1,5,11,15,2,26,6.722877122877123,27,37
"['0011', '01', '1011']",1,3,4,6,2,10,2.083333333333333,5,8
"['011001', '011', '0111', '0001111']",1,4,8,12,0,20,4.266466866466867,17,22
"['10', '000001', '0100100', '11']",1,4,11,6,2,17,2.5042735042735043,24,11
"['110110', '11010', '01101', '001', '0001', '100110', '11101']",1,7,15,19,5,34,13.398556998556998,52,62
"['0', '0100110', '110100']",1,3,8,6,0,14,1.151098901098901,14,8
"['1101', '1', '001011']",1,3,4,7,0,11,1.2857142857142856,11,9
"['11001', '010', '1001', '000101', '110']",1,5,11,10,2,21,6.204978354978355,25,26
"['010001', '011', '1111']",1,3,5,8,0,13,1.638095238095238,9,9
"['1001001', '1000', '100']",1,3,9,5,0,14,2.1844155844155844,8,13
"['0', '00011', '0101101', '110100', '11101']",1,5,11,13,2,24,4.808674658674659,37,25
"['0011', '1010', '00', '01011']",1,4,8,7,2,15,3.96031746031746,12,16
"['11001', '0110', '111101']",1,3,5,10,0,15,1.993939393939394,8,6
"['1100', '0010100', '00101']",1,3,10,6,0,16,2.005050505050505,8,15
"['1100011', '10100', '1101110']",1,3,8,11,2,19,2.0476190476190474,10,9
"['1101000', '1000', '001']",1,3,9,5,0,14,1.6987012987012986,10,11
"['100011', '000', '11']",1,3,6,5,0,11,1.1666666666666665,10,6
"['1011', '1101', '00010']",1,3,6,7,2,13,1.6388888888888888,8,5
"['100', '010010', '0100101', '100010']",1,4,14,8,2,22,4.458974358974359,16,22
"['01', '101000', '111011', '10', '000111']",1,5,10,12,5,22,4.75,39,26
"['01001', '1100000', '11111']",1,3,8,9,2,17,1.2333333333333334,12,8
"['0', '1001001', '0101', '110']",1,4,8,7,0,15,2.8487012987012985,20,11
"['1100', '10000', '1000111']",1,3,9,7,0,16,1.8787878787878787,9,11
"['0011', '1', '10', '000010']",1,4,8,5,0,13,2.7857142857142856,19,12
"['001', '00001', '10101', '1001000', '110100', '10100', '1001100', '1100']",1,8,25,17,5,42,17.547025197025196,71,103
"['1010100', '110', '000011']",1,3,9,7,0,16,1.305982905982906,13,8
"['1101101', '1', '000', '1001011']",1,4,8,10,2,18,2.2142857142857144,27,13
"['11', '00111', '10111', '100', '0110000', '00110', '000']",1,7,16,14,5,30,11.292063492063491,65,64
"['001', '1', '0100101']",1,3,6,5,0,11,1.35,12,7
"['1001000', '00', '010101', '001110', '011010']",1,5,16,11,3,27,6.123931623931624,34,33
"['1', '101010', '100', '0110000', '000']",1,5,13,7,2,20,4.851098901098901,35,26
"['111', '001101', '000101', '100011', '011000']",1,5,14,13,4,27,6.166666666666666,31,26
"['11100', '011010', '1', '0000']",1,4,9,7,0,16,2.390764790764791,21,12
"['0', '1111100', '0010', '111011']",1,4,7,11,0,18,2.3147352647352646,26,14
"['010', '11000', '100010', '0111', '110']",1,5,11,10,2,21,5.7423520923520925,26,29
"['001', '1111101', '010110', '00011']",1,4,9,12,0,21,3.2704351204351205,20,13
"['0', '111111', '0111', '010011', '1100', '110101']",1,6,9,18,5,27,7.138095238095238,50,46
"['010', '0101010', '000001', '01010', '000000']",1,5,20,7,2,27,5.7377233877233875,29,56
"['0101', '01101', '1110']",1,3,5,8,2,13,2.0555555555555554,6,9
"['010000', '1011001', '0011', '0001', '100', '001110', '11111']",1,7,18,17,4,35,11.15140415140415,68,56
"['0011110', '010', '01000', '0100']",1,4,12,7,0,19,3.9596681096681094,16,35
"['01100', '10', '1100110', '11']",1,4,7,9,2,16,3.198412698412698,21,13
"['101100', '00', '100000']",1,3,10,4,2,14,1.5,10,12
"['001', '100111', '10', '110']",1,4,6,8,2,14,3.1444444444444444,17,15
"['11001', '111', '011101', '1110110', '1100']",1,5,8,17,0,25,6.967427017427017,26,36
"['01', '0001', '110']",1,3,5,4,0,9,1.3523809523809525,7,7
"['1', '1110000', '0001', '11100', '110101']",1,5,11,12,0,23,4.834937284937285,36,33
"['1101', '0110', '11']",1,3,3,7,2,10,2.083333333333333,6,6
"['0000111', '010111', '011']",1,3,7,9,0,16,2.0358974358974358,9,12
"['1100', '01100', '11111']",1,3,5,9,2,14,1.7333333333333334,7,9
"['0010110', '11001', '001', '0101', '1100']",1,5,12,11,2,23,6.321139971139971,26,29
"['10100', '100', '011', '0000']",1,4,10,5,2,15,2.884920634920635,15,19
"['110011', '10001', '0001110', '10']",1,4,10,10,0,20,3.5251970251970253,22,12
"['01', '10', '0011000', '111001']",1,4,9,8,2,17,3.0042735042735043,23,11
"['0100000', '010', '001111', '1011110', '01100', '0110001']",1,6,19,16,3,35,8.95931290931291,51,50
"['010', '1', '0000100', '100100', '1110011', '0001100', '1011000']",1,7,23,15,4,38,10.828205128205129,82,60
"['100', '1', '000101', '0000']",1,4,10,4,0,14,2.6015873015873017,19,17
"['1000000', '1110001', '000010', '1011000', '1011', '0001000']",1,6,25,13,4,38,8.690709290709291,48,52
"['0011111', '01', '11100', '011']",1,4,6,11,0,17,3.13015873015873,21,18
"['010', '100', '1101100']",1,3,7,6,2,13,1.8666666666666667,10,8
"['0000100', '01111', '1001000', '00', '111001']",1,5,16,11,2,27,4.8597513597513595,42,29
"['00', '010', '110', '10']",1,4,6,4,4,10,3.966666666666667,7,17
"['0010001', '1101', '1']",1,3,6,6,0,12,1.0136363636363637,13,9
"['110000', '11', '10000', '00110', '0111']",1,5,12,10,2,22,5.167243867243867,32,29
"['1010001', '1010101', '1']",1,3,7,8,2,15,1.3571428571428572,13,16
"['010100', '01', '01101', '00001', '10110', '1111110', '1110']",1,7,15,19,3,34,10.734099234099235,67,58
"['010', '11011', '00', '0011111', '1011', '01100']",1,6,11,15,2,26,8.357359307359307,46,39
"['11100', '01010', '00011']",1,3,8,7,3,15,1.6,10,8
"['1000', '0000100', '10']",1,3,10,3,0,13,1.6565656565656566,11,10
"['0', '1001001', '10111', '110']",1,4,7,9,0,16,2.65,22,12
"['110000', '00100', '1100010', '0011010', '1000', '1011', '110']",1,7,21,15,4,36,12.8006549006549,64,67
"['10100', '110', '01110']",1,3,6,7,2,13,1.65,7,8
"['110000', '010', '01111', '1111001']",1,4,9,12,0,21,2.9901320901320902,23,16
"['1011110', '10110', '00', '001001', '110']",1,5,11,12,0,23,5.550643800643801,33,31
"['11000', '110', '1011']",1,3,5,7,0,12,1.7658730158730158,7,10
"['0010', '100', '111010']",1,3,7,6,0,13,1.838095238095238,8,9
"['1000011', '1110', '0']",1,3,6,6,0,12,1.0136363636363637,14,5
"['000110', '011', '1111', '10100', '11100', '01100']",1,6,13,15,3,28,8.98001443001443,39,47
"['101', '00110', '0111101', '001001', '01000']",1,5,14,12,2,26,6.103263403263403,30,27
"['01', '11010', '1000111', '100010', '100110', '1010', '0001011']",1,7,19,18,4,37,13.593062493062494,61,66
"['0', '0011011', '01']",1,3,5,5,0,10,1.3611111111111112,12,6
"['110', '1100000', '100', '001010', '1100']",1,5,14,9,2,23,6.280874680874681,27,35
"['0101010', '1110110', '0001']",1,3,9,9,2,18,1.4415584415584415,11,7
"['011', '1010101', '10110', '00', '00010', '0110011']",1,6,15,14,4,29,8.662698412698413,49,37
"['010', '011', '100', '00', '01011', '01110']",1,6,11,10,5,21,9.40952380952381,32,49
"['000', '01000', '11111']",1,3,7,6,2,13,0.95,11,8
"['0', '10111', '0111111', '1110000']",1,4,7,13,2,20,2.4285714285714284,29,16
"['0000010', '01110', '0111110']",1,3,10,9,2,19,1.7619047619047619,10,20
"['10111', '11011', '00000']",1,3,7,8,3,15,1.2000000000000002,10,6
"['11', '0010011', '00110', '111110', '100011', '100111', '0000']",1,7,17,19,3,36,11.289299589299588,70,65
"['000110', '0110', '10110']",1,3,8,7,0,15,2.416161616161616,5,17
"['10100', '00', '011']",1,3,6,4,0,10,1.4714285714285715,8,8
"['0', '010011', '00111', '001111']",1,4,8,10,2,18,3.207792207792208,20,20
"['00110', '00', '11100', '101']",1,4,8,7,2,15,3.142857142857143,17,15
"['1011', '1101', '010', '111']",1,4,4,10,4,14,3.6547619047619047,10,17
"['0011001', '01101', '0110', '0111100']",1,4,11,12,2,23,4.557720057720058,15,23
"['1101110', '10', '11']",1,3,3,8,2,11,1.3888888888888888,11,9
"['11000', '0011', '110111']",1,3,6,9,0,15,1.5898989898989897,10,13
"['01', '0110', '111010']",1,3,5,7,0,12,1.7666666666666666,9,8
"['1100010', '110', '1111']",1,3,5,9,0,14,1.7168831168831167,10,13
"['10', '010010', '01000']",1,3,9,4,0,13,1.9805194805194803,8,12
"['0111010', '001', '0110100', '111', '10000', '1011000']",1,6,17,15,5,32,7.978571428571429,50,38
"['00', '100', '000111', '0010011']",1,4,11,7,0,18,3.558119658119658,20,22
"['01', '00011', '00111', '11000', '011010', '0100']",1,6,15,12,3,27,8.55079365079365,44,45
"['01101', '001', '1', '011101', '0000']",1,5,10,9,0,19,4.388455988455989,30,27
"['001', '100100', '0111', '0000', '0001000']",1,5,17,7,2,24,5.71966366966367,30,39
"['01101', '0010100', '11']",1,3,7,7,0,14,1.6825396825396823,11,4
"['01', '10110', '0011010', '000010', '11111', '1111011']",1,6,13,19,4,32,7.352658452658453,53,39
"['010000', '1', '001000', '0011', '11000', '0110']",1,6,17,9,4,26,8.053751803751803,48,46
"['110010', '1100111', '10', '0001011', '011000']",1,5,14,14,4,28,5.898046398046398,37,29
"['1100111', '1001001', '1110110', '10000']",1,4,12,14,3,26,3.8333333333333335,19,19
"['00', '0110111', '10']",1,3,5,6,2,11,1.3888888888888888,11,6
"['101', '00110', '100111', '0000']",1,4,10,8,0,18,3.2463203463203465,17,11
"['11011', '1', '00101']",1,3,4,7,2,11,1.2666666666666666,11,8
"['01101', '111000', '010101', '11100']",1,4,10,12,4,22,3.827272727272727,14,20
"['1000100', '110110', '00000', '10', '000010', '1110', '0100']",1,7,22,12,4,34,11.345077145077145,63,72
"['0', '101', '0110']",1,3,4,4,0,8,1.4714285714285715,8,4
"['0001', '10001', '00', '0101001', '110', '101110', '101001']",1,7,18,15,2,33,12.34004884004884,60,64
"['1010110', '101101', '00001', '0001100', '10', '0110010', '111000']",1,7,22,18,5,40,12.015318015318016,75,56
"['0', '1111010', '0001']",1,3,6,6,0,12,1.0136363636363637,14,6
"['0', '11010', '10']",1,3,4,4,0,8,1.5714285714285714,8,7
"['101', '0101011', '1001011', '1']",1,4,7,11,2,18,3.057142857142857,24,23
"['011', '11000', '1100001', '0110', '0101100', '101110']",1,6,16,16,2,32,9.61085581085581,49,41
"['111', '00011', '0011', '010110', '0111', '000', '001011']",1,7,15,16,6,31,13.151370851370851,45,73
"['01', '111100', '0000100', '00001', '011010']",1,5,16,10,2,26,5.07006882006882,37,33
"['10011', '000', '11']",1,3,5,5,0,10,1.0714285714285714,9,6
"['011011', '100', '10', '00001']",1,4,9,7,0,16,2.893795093795094,19,14
"['11010', '101', '1001', '0110', '1000010', '0000', '0100001', '0011100']",1,8,25,16,6,41,17.03253968253968,88,69
"['1101000', '1011011', '110']",1,3,7,10,2,17,1.7714285714285714,12,10
"['1001100', '00', '0101100', '01010']",1,4,13,8,2,21,3.817460317460317,21,29
"['010', '1011110', '1000000', '10', '0011111', '000111']",1,6,16,16,3,32,7.28028083028083,61,42
"['1110010', '101', '00', '1011000', '000100']",1,5,15,10,2,25,5.521245421245421,37,29
"['11110', '001', '10010', '110', '0110011']",1,5,10,13,4,23,5.35,30,27
"['10101', '00', '110', '0100000']",1,4,11,6,0,17,2.8158730158730156,21,12
"['0101111', '00011', '0001010', '10', '1011', '1101', '000100']",1,7,18,17,4,35,12.216000666000665,67,59
"['10100', '11110', '0010', '0000']",1,4,11,7,4,18,2.9277777777777776,14,20
"['0011', '010', '110']",1,3,5,5,2,10,1.8095238095238093,6,8
"['0101010', '1001', '1111101']",1,3,7,11,2,18,1.3376623376623376,11,5
"['0', '111101', '1101010']",1,3,5,9,0,14,1.151098901098901,13,5
"['100', '110', '01100', '111100']",1,4,8,9,2,17,4.2272727272727275,13,20
"['0', '111', '1101110', '1011', '01001', '0100011']",1,6,11,16,2,27,7.330735930735931,52,41
"['11010', '001000', '1100010', '1110011', '110']",1,5,14,14,2,28,6.231107781107781,32,34
"['100', '0101', '0110', '0111100']",1,4,9,9,2,18,3.7655844155844154,17,20
"['0', '1101011', '0111']",1,3,4,8,0,12,1.1954545454545453,12,6
"['10111', '1011001', '11100']",1,3,6,11,2,17,2.2666666666666666,7,13
"['0011101', '00111', '10100', '10', '000']",1,5,12,10,2,22,5.034920634920635,32,33
"['0', '00111', '1100', '10']",1,4,6,6,0,12,2.7968253968253967,18,14
"['1', '101011', '1000', '10100', '001010', '000001']",1,6,17,11,3,28,7.375324675324675,47,40
"['00111', '0', '11']",1,3,3,5,0,8,0.9047619047619047,9,6
"['1001001', '000111', '11']",1,3,7,8,0,15,1.5598290598290598,12,10
"['00', '011110', '1100', '1111111', '110101']",1,5,8,17,2,25,5.1610722610722615,36,24
"['000110', '101', '0001011', '110', '01100']",1,5,13,11,2,24,6.024281274281274,32,26
"['0011', '11101', '0110001']",1,3,7,9,0,16,1.6565656565656566,10,8
"['010100', '110000', '001', '10']",1,4,11,6,2,17,2.9555555555555557,19,15
"['01', '110', '1000111']",1,3,5,7,0,12,1.2444444444444445,12,7
"['01', '1000', '00001']",1,3,8,3,0,11,1.5714285714285714,8,9
"['01', '10001', '110']",1,3,5,5,0,10,1.4714285714285715,8,7
"['0', '1010', '000100', '011']",1,4,9,5,0,14,2.8015873015873014,19,14
"['000110', '001', '001000', '10101', '1101', '0111', '0001011', '010011', '000100', '1110']",1,10,28,23,7,51,26.564274614274613,130,135
"['111100', '00011', '1110011', '10110', '10100', '00010']",1,6,16,17,4,33,9.051048951048951,44,48
"['110000', '11', '101', '10101', '100']",1,5,9,10,2,19,6.094660894660895,25,35
"['0010', '00100', '0011010', '1101100', '00110', '0000111', '1011']",1,7,22,17,7,39,13.667243867243867,61,83
"['0', '001111', '101101', '000101', '0101010', '1011100', '0100100']",1,7,21,19,6,40,11.275641025641026,73,56
"['0001011', '01', '001', '10001']",1,4,10,7,0,17,3.8325396825396822,18,17
"['011', '10101', '1111001', '110100', '10', '000']",1,6,12,14,2,26,7.597419247419247,47,35
"['0010000', '10101', '1111', '00', '0010010', '110', '111001']",1,7,18,16,2,34,10.73853923853924,71,56
"['0010', '00001', '11000', '0001', '01111', '010010', '1010', '0101001']",1,8,24,16,6,40,17.869230769230768,72,86
"['0', '1001', '01100']",1,3,6,4,0,10,1.4,10,4
"['110000', '0000101', '011', '01010']",1,4,13,8,0,21,3.621950271950272,21,17
"['111', '101', '1000', '100101', '000']",1,5,10,9,3,19,5.514285714285714,23,30
"['0', '010000', '0110100', '100100', '1100110', '011110']",1,6,19,14,5,33,7.428571428571429,53,53
"['0101', '011', '10111', '00100', '1101101', '1001', '0001', '000010', '111000']",1,9,23,21,7,44,20.84125874125874,102,97
"['101100', '00', '010001']",1,3,9,5,2,14,1.6666666666666665,11,8
"['0101110', '1', '1100010', '0000', '0100']",1,5,14,9,4,23,4.374025974025974,37,25
"['01', '001', '011101', '000', '01100']",1,5,11,8,2,19,5.554256854256854,25,34
"['000100', '011', '11', '10001', '1011', '011010', '01100']",1,7,16,15,4,31,13.086868686868687,59,53
"['1100011', '10100', '001101']",1,3,9,9,0,18,1.8275058275058274,11,7
"['01', '10', '0111011', '1110']",1,4,5,10,2,15,3.116161616161616,20,15
"['01', '11000', '100100', '1101101', '10110', '110001', '1111', '0000']",1,8,19,20,6,39,15.51953601953602,85,81
"['101', '100', '1001000', '1111', '1010001']",1,5,12,12,4,24,5.69004329004329,33,36
"['010', '011', '100100', '110001', '1000']",1,5,13,9,4,22,5.79047619047619,28,23
"['0010', '1000', '10101', '0000']",1,4,12,5,3,17,4.027777777777778,11,18
"['010', '00101', '10111', '0001', '101011', '0110', '1111110', '1101']",1,8,15,23,5,38,15.912742812742813,75,71
"['111111', '111110', '10']",1,3,2,12,2,14,1.5833333333333335,10,15
"['01111', '1001', '100011', '1101010']",1,4,9,13,0,22,3.632556332556333,18,19
"['011', '111', '00000', '0111', '1101', '01000']",1,6,12,12,6,24,7.242857142857143,39,45
"['010', '1', '1110000', '0110', '11101', '111000', '01000']",1,7,16,15,2,31,11.643711843711843,64,61
"['01', '00011', '0000001', '1111001', '10011', '0010010']",1,6,19,14,5,33,8.371428571428572,55,41
"['0', '1111010', '111010', '100110']",1,4,8,12,2,20,3.0265567765567765,23,21
"['01', '01001', '111', '0100']",1,4,7,7,0,14,3.3126984126984125,14,16
"['11000', '001', '0101111']",1,3,7,8,0,15,1.2333333333333334,12,8
"['110011', '1100001', '0011101']",1,3,9,11,2,20,1.9560439560439562,11,13
"['0110', '101110', '011000', '11']",1,4,8,10,2,18,3.9333333333333336,17,15
"['1010', '1', '0000001']",1,3,8,4,0,12,1.0136363636363637,14,6
"['101011', '01', '1000111', '0000']",1,4,10,9,0,19,2.9924630924630926,22,12
"['11', '010101', '1100101', '011001', '01000']",1,5,13,13,2,26,5.902652902652902,31,29
"['0000010', '10', '011', '00001']",1,4,12,5,0,17,2.8634920634920635,21,16
"['110010', '1', '101110']",1,3,5,8,2,13,1.0714285714285714,13,7
"['0000', '101', '11']",1,3,5,4,0,9,1.0857142857142859,8,4
"['100', '0001', '111000', '110']",1,4,9,7,2,16,3.457142857142857,16,17
"['00', '011010', '11']",1,3,5,5,2,10,1.0,10,4
"['0101101', '1', '011', '01010']",1,4,7,9,0,16,3.2666666666666666,20,15
"['1000100', '111', '00111', '01010', '0000', '110']",1,6,15,12,4,27,7.607431457431457,45,41
"['0010', '1001', '111110', '1100', '1110']",1,5,9,13,4,22,5.95,26,28
"['111100', '110011', '00', '1100101', '1001100', '0101001']",1,6,17,18,5,35,9.31868131868132,52,44
"['110000', '001000', '1111']",1,3,9,7,2,16,1.2666666666666666,12,9
"['0', '1010110', '01110']",1,3,6,7,0,13,1.25,12,10
"['0100100', '1', '011110']",1,3,7,7,0,14,1.151098901098901,14,5
"['0100110', '100', '10', '0000', '01100']",1,5,14,7,0,21,5.727200577200577,28,35
"['1000110', '1010', '010010']",1,3,10,7,0,17,2.0965034965034963,8,11
"['0100111', '10100', '10', '10011', '0111101']",1,5,11,15,4,26,5.703174603174603,36,25
"['111', '1111110', '00', '0000011', '011110', '000100']",1,6,15,16,4,31,6.495115995115995,63,50
"['011100', '100', '110011', '1000', '000', '1100']",1,6,15,11,6,26,10.248412698412698,34,54
"['0001', '10000', '01100', '100010']",1,4,14,6,2,20,3.9656565656565657,15,19
"['0010', '0101111', '011', '111', '10110', '1001101', '011101']",1,7,13,22,4,35,13.201881451881452,59,56
"['1010', '00', '111']",1,3,4,5,0,9,1.2380952380952381,7,4
"['0', '0110000', '11010']",1,3,8,5,0,13,1.25,13,8
"['1011011', '001', '1100100']",1,3,8,9,2,17,1.5714285714285714,12,8
"['1011001', '1', '10110', '100110', '100000', '101111']",1,6,14,17,3,31,8.122294372294371,49,57
"['0111111', '01011', '000']",1,3,6,9,0,15,1.2,12,8
"['0111000', '0011101', '0011', '000', '1011']",1,5,13,12,4,25,5.885064935064935,33,33
"['010011', '110101', '1110000', '11']",1,4,9,12,2,21,3.1880341880341883,23,23
"['101110', '00', '10', '10011']",1,4,7,8,2,15,3.37012987012987,17,14
"['101100', '010001', '10101', '1100000', '00', '01001']",1,6,19,12,4,31,9.375646575646575,46,42
"['001', '11', '1101', '00110', '00010', '0101001']",1,6,14,12,2,26,8.662914862914862,42,37
"['110000', '11', '0100100', '1001111', '0100101', '1111011']",1,6,16,20,4,36,8.2997557997558,58,51
"['001101', '1010110', '011', '01110']",1,4,9,12,0,21,4.17983682983683,16,16
"['001', '1000101', '00100', '0011', '1010', '11101', '000001', '1100']",1,8,22,16,5,38,16.7022533022533,77,84
"['1010111', '00111', '111101']",1,3,5,13,0,18,1.8403263403263403,8,15
"['00', '001', '01010', '1110']",1,4,8,6,0,14,2.9349206349206347,14,17
"['001', '1', '0100110', '1101111']",1,4,7,11,2,18,2.571428571428571,26,10
"['1010', '100', '00']",1,3,6,3,0,9,2.3238095238095235,4,9
"['10101', '10010', '11']",1,3,5,7,2,12,1.9428571428571428,8,9
"['00001', '0001', '11']",1,3,7,4,0,11,1.507936507936508,8,11
"['1', '111100', '0010000']",1,3,8,6,0,14,0.9972527472527473,15,6
"['110110', '111110', '1']",1,3,3,10,2,13,1.0714285714285714,11,9
"['1011', '010001', '010', '1']",1,4,7,7,0,14,3.0238095238095237,18,12
"['1101', '0110', '10', '000']",1,4,7,6,2,13,3.34047619047619,13,11
"['10000', '1111', '0111', '111000', '110101']",1,5,10,15,4,25,5.733838383838384,29,38
"['01', '0010010', '11']",1,3,6,5,2,11,1.3888888888888888,11,4
"['001', '001111', '000', '11']",1,4,7,7,2,14,2.6777777777777776,17,18
"['0111001', '010', '1111', '0101100', '1001011']",1,5,12,16,3,28,5.683116883116883,35,22
"['101100', '01111', '11']",1,3,4,9,0,13,1.6168831168831168,10,8
"['0011011', '1000', '1100', '0011111']",1,4,10,12,4,22,3.425324675324675,22,23
"['0', '01001', '1100', '110101']",1,4,8,8,0,16,3.212987012987013,18,13
"['0', '0101', '011']",1,3,4,4,0,8,1.7571428571428571,6,7
"['0100000', '011011', '00100', '0110', '10000', '1000010', '11100', '1111111']",1,8,25,21,6,46,14.944377844377843,96,85
"['1110011', '00010', '010', '000']",1,4,11,7,2,18,3.466666666666667,19,18
"['1101000', '0001', '0111100']",1,3,10,8,2,18,1.4805194805194803,12,10
"['11001', '000110', '0100111', '01100', '010010', '01001', '0100101', '1011111']",1,8,24,24,8,48,19.584149184149183,75,92
"['00011', '110111', '10', '010011', '1110']",1,5,9,14,2,23,5.518037518037518,31,33
"['010', '001', '100', '1000', '110']",1,5,10,6,4,16,6.238095238095238,18,26
"['00010', '010', '0101011', '10']",1,4,10,7,0,17,3.6658730158730157,18,20
"['0010111', '10110', '11']",1,3,5,9,0,14,1.6825396825396823,11,8
"['0001001', '011', '11']",1,3,6,6,0,12,1.8444444444444446,10,8
"['00', '10010', '001110', '1101']",1,4,9,8,0,17,3.398701298701299,19,13
"['101100', '00', '10001', '1']",1,4,8,6,0,14,2.2359307359307357,21,13
"['01', '10001', '11101']",1,3,5,7,2,12,1.7428571428571429,8,11
"['101', '1001001', '0001111']",1,3,8,9,2,17,1.5714285714285714,12,10
"['110110', '010001', '001100']",1,3,10,8,3,18,1.8333333333333333,10,6
"['11000', '11110', '0001', '10']",1,4,8,8,2,16,2.9650793650793648,18,16
"['0100001', '1011001', '1', '1101000']",1,4,12,10,3,22,2.892857142857143,27,16
"['0010', '01101', '01111', '1111', '1010111', '111001']",1,6,10,21,4,31,9.456993006993006,38,53
"['0', '00111', '1001011', '11111']",1,4,6,12,2,18,2.35,22,17
"['11011', '110001', '001010', '000', '1100', '1001011']",1,6,16,15,2,31,9.31140526140526,43,46
"['1101', '010', '110', '11111']",1,4,4,11,2,15,3.511904761904762,13,17
"['1', '0001', '1101000', '10011', '1011', '0101']",1,6,12,13,3,25,7.891919191919191,46,44
"['1011', '0100011', '0000001']",1,3,11,7,2,18,1.8051948051948052,10,8
"['111', '101', '000111', '100000', '0101']",1,5,11,11,4,22,5.373015873015873,31,31
"['00', '010', '11100']",1,3,6,4,0,10,1.8714285714285714,7,10
"['11110', '0001', '1101', '11']",1,4,5,10,2,15,2.96031746031746,16,20
"['011111', '0011', '001', '1100']",1,4,7,10,2,17,3.373015873015873,19,19
"['1100010', '101', '1010101', '1101100', '100101', '0111', '1110']",1,7,16,22,5,38,12.643240093240093,64,68
"['010', '001', '01011', '0111']",1,4,7,8,2,15,3.7261904761904763,11,17
"['010', '0111001', '01111', '1001100', '01011']",1,5,12,15,4,27,6.264285714285714,30,30
"['01', '111110', '010111', '10011', '000', '00010']",1,6,13,14,4,27,7.309523809523809,48,38
"['001', '001000', '101011', '01100', '0110', '11101', '0000', '101110', '1001011']",1,9,24,22,7,46,20.735087135087134,102,98
"['11', '0111111', '10011', '0111', '111001']",1,5,6,18,0,24,6.019136419136419,32,46
"['001100', '1010', '110', '011000']",1,4,11,8,2,19,3.938095238095238,15,17
"['0', '11011', '111', '10', '001100']",1,5,7,10,0,17,4.497041847041847,32,20
"['001', '1111101', '01100', '10', '0000', '011010', '110', '111101', '0100']",1,9,19,21,6,40,19.35989010989011,107,100
"['011', '00', '0101', '101110', '011000']",1,5,11,10,2,21,6.123809523809523,28,28
"['0001', '1101101', '10011', '11']",1,4,7,11,0,18,3.046176046176046,20,24
"['100101', '011', '01010', '1101110']",1,4,9,12,0,21,4.025990675990676,18,13
"['000011', '0101101', '1010', '11101', '0100011']",1,5,14,15,2,29,5.94062604062604,30,31
"['11011', '1101111', '011011', '0011001', '1111110', '00110', '00', '001010']",1,8,18,27,7,45,16.046830946830948,93,91
"['11110', '001', '00000', '1001', '000101']",1,5,14,9,2,23,5.053607503607504,30,29
"['0101', '1100', '1001101']",1,3,7,8,2,15,1.7727272727272727,9,8
"['100110', '1010', '0100011', '1']",1,4,9,9,0,18,3.0503996003996003,23,14
"['0011', '100', '001', '0000010']",1,4,12,5,2,17,3.6406926406926408,19,19
"['01', '010', '00111', '1111', '10100']",1,5,8,11,2,19,5.323015873015873,26,24
"['010', '1110000', '011', '10001', '0000101', '10']",1,6,16,11,4,27,8.231746031746031,52,36
"['111111', '00', '100101']",1,3,5,9,2,14,1.0,13,4
"['110000', '01', '111', '0100100', '01001', '01000']",1,6,17,11,2,28,8.34037074037074,46,48
"['001', '101', '100', '01111', '110111', '0000', '000100', '1101010']",1,8,19,18,5,37,14.688439338439338,88,78
"['1111001', '00', '0100111', '0010']",1,4,10,10,2,20,3.217893217893218,26,14
"['11010', '001', '101000', '10100', '10010']",1,5,14,10,3,24,6.958080808080808,22,31
"['01', '1001', '0010000', '11111']",1,4,9,9,0,18,2.5533910533910533,24,11
"['00101', '011', '000011']",1,3,8,6,0,14,2.143939393939394,7,9
"['0110010', '01', '100', '010']",1,4,9,6,2,15,3.511111111111111,18,19
"['00', '0010100', '00011']",1,3,10,4,0,14,1.6825396825396823,11,16
"['0110', '111', '10011']",1,3,4,8,0,12,1.7380952380952381,7,6
"['01', '001', '11', '011011', '101000', '00010']",1,6,13,11,4,24,7.786940836940837,46,36
"['1100010', '1010100', '010110', '00011']",1,4,14,11,2,25,3.696137196137196,17,15
"['01011', '1001', '10011']",1,3,6,8,2,14,2.1333333333333333,5,13
"['100', '010010', '00001']",1,3,10,4,0,14,1.893939393939394,8,7
"['01', '0011', '111111', '100']",1,4,5,10,0,15,2.5103174603174603,21,15
"['1001110', '1010', '01', '001101']",1,4,9,10,0,19,3.7076146076146075,20,15
"['11010', '011', '0011', '01111', '1011100']",1,5,9,15,2,24,6.2970418470418466,28,30
"['0', '01', '0100111', '1011110']",1,4,7,10,2,17,2.7698412698412698,26,13
"['00110', '010', '0000']",1,3,9,3,0,12,1.9880952380952381,6,15
"['11001', '01', '1', '110100']",1,4,6,8,0,14,3.0844155844155843,19,17
"['0', '1011001', '110001', '10000', '01010']",1,5,14,10,2,24,5.011005661005661,36,19
"['011011', '0001100', '00']",1,3,9,6,0,15,1.5598290598290598,13,12
"['11010', '0010', '00101', '101011', '1001', '01111', '10100', '000', '1110']",1,9,20,21,7,41,21.36933621933622,85,96
"['0111001', '0001110', '11', '101011', '0000', '0101', '110']",1,7,16,17,4,33,11.211988011988012,70,51
"['000', '110100', '111']",1,3,6,6,2,12,1.1111111111111112,9,8
"['011111', '0001101', '01111']",1,3,6,12,0,18,2.191142191142191,7,13
"['0001', '10111', '1101000', '001111']",1,4,10,12,0,22,3.2787101787101784,21,20
"['01', '011', '00111', '0001111', '1111', '00110']",1,6,10,16,2,26,9.53044733044733,39,50
"['1010110', '1000', '010111', '0000001']",1,4,14,10,2,24,3.0353646353646355,22,15
"['1100000', '1', '01000', '0000']",1,4,13,4,0,17,2.643939393939394,21,22
"['011101', '0011', '0011000']",1,3,9,8,0,17,1.9426573426573426,9,10
"['11001', '1010', '1011101']",1,3,6,10,0,16,2.0606060606060606,9,11
"['10111', '01', '10']",1,3,3,6,2,9,1.6428571428571428,8,7
"['011101', '10', '011']",1,3,4,7,0,11,1.5666666666666667,9,8
"['101011', '01101', '1010000', '0101']",1,4,11,11,0,22,3.895182595182595,17,18
"['010001', '0011111', '01001', '110', '1001011']",1,5,13,15,2,28,5.611410811410812,34,28
"['0111101', '001', '1011111']",1,3,5,12,2,17,1.657142857142857,11,7
"['101', '11011', '00101', '101000']",1,4,9,10,2,19,3.8575757575757574,16,19
"['110010', '1010110', '11', '00111', '10110', '10100', '0000', '101110']",1,8,19,21,5,40,16.083438783438783,78,89
"['00', '1100101', '10011', '10010', '110', '01100', '0100']",1,7,17,14,3,31,13.247835497835498,58,53
"['0111000', '0001', '100', '0101011', '1010', '01000']",1,6,18,12,4,30,9.322294372294373,42,47
"['0', '0111000', '101', '01111', '101110', '0100']",1,6,12,14,0,26,7.842030192030192,50,38
"['01', '0010011', '011101', '1010011', '11100', '1111011']",1,6,13,21,3,34,8.371961371961373,50,51
"['1110111', '01', '11', '1010101', '0110011']",1,5,8,17,5,25,5.309523809523809,39,36
"['1111101', '10110', '0100', '111011']",1,4,7,15,0,22,3.5934731934731934,19,13
"['01101', '0111111', '01110', '0111101', '101110', '101111']",1,6,10,26,6,36,11.504462204462204,33,58
"['1101', '100', '011', '010']",1,4,6,7,3,13,3.380952380952381,12,12
"['111011', '00', '001000']",1,3,8,6,2,14,1.0833333333333333,13,8
"['1', '000101', '0011100', '01100']",1,4,11,8,0,19,2.6814019314019313,23,17
"['0', '111010', '100110', '011001', '0100011']",1,5,13,13,3,26,4.799450549450549,40,23
"['0', '1101011', '001000']",1,3,8,6,0,14,0.9972527472527473,15,4
"['000110', '01', '011', '1001', '110100', '111111', '000', '111000']",1,8,17,19,6,36,13.987301587301587,92,79
"['01', '11010', '0101100', '01011', '1011111']",1,5,10,16,4,26,5.869841269841269,34,27
"['101', '110010', '0100']",1,3,7,6,0,13,1.838095238095238,8,4
"['1110011', '001001', '1', '111010']",1,4,8,12,2,20,2.706043956043956,25,18
"['1100000', '1100', '010000', '11111']",1,4,12,10,0,22,3.056099456099456,21,22
"['0011', '0101011', '010111']",1,3,7,10,0,17,2.2965034965034965,6,13
"['11001', '0', '11110', '010', '101101', '0100101']",1,6,12,15,2,27,7.485131535131535,50,34
"['00100', '0111010', '01111']",1,3,8,9,2,17,1.9,8,11
"['11', '0010', '001', '1011111']",1,4,6,10,0,16,2.7985569985569985,21,14
"['0', '1010000', '011', '111011']",1,4,8,9,0,17,2.5639194139194137,25,13
"['001000', '1000', '10010', '000001', '011001', '00010', '001011']",1,7,26,12,6,38,13.725252525252525,49,74
"['010001', '1', '1001', '0110', '1011111']",1,5,9,13,2,22,4.788161838161838,37,24
"['0011', '1', '1111000', '111101']",1,4,6,12,0,18,2.4685814185814188,25,21
"['10111', '011110', '11111', '1010011', '111101']",1,5,7,22,4,29,6.432167832167832,23,42
"['011101', '10', '11']",1,3,3,7,2,10,1.5,9,6
"['0', '1001', '10110', '01110']",1,4,7,8,2,15,2.977777777777778,19,13
"['010100', '101', '1']",1,3,5,5,0,10,1.4523809523809523,10,4
"['1011100', '10', '0100011', '101110', '011000']",1,5,14,14,4,28,6.203907203907204,36,30
"['001100', '001', '110', '11']",1,4,7,7,2,14,3.3666666666666667,16,15
"['111010', '100', '10011', '0000', '01011', '01000']",1,6,16,12,3,28,8.648196248196248,39,43
"['10010', '1000101', '0100', '0000']",1,4,14,6,2,20,3.9393939393939394,15,14
"['1000000', '001001', '1100']",1,3,12,5,0,17,1.606993006993007,10,9
"['11010', '10', '001000']",1,3,8,5,0,13,1.6168831168831168,10,7
"['0011', '1001', '00', '1011', '0111110']",1,5,9,12,3,21,5.815656565656566,29,21
"['101000', '01', '1011100']",1,3,8,7,0,15,1.7136752136752138,11,9
"['0', '1110111', '001000', '101', '1111001', '1001111']",1,6,12,19,3,31,7.010927960927961,64,41
"['01100', '01', '10', '000']",1,4,8,4,2,12,2.942857142857143,14,17
"['101', '1101', '1101000', '111']",1,4,6,11,2,17,4.308225108225108,14,27
"['10111', '01111', '10', '0100']",1,4,6,10,2,16,3.212698412698413,17,14
"['0', '001001', '001101']",1,3,8,5,2,13,1.4047619047619047,11,9
"['1000000', '01', '1100', '011']",1,4,10,6,0,16,2.6724386724386724,23,15
"['111', '10110', '10', '0000', '1100111', '01001']",1,6,12,14,2,26,7.106493506493506,48,36
"['1', '01100', '100', '010011', '0110110']",1,5,11,11,0,22,5.226040626040626,33,25
"['1001000', '10', '0100101', '101101']",1,4,12,10,2,22,3.1800976800976803,22,17
"['1111', '1000', '011100', '110101']",1,4,8,12,4,20,3.5166666666666666,17,13
"['0001001', '1000', '0111111', '011']",1,4,10,11,2,21,2.641558441558441,25,17
"['01', '10001', '000111', '001001']",1,4,11,8,2,19,3.6926406926406927,19,17
"['011', '10111', '000', '011001', '110', '01100']",1,6,12,13,5,25,8.847474747474747,37,41
"['11110', '011', '101', '00110', '0000010', '000111']",1,6,15,14,4,29,8.315889665889665,49,40
"['01101', '010011', '1000']",1,3,8,7,0,15,1.5898989898989897,8,7
"['01', '01001', '000111', '010010']",1,4,11,8,2,19,3.8744588744588744,18,19
"['01101', '01', '0111101', '110']",1,4,6,11,0,17,3.5992063492063493,18,21
"['1011', '0011101', '11']",1,3,4,9,0,13,1.6565656565656566,11,10
"['1111011', '10', '111001', '0100']",1,4,7,12,0,19,3.3439782439782437,21,13
"['001100', '1010110', '000010']",1,3,12,7,2,19,1.8974358974358974,9,11
"['101011', '00', '1']",1,3,4,5,0,9,0.7857142857142857,11,4
"['0', '1110110', '0101111', '1101000']",1,4,9,13,3,22,2.4642857142857144,29,16
"['0', '0010', '001111', '010010', '0010100']",1,5,15,9,2,24,5.079470529470529,37,44
"['1101000', '010', '110', '0100']",1,4,10,7,2,17,4.022510822510823,15,20
"['010', '10', '01110']",1,3,5,5,0,10,2.1214285714285714,6,12
"['01011', '1001', '10', '01100']",1,4,8,8,2,16,3.5206349206349206,16,12
"['01', '1110010', '1111110', '01000']",1,4,9,12,2,21,2.8095238095238093,24,16
"['00010', '1010110', '011001']",1,3,10,8,0,18,1.8426573426573427,10,7
"['0', '10001', '00101']",1,3,7,4,2,11,1.2666666666666666,10,5
"['01011', '011', '111']",1,3,3,8,2,11,1.9166666666666665,5,13
"['00010', '100', '10', '011']",1,4,8,5,2,13,3.104761904761905,15,15
"['01', '111000', '110', '010000']",1,4,10,7,2,17,2.9277777777777776,20,16
"['000011', '00001', '011100', '1011101', '1001', '01111', '1001101', '100111', '000000']",1,9,27,25,8,52,21.373149073149072,106,119
"['101', '1', '0000']",1,3,5,3,0,8,0.7857142857142857,9,4
"['0', '00111', '10011', '1101', '000100']",1,5,11,10,2,21,4.754401154401155,33,21
"['01', '1011011', '010']",1,3,5,7,0,12,1.6444444444444444,10,5
"['101', '1100101', '0110011']",1,3,7,10,2,17,2.057142857142857,10,11
"['01', '0010101', '11']",1,3,5,6,2,11,1.3888888888888888,11,7
"['010011', '1100', '1', '010001']",1,4,9,8,2,17,3.0047619047619047,20,16
"['01', '0111011', '00', '1000', '0000110']",1,5,13,9,4,22,4.758297258297258,39,29
"['1100011', '01', '11011', '01000']",1,4,9,10,2,19,3.4873015873015873,19,17
"['010', '001111', '011', '101', '0001', '1001101', '0111']",1,7,13,17,5,30,13.011799311799312,54,54
"['101010', '11000', '001110', '100110']",1,4,12,11,3,23,3.6515151515151514,15,18
"['001', '111', '1101000', '0010101', '10011']",1,5,12,13,4,25,5.521428571428571,34,32
"['01101', '110', '101001', '111011']",1,4,7,13,2,20,3.80050505050505,14,17
"['1000', '1', '0010011']",1,3,7,5,0,12,1.1954545454545453,13,7
"['0', '110011', '010101', '0000011', '01011']",1,5,13,12,2,25,5.2013819513819515,35,30
"['1000100', '001', '111', '1011111']",1,4,8,12,4,20,2.761904761904762,24,20
"['1101001', '00', '0110100']",1,3,9,7,2,16,1.746031746031746,12,6
"['011', '1001', '010111', '01110', '01000']",1,5,11,12,2,23,6.0719336219336215,26,27
"['010', '0101110', '0010111', '11', '10001', '00']",1,6,13,13,4,26,7.511111111111111,52,33
"['1011', '01', '1001']",1,3,4,6,2,10,2.083333333333333,5,10
"['0010', '0111010', '000011', '00111', '100010', '000']",1,6,19,12,2,31,9.767399267399266,41,56
"['1001010', '1101101', '1001', '0001111', '00', '000111']",1,6,16,17,3,33,9.11098901098901,50,45
"['0', '01', '1011001', '0000011']",1,4,10,7,2,17,2.484126984126984,27,11
"['0111001', '10', '1100100', '00001']",1,4,12,9,2,21,3.0555555555555554,25,15
"['1100', '110', '11']",1,3,3,6,0,9,2.3238095238095235,4,12
"['1001100', '01101', '10', '110100']",1,4,10,10,0,20,3.371350871350871,20,15
"['00111', '1', '000', '1001101']",1,4,8,8,0,16,2.5166666666666666,22,12
"['0010', '111110', '10011']",1,3,6,9,0,15,1.4303030303030302,9,6
"['01', '0011001', '1101000', '1001', '0001111', '1101']",1,6,15,16,5,31,8.767316017316016,53,49
"['0011000', '101010', '00100', '100', '1111010']",1,5,16,12,2,28,6.47947052947053,29,36
"['100', '01', '1010100', '0110']",1,4,9,7,0,16,3.046176046176046,18,16
"['010111', '10', '0111011']",1,3,5,10,0,15,1.7136752136752138,11,8
"['1', '10110', '001000']",1,3,7,5,0,12,1.1645021645021645,12,4
"['0001101', '1010111', '1']",1,3,6,9,2,15,1.2142857142857144,15,8
"['01', '0001', '10']",1,3,5,3,2,8,1.5,7,7
"['101100', '1001', '01100']",1,3,8,7,0,15,2.175757575757576,7,9
"['0', '1101', '01111']",1,3,3,7,0,10,1.4,9,5
"['011101', '0011', '01']",1,3,5,7,0,12,1.7666666666666666,9,8
"['11010', '0001', '1111000', '00', '10010', '0101']",1,6,15,12,4,27,8.907503607503607,44,40
"['0010', '001111', '011', '1100001', '110011', '011000']",1,6,16,16,3,32,9.15021645021645,50,44
"['101', '1001', '1']",1,3,3,5,0,8,1.7571428571428571,6,14
"['11010', '11011', '001000', '10110', '000', '0000111', '101110', '111001']",1,8,21,22,6,43,16.12886557886558,89,84
"['0000011', '00', '000001']",1,3,12,3,0,15,1.8675213675213675,10,15
"['001', '10101', '00', '111110', '01001']",1,5,10,11,2,21,5.192352092352093,30,24
"['010011', '11101', '1']",1,3,4,8,0,12,0.9826839826839826,12,9
"['10101', '111', '000', '110101']",1,4,7,10,2,17,3.27020202020202,16,18
"['010', '011', '101', '10001', '100', '1000', '0111']",1,7,13,12,6,25,12.321428571428571,45,57
"['1010111', '00', '01010', '1011111']",1,4,8,13,2,21,3.119047619047619,22,12
"['0010101', '1111101', '001101', '000000']",1,4,14,12,4,26,3.2362637362637363,19,23
"['00', '001110', '10']",1,3,6,4,2,10,1.5,9,11
"['1010100', '1001', '110', '1']",1,4,7,8,0,15,2.666883116883117,20,15
"['110', '11100', '10', '01010']",1,4,7,8,2,15,3.7928571428571427,14,16
"['01', '01111', '0010', '0110']",1,4,7,8,2,15,3.765873015873016,13,19
"['100', '1', '011']",1,3,3,4,2,7,1.3333333333333333,7,6
"['1011', '010', '1101011']",1,3,5,9,0,14,1.8987012987012988,9,8
"['00', '1', '011', '100010']",1,4,7,5,0,12,2.13015873015873,19,10
"['111100', '1001', '0000', '010111', '10', '11111', '01011']",1,7,13,19,6,32,10.358152958152958,65,63
"['0', '0001100', '01']",1,3,7,3,0,10,1.3611111111111112,12,8
"['0010', '00100', '100', '1111', '1011100', '011110', '10']",1,7,15,16,2,31,11.619014319014319,61,62
"['0110101', '100', '1', '000']",1,4,8,6,2,14,2.6166666666666667,20,12
"['11001', '1011010', '0101000', '11', '11000', '10', '1001100', '0000111', '0100']",1,9,25,21,8,46,20.315151515151513,126,100
"['101', '1101', '1110', '0100']",1,4,6,9,3,15,3.75,11,13
"['010100', '00100', '1011', '011000']",1,4,13,8,2,21,4.1141414141414145,15,20
"['1010111', '0011', '001', '01110']",1,4,8,11,0,19,3.8177489177489177,16,13
"['0100000', '1011110', '1001', '1010', '01110']",1,5,14,13,4,27,5.7644300144300145,34,28
"['100001', '00101', '00000', '00111', '0110', '100101', '0111', '0101', '101110']",1,9,24,21,9,45,22.675252525252525,86,100
"['001', '10', '000000']",1,3,9,2,0,11,1.0944444444444446,11,8
"['00101', '11', '100', '100110', '111110']",1,5,9,13,2,22,5.34011544011544,32,27
"['11', '101', '100', '110001', '0100100', '0000']",1,6,15,10,2,25,8.144244644244644,45,36
"['00010', '1001', '111100']",1,3,8,7,0,15,1.6303030303030304,10,5
"['000011', '100', '1111', '10', '110', '1110']",1,6,9,13,4,22,8.24126984126984,40,47
"['101010', '010101', '001']",1,3,8,7,2,15,1.7222222222222223,8,7
"['1111001', '10100', '10', '01000', '0100']",1,5,13,10,2,23,6.543867243867243,28,27
"['11010', '1110011', '111', '1101']",1,4,5,14,0,19,4.48997113997114,14,35
"['01', '00001', '1111', '1100101', '0100']",1,5,11,11,2,22,4.705266955266955,32,25
"['0101101', '101', '1100001', '111111', '011001', '1001001', '110101']",1,7,17,25,6,42,13.412942612942613,61,92
"['1111010', '110', '1']",1,3,3,8,0,11,1.35,12,8
"['01', '100', '111010']",1,3,5,6,0,11,1.5666666666666667,9,6
"['01', '0101101', '100000', '0010010', '011010', '0100']",1,6,20,12,4,32,8.635925185925187,51,49
"['1011', '11110', '11']",1,3,2,9,0,11,1.6825396825396823,7,13
"['11001', '0', '1000110', '01111', '010010', '0111', '1110110']",1,7,15,20,4,35,11.237140637140637,72,59
"['01', '1', '0100000', '0010011']",1,4,11,6,2,17,2.626984126984127,27,12
"['1011001', '001000', '00100', '00010', '110']",1,5,17,9,2,26,6.42952602952603,29,33
"['01', '1', '00101', '0000']",1,4,8,4,0,12,2.571428571428571,17,13
"['0111010', '000011', '100', '1111', '000', '1110110']",1,6,14,16,4,30,7.898257298257298,52,43
"['11101', '10', '1100011', '011010', '110']",1,5,9,14,0,23,6.341863691863692,31,27
"['0001110', '000011', '0001101', '100101', '011110', '01100']",1,6,20,17,5,37,9.816350316350317,42,48
"['11000', '1001', '001110', '000001', '010110']",1,5,16,11,3,27,5.7696969696969695,32,26
"['00', '1', '101111']",1,3,3,6,0,9,0.5357142857142857,12,4
"['1000011', '010011', '10000']",1,3,11,7,0,18,2.148018648018648,7,13
"['00100', '00', '010']",1,3,8,2,0,10,2.1214285714285714,6,16
"['1011010', '10001', '0011', '000']",1,4,11,8,0,19,3.80021645021645,17,13
"['0101101', '10', '0000010', '11']",1,4,10,8,4,18,2.484126984126984,26,11
"['010001', '1', '1011101', '00', '100011', '0101']",1,6,13,13,2,26,7.342096792096792,52,37
"['01', '010000', '101110', '0101100']",1,4,12,9,2,21,3.482905982905983,21,19
"['11010', '01101', '101010', '0110', '1000', '100111', '1010000', '101111', '1100', '01110']",1,10,24,28,9,52,28.41756021756022,115,129
"['011', '11', '100', '1000000', '00110']",1,5,12,8,2,20,4.7103174603174605,34,25
"['11010', '1001', '1']",1,3,4,6,0,10,1.4,9,8
"['11001', '111001', '11']",1,3,4,9,0,13,1.9805194805194803,8,21
"['11011', '1011001', '0111', '11']",1,4,5,13,0,18,3.743145743145743,18,26
"['111', '0011', '101', '1111000', '0101100', '1100', '01000']",1,7,16,17,6,33,12.073232323232324,64,65
"['0', '0011', '10111', '1101', '01011', '110101']",1,6,9,16,4,25,8.795815295815295,40,45
"['0', '00110', '1101']",1,3,5,5,0,10,1.4,10,4
"['0010', '11110', '010', '0110100', '00', '11111']",1,6,12,14,2,26,7.597907647907648,47,50
"['011', '00111', '100011', '10', '0110010', '000100']",1,6,16,13,2,29,8.415279165279165,50,38
"['11011', '1', '10010', '100111', '0100011', '0110001']",1,6,14,17,4,31,8.415351315351316,52,46
"['11000', '010', '10000', '11']",1,4,9,6,2,15,3.057142857142857,16,14
"['11', '101', '000', '1011', '11100']",1,5,7,10,2,17,4.958730158730159,24,29
"['000110', '110010', '0111']",1,3,8,8,2,16,1.8666666666666667,10,8
"['0010', '11101', '00', '0111']",1,4,7,8,2,15,2.8968253968253967,16,14
"['0111001', '1', '0100']",1,3,6,6,0,12,1.3772727272727274,12,5
"['00001', '100100', '10100', '1011100', '01110']",1,5,16,12,3,28,5.47972027972028,28,34
"['101', '00', '11011']",1,3,4,6,0,10,1.4357142857142857,8,4
"['000110', '0010', '00100', '0111101', '1100']",1,5,15,11,2,26,6.389121989121989,29,39
"['001', '1', '110111']",1,3,3,7,0,10,1.2301587301587302,11,8
"['11', '01101', '011', '0000']",1,4,7,7,0,14,2.8515873015873017,16,14
"['000110', '01', '100', '01001']",1,4,10,6,0,16,3.3931457431457432,18,15
"['00111', '0001', '1']",1,3,5,5,0,10,1.4,9,7
"['0011110', '100', '11']",1,3,5,7,0,12,1.2444444444444445,12,5
"['11001', '0100011', '0011110', '1111']",1,4,9,14,2,23,3.4956709956709955,21,15
"['11000', '1000', '111']",1,3,6,6,0,12,1.6746031746031744,7,11
"['011', '10101', '1110011', '0110', '100101']",1,5,10,15,0,25,6.808696858696859,27,29
"['0011', '10101', '100', '010001']",1,4,10,8,0,18,3.982034632034632,15,15
"['0110011', '001000', '00', '0101', '0100']",1,5,15,8,2,23,6.497707847707848,28,38
"['00', '0110', '1111']",1,3,4,6,2,10,1.1666666666666665,8,4
"['11100', '10100', '11111', '1100', '01100', '110101']",1,6,12,18,4,30,10.62020202020202,29,55
"['01', '110', '0000000']",1,3,9,3,0,12,0.8222222222222222,14,6
"['101100', '00', '100']",1,3,7,4,0,11,1.9666666666666668,8,13
"['00001', '110', '01010', '1001101']",1,4,11,9,2,20,2.9166666666666665,20,12
"['0111000', '010', '111010']",1,3,8,8,0,16,2.0358974358974358,9,11
"['11001', '010', '1100101']",1,3,7,8,0,15,1.9333333333333333,9,9
"['0100001', '011101', '011']",1,3,8,8,0,16,1.882051282051282,10,11
"['1101', '100100', '010']",1,3,7,6,0,13,1.838095238095238,8,4
"['110000', '1011', '11011', '000000']",1,4,12,9,2,21,2.8828282828282825,20,24
"['1000010', '11000', '0100111', '10']",1,4,12,9,2,21,3.198412698412698,24,15
"['00011', '11', '101', '0011010', '010101', '10010', '000001', '1100111']",1,8,21,20,6,41,16.12847152847153,89,75
"['010100', '101', '0001', '001101']",1,4,11,8,2,19,3.571428571428571,16,17
"['1000001', '001', '111', '001000']",1,4,12,7,2,19,2.8376068376068377,22,15
"['010', '0000011', '111']",1,3,7,6,2,13,1.1333333333333333,12,6
"['1010', '111000', '1110110', '11']",1,4,7,12,0,19,3.7076146076146075,19,20
"['0000111', '1010', '001', '000010']",1,4,13,7,0,20,3.570962370962371,19,20
"['001', '0000011', '1111011']",1,3,8,9,2,17,1.4285714285714286,13,10
"['1010110', '0100110', '0000100', '011100', '10110', '00110', '0101', '0100']",1,8,26,19,7,45,19.376961926961926,72,121
"['0100000', '11', '100100', '011001', '1100', '111001']",1,6,17,14,3,31,8.993317793317793,46,42
"['0010110', '0001', '100']",1,3,9,5,0,14,1.516883116883117,9,9
"['0111000', '0111010', '110', '0000']",1,4,12,9,2,21,3.4337662337662334,19,27
"['00100', '111111', '10']",1,3,5,8,0,13,1.0032467532467533,13,4
"['0', '0100110', '101', '0001', '01111']",1,5,10,10,0,20,4.626479076479076,33,20
"['0110101', '0010', '00011', '000', '110']",1,5,13,9,2,22,6.105844155844156,27,31
"['010001', '111011', '100111', '010110', '000', '00010']",1,6,17,15,4,32,8.598484848484848,47,36
"['11010', '01101', '101', '0011', '11111']",1,5,7,15,3,22,6.1269841269841265,23,29
"['111', '00000', '0011', '011110', '01000']",1,5,13,10,2,23,4.486075036075036,31,30
"['1100001', '111011', '1110101', '10100', '1110']",1,5,11,18,2,29,6.648706848706849,26,43
"['1000', '0110', '010110', '00000']",1,4,13,6,2,19,3.5565656565656565,16,26
"['101', '0000011', '0111', '0001010', '01100', '111001']",1,6,17,15,2,32,8.293639693639694,50,37
"['01', '0101111', '00001']",1,3,7,7,0,14,1.349206349206349,12,8
"['110', '1000', '1010011', '1011', '1100']",1,5,10,12,3,22,6.15,24,35
"['11000', '1010110', '010', '100']",1,4,10,8,2,18,3.6166666666666667,18,15
"['10100', '1101', '000', '00011']",1,4,10,7,2,17,3.0468253968253967,16,18
"['0101101', '10111', '1010', '111110', '1011100', '0111', '1011000', '000', '011110', '0100011']",1,10,24,32,8,56,27.48127983127983,136,136
"['100', '110', '111', '0011000']",1,4,8,8,3,16,3.2666666666666666,17,14
"['110110', '101', '0001101', '1010000', '001001']",1,5,16,13,4,29,6.22014652014652,34,30
"['1001', '10', '010110', '0100']",1,4,9,7,2,16,3.9833333333333334,15,14
"['00100', '110101', '10', '00001']",1,4,11,7,2,18,2.866233766233766,19,13
"['01', '001111', '011', '00011', '0001', '0111111', '110111', '000000']",1,8,18,21,3,39,15.085359085359086,93,93
"['0', '001', '0011001', '110100']",1,4,10,7,0,17,2.6955433455433457,25,18
"['01', '001', '111']",1,3,3,5,2,8,1.5333333333333334,5,7
"['0111011', '000', '1011', '111000', '110', '01110']",1,6,12,16,2,28,8.743739593739594,45,46
"['0101010', '11100', '10']",1,3,7,7,0,14,1.5158730158730158,11,7
"['01', '10', '111']",1,3,2,5,2,7,1.3,6,6
"['1000100', '01', '10100', '0000', '0100']",1,5,16,6,2,22,6.137085137085137,25,39
"['00011', '1000', '0', '0111100']",1,4,10,7,0,17,2.6954545454545453,24,18
"['101001', '10111', '11100', '1110']",1,4,7,13,2,20,4.01010101010101,13,23
"['00', '100011', '101001', '00011']",1,4,11,8,2,19,3.8744588744588744,17,17
"['0', '10100', '0111']",1,3,5,5,0,10,1.1777777777777778,10,6
"['1010111', '0110101', '010111', '10000']",1,4,11,14,2,25,3.6163836163836165,18,19
"['1010111', '000', '101001']",1,3,8,8,0,16,1.6136752136752137,10,7
"['1001100', '11000', '0001', '0101']",1,4,12,8,2,20,3.3686868686868685,18,17
"['00', '100', '010']",1,3,6,2,2,8,2.2666666666666666,4,10
"['111101', '001110', '000']",1,3,7,8,2,15,1.5555555555555554,11,6
"['0101', '000101', '1110']",1,3,7,7,2,14,1.7000000000000002,9,9
"['010000', '1', '0011', '10101', '101', '100011']",1,6,13,12,2,25,8.043362193362194,46,44
"['110010', '11011', '1']",1,3,4,8,0,12,1.3463203463203464,11,11
"['110011', '0101', '1001110', '111010']",1,4,9,14,2,23,3.7967365967365967,18,15
"['010', '1100', '101111']",1,3,5,8,0,13,1.4158730158730157,10,5
"['000001', '10', '0101001']",1,3,10,5,0,15,1.4636752136752138,12,8
"['011', '100010', '1010111', '11111', '01011', '1110']",1,6,10,20,2,30,8.18024753024753,43,55
"['1001010', '11100', '1001011']",1,3,9,10,2,19,1.8571428571428572,8,12
"['1010000', '010', '10000']",1,3,11,4,0,15,1.9333333333333333,9,11
"['0011', '1', '101']",1,3,3,5,0,8,1.4714285714285715,7,8
"['0100001', '11000', '1101']",1,3,9,7,0,16,1.6969696969696968,9,9
"['0101101', '00', '10010']",1,3,8,6,0,14,1.5158730158730158,11,6
"['0011101', '1110000', '110100']",1,3,10,10,2,20,1.9560439560439562,11,10
"['0001001', '0010', '0000100', '1000010', '1010111', '10100', '100011', '0001010', '0110010', '0100']",1,10,39,22,8,61,30.802425352425352,133,150
"['01111', '0110', '11101', '011110', '1010010']",1,5,10,17,2,27,6.912354312354313,25,32
"['00', '000101', '100111']",1,3,8,6,2,14,1.6666666666666665,10,6
"['0', '001', '011', '0111']",1,4,5,6,2,11,3.4952380952380953,11,15
"['01', '1101011', '0110', '000', '001001']",1,5,12,10,0,22,5.41004551004551,33,22
"['010001', '1', '01111', '10110', '00']",1,5,9,10,2,19,4.0004329004329,36,19
"['1000101', '0011', '101', '10110']",1,4,9,10,0,19,3.8153679653679653,16,20
"['110010', '100011', '10', '1111']",1,4,7,11,2,18,3.0,19,21
"['0001101', '10', '0100']",1,3,8,5,0,13,1.4747474747474747,11,7
"['0011', '10001', '0110', '10011', '0000', '0101', '01100']",1,7,18,13,7,31,13.527777777777777,48,54
"['1000', '0100011', '0110', '0010']",1,4,12,7,3,19,3.5681818181818183,17,17
"['10001', '11011', '100001', '0111']",1,4,9,11,2,20,3.5656565656565657,15,26
"['1100011', '0001001', '01', '01111']",1,4,10,11,2,21,3.1746031746031744,25,16
"['11110', '0101111', '1', '000010']",1,4,8,11,0,19,2.360889110889111,26,14
"['11', '1001', '1100100', '1010', '10010', '1000011', '000100']",1,7,20,15,4,35,13.824875124875124,62,64
"['1110101', '1001', '1100101']",1,3,7,11,2,18,2.311688311688312,7,18
"['110100', '0111111', '0111', '1011', '1110', '0100']",1,6,10,19,4,29,8.743356643356643,44,49
"['10111', '00110', '011000']",1,3,8,8,2,16,1.8727272727272726,9,5
"['0110100', '0001', '10001', '1010', '11100']",1,5,14,11,4,25,6.024242424242424,28,26
"['101', '10001', '100001', '010010']",1,4,12,8,2,20,4.386363636363637,15,22
"['0010110', '11', '1110011', '0110', '010010']",1,5,12,14,2,26,5.930480630480631,34,26
"['0001011', '00', '01110']",1,3,8,6,0,14,1.5158730158730158,12,10
"['01', '11100', '010010']",1,3,7,6,0,13,1.331168831168831,11,7
"['101', '0011', '110110', '0000']",1,4,9,8,2,17,3.0238095238095237,17,13
"['1110101', '011', '110111']",1,3,4,12,0,16,1.835897435897436,9,14
"['11000', '010010', '10000', '0010011']",1,4,15,8,2,23,4.023776223776224,15,17
"['01', '100', '00101']",1,3,6,4,0,10,1.4714285714285715,8,8
"['0100010', '001011', '1000111', '11']",1,4,11,11,2,22,3.487789987789988,23,15
"['01', '100010', '11']",1,3,5,5,2,10,1.5,9,6
"['001', '1011001', '00101', '100', '100011', '010110', '101001']",1,7,19,17,5,36,13.702136752136752,59,64
"['01', '0010000', '111011', '1110101', '0110000', '000000', '01001', '001001', '0100']",1,9,31,19,6,50,20.5497446997447,113,125
"['010', '0101110', '110001', '000001', '000', '110', '110101']",1,7,19,15,6,34,11.573504273504273,65,59
"['11', '0001', '00000']",1,3,8,3,0,11,1.0,10,8
"['11110', '1010', '0100011', '101001']",1,4,10,12,0,22,3.2560994560994563,19,17
"['1011100', '001101', '111']",1,3,6,10,0,16,1.7282051282051283,10,7
"['0000011', '010001', '011', '11']",1,4,10,8,0,18,3.7803418803418802,19,19
"['01001', '10000', '11111']",1,3,7,8,3,15,1.2,10,6
"['01', '100', '111011', '1000', '1101']",1,5,8,11,2,19,5.473015873015873,26,28
"['101', '111', '0010000']",1,3,7,6,2,13,1.2666666666666666,12,4
"['110110', '001', '0001110', '011', '10110', '00110', '000']",1,7,17,15,5,32,13.42012432012432,53,77
"['0100111', '111', '101111']",1,3,4,12,0,16,2.0358974358974358,9,18
"['010', '000011', '101011', '000001', '0011011']",1,5,16,12,3,28,5.835042735042735,28,30
"['0011011', '11010', '10']",1,3,6,8,0,14,1.6825396825396823,11,8
"['0', '1010110', '1110000', '10111', '01010']",1,5,12,13,4,25,4.671428571428571,39,23
"['0001', '1', '10110', '0111100']",1,4,8,9,0,17,2.458080808080808,24,11
"['001', '1', '00011']",1,3,5,4,0,9,1.5833333333333333,8,7
"['001', '100011', '1']",1,3,5,5,0,10,1.4523809523809523,10,8
"['0110101', '11011', '00', '1010011', '110', '111101']",1,6,11,19,2,30,8.259751359751359,48,43
"['0101001', '1000011', '1101', '0011100', '1110']",1,5,14,15,5,29,5.698051948051948,36,22
"['0', '0001', '1110', '111011']",1,4,6,9,2,15,2.5357142857142856,21,14
"['110011', '101', '00', '0111111']",1,4,6,12,0,18,2.6504273504273503,23,12
"['110010', '010010', '0110110']",1,3,10,9,2,19,2.371794871794872,5,15
"['010', '1101011', '000']",1,3,7,6,2,13,1.6666666666666665,10,4
"['0', '110', '1001000', '0111010']",1,4,10,8,2,18,2.571428571428571,26,15
"['0110000', '10011', '111', '000']",1,4,10,8,2,18,2.5,21,14
"['11010', '11011', '1', '001000', '110011']",1,5,10,13,4,23,5.083549783549784,33,33
"['001', '1001', '0001101', '01011', '111001']",1,5,12,13,0,25,6.127772227772228,28,34
"['1011', '110', '01010']",1,3,5,7,0,12,1.7380952380952381,6,6
"['01101', '111', '0101100']",1,3,6,9,0,15,1.8166666666666667,9,5
"['001', '0010011', '0100111', '111011']",1,4,10,13,2,23,3.7323565323565324,20,21
"['101010', '01', '1001', '001110']",1,4,9,9,2,18,3.4,18,13
"['101', '110001', '10000', '100111', '1110']",1,5,11,13,2,24,5.9886002886002885,28,35
"['1011010', '11110', '1', '00000', '10010', '001010']",1,6,16,13,3,29,6.98979353979354,49,41
"['11', '1100100', '001000']",1,3,9,6,0,15,1.4636752136752138,13,8
"['01', '0101000', '001011', '000111']",1,4,12,9,2,21,3.3547008547008548,22,18
"['0', '000110', '1011', '10']",1,4,7,6,0,13,3.119047619047619,18,12
"['111111', '100', '110', '101111']",1,4,4,14,4,18,2.888888888888889,19,24
"['1010110', '11', '1010', '10010', '10011', '01011']",1,6,12,16,3,28,10.308225108225107,36,52
"['011011', '101011', '011001']",1,3,7,11,3,18,2.166666666666667,6,12
"['001', '010', '10101', '000', '11111', '1101', '0100101']",1,7,14,16,5,30,11.472510822510822,57,54
"['0010', '0100011', '0001011', '000111', '01110', '0111100']",1,6,19,17,3,36,9.485614385614385,48,54
"['1010', '111110', '0010', '1111111']",1,4,6,15,2,21,2.864685314685315,21,22
"['11001', '01', '00101', '0110', '00']",1,5,10,8,4,18,6.052380952380952,25,24
"['101', '1010101', '110', '0110001']",1,4,9,11,4,20,3.438095238095238,21,20
"['0110101', '0111000', '10']",1,3,8,8,2,16,1.6031746031746033,13,8
"['100001', '00000', '0111', '01010', '1110']",1,5,14,10,4,24,4.978282828282828,30,22
"['0010', '1100', '110100']",1,3,8,6,2,14,1.9,8,12
"['00111', '01001', '1000', '10010']",1,4,11,8,3,19,4.0,15,15
"['101000', '01', '0001100', '11']",1,4,10,7,2,17,3.0042735042735043,22,13
"['110000', '01', '0101111', '0110111', '0001111', '1000000', '1110']",1,7,19,21,4,40,10.167460317460318,89,70
"['10100', '00', '000111']",1,3,8,5,0,13,1.435064935064935,11,11
"['01', '111100', '111001', '11111']",1,4,5,14,2,19,3.3235930735930737,19,27
"['0110101', '1110111', '1001', '010101', '10']",1,5,10,16,2,26,6.017393717393717,31,30
"['01101', '010', '0001110', '0001', '01111', '10110', '00', '0101']",1,8,18,17,5,35,17.56320346320346,72,85
"['00', '0100011', '1110']",1,3,7,6,0,13,1.1414141414141414,13,7
"['00', '00101', '10']",1,3,6,3,2,9,1.6428571428571428,7,8
"['11010', '111', '00', '000001', '0111101']",1,5,11,12,0,23,4.426090576090576,37,23
"['01', '001100', '10100', '100110']",1,4,11,8,2,19,3.6774891774891776,17,16
"['1011', '0010', '0111110', '0111']",1,4,7,12,3,19,3.5681818181818183,17,15
"['010100', '00', '11101', '01110']",1,4,9,9,2,18,3.42987012987013,18,15
"['011011', '10000', '0000011', '000', '1001011']",1,5,17,11,2,28,5.893611943611943,31,38
"['01', '1101101', '11101']",1,3,4,10,0,14,1.6825396825396823,10,14
"['0010001', '1010110', '000011', '101', '100', '1001100', '1101', '1110']",1,8,21,20,7,41,16.49256854256854,91,82
"['0', '111', '1101', '0101', '0100']",1,5,7,9,3,16,4.914285714285715,22,22
"['001', '0110', '01000', '1111']",1,4,8,8,2,16,2.746031746031746,16,12
"['0', '00010', '1101', '100010']",1,4,10,6,0,16,2.9725829725829724,19,14
"['1000000', '10100', '10']",1,3,10,4,0,14,1.5158730158730158,11,10
"['0', '11010', '10010', '11']",1,4,6,7,2,13,2.6095238095238096,17,14
"['0010', '1010110', '011', '0001', '0001101', '0100']",1,6,17,12,5,29,9.083116883116883,43,43
"['11101', '100100', '111', '0100']",1,4,8,10,0,18,3.27005772005772,17,17
"['11001', '00100', '0011110', '0000']",1,4,13,8,2,21,3.6454545454545455,19,21
"['011', '10', '0111', '00011']",1,4,6,8,0,14,3.2928571428571427,14,18
"['000110', '01', '100100', '11']",1,4,9,7,4,16,3.1666666666666665,19,11
"['01', '0000010', '01010', '1101100']",1,4,13,8,2,21,2.9126984126984126,24,18
"['1011110', '101', '00', '111110']",1,4,6,12,0,18,3.0619658119658117,21,16
"['101100', '11011', '111', '0011010', '000001']",1,5,13,14,2,27,5.338344988344988,33,25
"['0110000', '100', '11']",1,3,7,5,0,12,1.4444444444444444,11,5
"['0011', '0110', '1100101', '000011']",1,4,11,10,2,21,4.038111888111888,18,16
"['0000101', '01100', '100100', '011100']",1,4,15,9,2,24,3.210955710955711,17,26
"['101100', '0011', '010010', '100010', '1011', '1110', '0100']",1,7,18,16,7,34,12.85,54,61
"['011111', '00110', '111100']",1,3,6,11,2,17,1.7575757575757573,9,10
"['10100', '0010', '1011111', '1111']",1,4,7,13,2,20,2.952020202020202,20,19
"['0', '0101', '0100']",1,3,6,3,2,9,1.55,7,10
"['011011', '100', '000101', '1010', '01110']",1,5,12,12,2,24,5.829870129870129,28,25
"['10111', '00010', '0101000']",1,3,10,7,2,17,1.4,10,6
"['00110', '01001', '1']",1,3,6,5,2,11,1.2666666666666666,11,4
"['00001', '101010', '0101010', '0000', '01001']",1,5,18,9,2,27,6.641258741258741,22,37
"['1101001', '110010', '101101', '11000', '00', '100111']",1,6,15,17,3,32,9.515873015873016,46,44
"['111', '100100', '10010', '0011111', '010011', '000100', '101001']",1,7,20,19,4,39,12.802020202020202,65,61
"['11100', '1', '1011']",1,3,3,7,0,10,1.1777777777777778,10,9
"['110', '1110000', '0000']",1,3,9,5,0,14,1.612987012987013,10,13
"['101100', '0010', '1110011', '10100', '001010', '111101']",1,6,16,18,3,34,9.481118881118881,42,42
"['00111', '01001', '110']",1,3,6,7,2,13,1.6,9,7
"['101', '011', '000', '11']",1,4,5,6,3,11,2.9333333333333336,11,12
"['01101', '100', '100110', '00', '1101010']",1,5,12,11,0,23,5.938017538017538,31,25
"['010001', '110001', '001', '1110']",1,4,10,9,2,19,3.4523809523809526,17,21
"['0', '001111', '100010', '1010111', '0000110']",1,5,14,13,4,27,4.912087912087912,39,23
"['11', '00010', '111000', '1001111', '0111100']",1,5,12,15,2,27,4.998445998445998,41,26
"['111111', '00', '100', '111010']",1,4,6,11,2,17,2.8555555555555556,21,16
"['0010000', '00011', '101000', '111011', '010110', '000']",1,6,20,13,3,33,8.749378399378399,49,55
"['100100', '01110', '0100']",1,3,9,6,0,15,1.8303030303030303,7,12
"['0111000', '000110', '01', '00', '101111']",1,5,12,11,4,23,4.869658119658119,39,27
"['000110', '1101', '10011', '100010']",1,4,11,10,2,21,3.9323232323232324,15,14
"['101', '11110', '01000']",1,3,6,7,2,13,1.4,9,4
"['001', '1', '11000', '0000', '101001']",1,5,12,7,0,19,4.651082251082251,30,27
"['110000', '1010101', '0000']",1,3,11,6,0,17,1.9608391608391609,9,10
"['11110', '01', '011', '100', '1100101', '0100']",1,6,11,13,2,24,8.048629148629148,44,37
"['0', '1010', '0011010', '0100010']",1,4,12,7,2,19,2.744155844155844,24,25
"['10110', '1010', '000', '011110', '1011', '110', '01100']",1,7,14,16,6,30,13.06010101010101,47,63
"['00101', '000011', '0010000', '001101', '101000', '101', '100', '1111', '0000']",1,9,27,17,7,44,19.89963924963925,109,132
"['001', '010001', '011011', '0001', '1010011', '101001']",1,6,17,15,3,32,10.282706182706182,36,54
"['010111', '0111', '011000']",1,3,7,9,2,16,1.9,9,13
"['00', '010101', '111000']",1,3,8,6,2,14,1.5,12,8
"['1101001', '111', '000101', '011101', '1010000', '0011011', '1001111']",1,7,19,24,6,43,12.76898656898657,71,68
"['010', '010001', '10', '0101000']",1,4,12,6,0,18,3.7803418803418802,19,21
"['0011110', '0001111', '0101', '1001']",1,4,10,12,4,22,3.538961038961039,21,12
"['000', '110', '111', '001010']",1,4,8,7,3,15,2.5555555555555554,16,15
"['0', '011100', '10111', '101000', '0111101']",1,5,11,14,2,25,4.9915917415917415,38,24
"['1111000', '01', '111', '1010110']",1,4,7,12,2,19,2.780952380952381,25,16
"['110001', '000101', '1111', '110111', '0011011']",1,5,11,18,3,29,6.314452214452214,29,44
"['11', '111001', '0100']",1,3,5,7,0,12,1.4333333333333333,10,6
"['01', '1001', '0101100', '01001', '0100011', '01011']",1,6,16,14,4,30,10.207647907647907,42,54
"['1101', '010', '1']",1,3,3,5,0,8,1.4714285714285715,7,4
"['0010', '001', '101', '100', '011111', '1111011']",1,6,10,16,3,26,8.043978243978243,47,38
"['100001', '00100', '10101', '10111', '11000']",1,5,14,12,4,26,5.945454545454545,26,28
"['101011', '1111000', '11']",1,3,5,10,0,15,1.4059829059829059,13,13
"['0010001', '11011', '010', '10010', '0000']",1,5,15,9,2,24,5.622438672438673,30,22
"['11011', '010', '100', '00', '010101', '010111', '0111', '1100011']",1,8,16,20,4,36,16.642002442002443,80,81
"['1110000', '00011', '01111', '111011', '00', '011110', '1001100']",1,7,17,21,6,38,11.6506438006438,75,68
"['01', '001', '1', '00000', '000111']",1,5,11,6,0,17,4.75021645021645,31,26
"['11011', '0001', '00', '1110110', '1101010']",1,5,11,14,2,25,5.536796536796537,34,28
"['1101', '00', '10']",1,3,4,4,2,8,1.5,6,4
"['0111001', '1110010', '0101110', '10', '000000']",1,5,16,13,3,29,4.956959706959707,41,26
"['0101', '000100', '11']",1,3,7,5,0,12,1.5166666666666666,10,4
"['1101001', '10', '010011', '11100', '01100']",1,5,12,13,2,25,6.262592962592962,31,25
"['0010', '001010', '00101']",1,3,10,5,0,15,2.597979797979798,4,20
"['0', '0011', '10']",1,3,4,3,0,7,1.4,7,6
"['1011001', '100011', '011', '1']",1,4,7,10,0,17,2.9177655677655676,23,21
"['001', '11100', '10']",1,3,5,5,0,10,1.4714285714285715,9,7
"['0101101', '000100', '011']",1,3,9,7,0,16,1.6598290598290597,11,7
"['101', '110', '100001']",1,3,6,6,2,12,1.7777777777777777,9,10
"['1111', '0110', '110111', '101101']",1,4,5,15,4,20,3.7666666666666666,13,18
"['00110', '1001', '011']",1,3,6,6,0,12,1.9880952380952381,7,4
"['1011', '1', '000001']",1,3,6,5,0,11,1.0857142857142859,12,8
"['110110', '1', '110100']",1,3,5,8,2,13,1.4047619047619047,11,9
"['0111000', '1101111', '1010101', '100101', '0111', '0000', '011000']",1,7,20,21,7,41,12.628354978354979,71,62
"['111', '0110', '0000001', '01010', '1100011', '0100']",1,6,17,13,4,30,7.907864357864358,50,36
"['001', '100111', '0111']",1,3,5,8,0,13,2.038095238095238,7,9
"['0011', '110001', '1001', '10', '000']",1,5,11,8,2,19,5.859523809523809,25,24
"['101110', '100', '01011', '110101']",1,4,8,12,2,20,3.9545454545454546,17,14
"['001101', '111111', '001010', '1011', '101001']",1,5,11,17,4,28,5.733333333333333,28,27
"['01', '01101', '0111010', '0010', '1011110', '100', '00110', '1000']",1,8,19,18,6,37,17.331096681096682,81,86
"['11', '101011', '1100100', '00110', '111110']",1,5,10,16,2,26,5.198856698856699,35,30
"['00010', '10', '10011', '11']",1,4,7,7,4,14,3.0999999999999996,16,14
"['01', '0100111', '110', '1001111']",1,4,7,12,2,19,2.9460317460317462,24,17
"['00', '1000', '0011010', '0100']",1,4,12,5,2,17,3.6186868686868685,18,27
"['11110', '00001', '100', '110', '01100']",1,5,11,10,5,21,5.366666666666666,27,27
"['0011', '1000', '1100']",1,3,7,5,3,12,1.75,8,10
"['1010001', '100', '001111', '10']",1,4,9,9,0,18,3.0004273504273504,24,16
"['0110101', '001100', '100']",1,3,9,7,0,16,2.0358974358974358,10,9
"['0', '11010', '110', '111']",1,4,4,8,2,12,3.0,14,17
"['001111', '1011110', '101011', '0110', '1000', '001100', '01011']",1,7,17,21,5,38,13.514141414141413,58,60
"['00', '10', '00011']",1,3,6,3,2,9,1.3571428571428572,8,8
"['110000', '01', '110', '10110']",1,4,8,8,0,16,3.1835497835497835,18,16
"['01', '10100', '1100']",1,3,6,5,0,11,1.7936507936507935,7,8
"['010001', '001', '100', '0010000']",1,4,14,5,2,19,3.9692307692307693,18,20
"['0110101', '111110', '1', '1100101']",1,4,7,14,2,21,2.5659340659340657,25,18
"['0', '1011', '1000']",1,3,5,4,2,9,1.3,8,5
"['0', '11011', '111', '110100', '01001', '0110011']",1,6,11,16,2,27,8.055644355644356,49,45
"['0', '1000110', '11011']",1,3,6,7,0,13,1.25,13,4
"['111110', '0110', '10']",1,3,4,8,0,12,1.7666666666666666,9,10
"['01', '1101', '001', '111111']",1,4,4,11,0,15,3.1103174603174604,18,19
"['0', '111', '0011', '100101', '1011']",1,5,7,11,2,18,5.045238095238095,25,27
"['111010', '00', '100111', '000001', '1110']",1,5,12,12,3,24,4.766666666666667,37,28
"['00110', '01', '10', '11110']",1,4,6,8,4,14,3.0999999999999996,17,16
"['101', '000111', '001110', '0000001']",1,4,13,9,2,22,3.1991452991452993,22,15
"['1011', '1101', '10110', '000000']",1,4,10,9,2,19,3.069191919191919,20,14
"['101011', '01011', '1111111', '0100']",1,4,7,15,0,22,2.9986013986013984,19,20
"['010', '00100', '110001', '10', '011110']",1,5,12,10,2,22,5.823448773448773,32,24
"['00001', '1011101', '0000', '1010001', '010011']",1,5,17,12,2,29,6.190820290820291,28,31
"['0', '0010', '11']",1,3,4,3,0,7,0.7333333333333334,8,4
"['10001', '1011001', '10', '0110']",1,4,9,9,0,18,3.520923520923521,19,16
"['010', '011', '00000', '101010', '100110', '011110', '0110010']",1,7,20,16,5,36,12.391724941724942,63,78
"['11110', '1000101', '10', '0000']",1,4,10,8,0,18,2.6320346320346317,22,12
"['0100000', '00111', '1000110', '10', '01110', '0101', '01100']",1,7,20,15,5,35,12.489321789321789,67,64
"['01', '111', '1000110', '1111010', '01001', '001001']",1,6,14,16,2,30,8.02887112887113,55,42
"['01', '11111', '00100', '1101011', '0000', '110101']",1,6,13,16,2,29,7.3499167499167495,50,43
"['10101', '100001', '000000']",1,3,12,5,2,17,1.7575757575757576,8,6
"['0', '100', '011']",1,3,4,3,2,7,1.3333333333333333,7,6
"['11', '000101', '0011111', '0001000', '111001']",1,5,14,14,4,28,4.902930402930403,40,34
"['1100', '001110', '010010']",1,3,9,7,2,16,1.8666666666666667,9,10
"['0', '0001', '1011000']",1,3,8,4,0,12,1.1954545454545453,13,8
"['1101101', '11110', '00', '0100']",1,4,8,10,0,18,2.886724386724387,20,13
"['0', '01001', '1011111']",1,3,5,8,0,13,1.0833333333333333,14,4
"['00111', '10111', '101110', '000']",1,4,8,11,2,19,3.6308080808080807,15,19
"['011', '1110', '11']",1,3,2,7,0,9,2.038095238095238,5,11
"['00', '00010', '0101110']",1,3,9,5,0,14,1.5158730158730158,11,15
"['01', '0111111', '1100100', '101111']",1,4,7,15,2,22,2.9053724053724053,25,18
"['101001', '0110', '10000', '01100']",1,4,12,8,2,20,3.606060606060606,15,15
"['1000', '10', '01110']",1,3,6,5,0,11,1.6825396825396823,8,8
"['11010', '111', '000101', '111011', '101111', '0110011']",1,6,11,22,3,33,9.586985236985237,44,61
"['011', '111', '101000', '1001', '101001']",1,5,10,12,4,22,6.265079365079365,25,37
"['0001', '1001000', '10100', '1000011', '00010', '1001011', '0100']",1,7,25,14,7,39,13.601443001443002,56,67
"['0000111', '1101', '011']",1,3,6,8,0,14,1.535064935064935,11,9
"['0101110', '00011', '11101', '001110', '110111']",1,5,11,18,4,29,6.8195804195804195,27,27
"['1011', '1010', '1100101', '110100']",1,4,9,12,2,21,4.01013986013986,14,20
"['001100', '01', '1110']",1,3,6,6,0,12,1.4333333333333333,10,6
"['0', '0101010', '011', '111101']",1,4,7,10,0,17,2.5416971916971915,24,12
"['0001110', '0011', '1000', '1101', '110']",1,5,11,11,3,22,5.918181818181818,30,28
"['01111', '101000', '0110', '10']",1,4,8,9,0,17,2.8826839826839827,19,16
"['00', '0110', '110100', '11']",1,4,7,7,2,14,2.933333333333333,17,14
"['110000', '1', '1101111', '000']",1,4,8,9,0,17,1.863919413919414,27,17
"['011', '110', '10']",1,3,3,5,2,8,1.8666666666666667,5,8
"['010', '00001', '1111010', '00', '11101', '01011']",1,6,13,14,3,27,8.08968253968254,47,39
"['11', '101', '0001', '1111110', '0000011', '1000011']",1,6,14,16,3,30,7.503030303030303,59,53
"['011', '111', '0001', '0100100', '1110110']",1,5,11,13,4,24,5.386147186147186,34,27
"['11', '0010100', '110100', '00', '110']",1,5,11,9,2,20,4.924786324786325,32,35
"['000111', '0111', '0000']",1,3,8,6,2,14,1.65,8,13
"['001', '101010', '100011', '110111', '1100011', '1101']",1,6,13,19,3,32,9.761949161949161,39,65
"['010', '110011', '1010', '001010', '0111', '101111', '0110011']",1,7,15,21,5,36,13.497879897879898,61,65
"['101', '1100', '000']",1,3,6,4,2,10,1.476190476190476,6,6
"['0', '001', '000101', '1111']",1,4,7,7,0,14,2.138095238095238,21,12
"['0', '0011', '11011', '101001']",1,4,7,9,0,16,3.012987012987013,19,13
"['010100', '1010110', '0010']",1,3,10,7,0,17,1.9146853146853147,7,10
"['10101', '010', '10010']",1,3,7,6,2,13,2.3,6,7
"['10100', '100001', '1001011', '0000']",1,4,14,8,0,22,3.6045843045843045,15,16
"['0', '0010', '01101', '110101']",1,4,8,8,0,16,3.012987012987013,19,12
"['11', '01', '101101']",1,3,3,7,2,10,1.5,9,9
"['1011', '0100111', '1']",1,3,4,8,0,12,1.3772727272727274,12,9
"['0010', '001', '001111', '1111101', '001110', '10', '0111', '1010011']",1,8,16,23,6,39,16.024236874236873,89,81
"['0010', '0101011', '1', '0001111']",1,4,9,10,2,19,2.705194805194805,24,12
"['11000', '011001', '1111001', '11']",1,4,8,12,0,20,3.679043179043179,19,23
"['111010', '0011100', '00', '01001', '0110001']",1,5,15,12,2,27,5.938006438006438,35,29
"['1010', '1', '011000']",1,3,6,5,0,11,1.2857142857142856,11,4
"['0111', '000', '1111']",1,3,4,7,2,11,1.0357142857142856,8,8
"['0', '101000', '100010', '1111', '10010']",1,5,12,10,2,22,4.452236652236652,34,25
"['1110111', '0110111', '110011', '1101', '1100']",1,5,8,20,4,28,6.983366633366633,24,54
"['10101', '000', '0100']",1,3,8,4,0,12,1.7380952380952381,6,6
"['0011', '011', '101001']",1,3,6,7,0,13,2.123809523809524,7,8
"['1010100', '1', '10']",1,3,5,5,0,10,1.3611111111111112,12,7
"['1', '011', '110100', '00011']",1,4,7,8,0,15,2.677128427128427,21,17
"['1001', '100', '011', '01110']",1,4,7,8,2,15,3.456349206349206,15,14
"['101', '1000', '1', '0101100']",1,4,8,7,0,15,2.866883116883117,20,12
"['0100001', '01', '1011001', '1101']",1,4,10,10,2,20,3.178932178932179,22,22
"['1111100', '110010', '001111']",1,3,7,12,2,19,1.7307692307692308,12,12
"['100101', '0000011', '0111', '00011']",1,4,12,10,0,22,3.988111888111888,16,20
"['01101', '00111', '0011', '000', '01001']",1,5,12,10,3,22,6.493650793650794,21,30
"['0010', '0110100', '00101', '010101', '001110', '10', '0000']",1,7,21,13,4,34,13.338677988677988,55,79
"['1000001', '110', '0']",1,3,7,4,0,11,1.15,13,4
"['0110111', '1001010', '101', '010111', '011001', '111101']",1,6,13,22,5,35,9.758608058608058,46,50
"['011', '000111', '11100', '111']",1,4,6,11,2,17,3.7954545454545454,17,27
"['0', '101011', '1101', '0100']",1,4,7,8,2,15,2.7857142857142856,18,9
"['01', '11100', '11111']",1,3,3,9,2,12,1.1714285714285713,10,10
"['0', '111111', '10001']",1,3,4,8,0,12,0.696969696969697,14,4
"['0', '10', '01100', '110101']",1,4,7,7,0,14,3.0844155844155843,20,10
"['0110101', '011', '111110', '10011', '010011', '01011']",1,6,12,20,4,32,8.97964257964258,39,56
"['0', '1001', '111']",1,3,3,5,0,8,0.9714285714285714,8,4
"['110110', '0101110', '011', '10001', '0011010', '1111', '1111010', '1100101', '000001', '001001']",1,10,27,31,7,58,25.873171273171273,145,130
"['1001110', '000110', '011111', '100110']",1,4,11,14,3,25,4.141025641025641,14,24
"['0000100', '0011001', '1000', '10', '000', '1010010']",1,6,21,9,3,30,9.018181818181818,52,54
"['0111001', '1111', '1000010', '00', '1100', '0100101']",1,6,16,15,5,31,7.954545454545454,56,34
"['1110111', '01101', '01010']",1,3,6,11,2,17,1.9666666666666668,9,5
"['0010010', '011', '0100']",1,3,9,5,0,14,1.8987012987012988,9,10
"['10101', '00101', '011', '000101']",1,4,10,9,2,19,4.6030303030303035,11,23
"['0101', '001', '0010011']",1,3,8,6,0,14,1.8987012987012988,8,9
"['1100111', '01001', '00000']",1,3,10,7,2,17,1.4,10,4
"['001', '00011', '1100011', '0101', '01100', '110101']",1,6,15,15,2,30,9.686618936618936,41,46
"['0010', '01', '1111101', '1001', '110111']",1,5,8,15,2,23,5.552253302253302,33,26
"['0011', '110001', '0011010', '0010100', '00', '0101']",1,6,18,12,4,30,9.669225219225218,48,49
"['001', '00101', '10100', '1010', '110', '111101']",1,6,12,14,4,26,8.683766233766233,37,43
"['0010111', '0110', '0000001', '0100011', '11111', '1011', '1101', '000100']",1,8,22,22,6,44,14.493267843267843,96,77
"['000110', '111', '1001', '0000', '0111101', '101110']",1,6,14,16,4,30,8.142912642912643,48,34
"['1010111', '1000', '01110']",1,3,7,9,0,16,1.6565656565656566,10,5
"['001', '11111', '10111', '0110', '0000', '01100']",1,6,12,14,5,26,7.159523809523809,40,38
"['01', '00', '111', '111101']",1,4,4,9,2,13,2.3166666666666664,18,15
"['0', '010001', '1111', '10100', '110101']",1,5,10,12,2,22,4.67041847041847,34,21
"['0', '111100', '111101', '01010', '1001011']",1,5,10,15,2,25,4.822594072594073,37,22
"['1011010', '1011001', '1001010', '1100110', '1101']",1,5,14,18,4,32,7.298701298701299,27,36
"['11001', '01', '1111101', '101101', '00001', '0011', '10']",1,7,13,18,4,31,11.145998445998446,68,66
"['0101111', '0011', '011000', '10100', '110111', '01001', '0110011']",1,7,18,22,6,40,13.761294261294262,61,65
"['01', '111', '110010', '0000']",1,4,8,7,0,15,2.5,19,12
"['101100', '00101', '00001', '001110', '1100111', '1101', '101001']",1,7,19,20,5,39,13.013442113442114,59,62
"['010', '111', '1001000', '100110', '1010']",1,5,12,11,2,23,6.169519369519369,27,27
"['010', '00011', '011110', '0000', '110101']",1,5,13,11,2,24,5.462337662337662,30,27
"['1000100', '0101', '011', '111']",1,4,8,9,2,17,3.4406926406926406,18,15
"['01', '00011', '01100', '10110', '111111', '0111', '0001011', '01000', '0100']",1,9,21,22,6,43,20.118154068154066,109,112
"['11010', '010', '1111', '1110100', '0111', '10']",1,6,9,16,2,25,8.87907647907648,41,47
"['10101', '001', '1001']",1,3,6,6,0,12,2.246031746031746,4,13
"['11010', '0011101', '11', '00', '1101', '011000']",1,6,12,14,2,26,8.257231657231657,47,41
"['00100', '0000101', '1000000', '001010', '11111', '101110', '0100']",1,7,24,16,6,40,11.367121767121766,67,64
"['1', '001000', '101', '100110', '1100101', '0000', '0101']",1,7,18,13,4,31,10.799406149406149,71,52
"['001100', '101', '11']",1,3,5,6,0,11,1.7444444444444445,9,4
"['01', '0101000', '11']",1,3,6,5,2,11,1.3888888888888888,11,5
"['01111', '1100101', '000', '101001', '1110']",1,5,11,14,0,25,5.006965256965257,32,23
"['01', '0011110', '1110']",1,3,5,8,0,13,1.505050505050505,11,9
"['100110', '11110', '1110010', '01010']",1,4,10,13,2,23,3.7904428904428906,15,22
"['010', '0101000', '00100', '1011', '1101']",1,5,13,10,2,23,6.055988455988456,28,21
"['111010', '1010101', '110001', '0000000', '101001']",1,5,18,14,5,32,5.826007326007326,30,28
"['10', '10011', '11111']",1,3,3,9,2,12,1.2571428571428571,9,11
"['11001', '01', '111']",1,3,3,7,0,10,1.7214285714285715,7,11
"['0011', '011010', '1']",1,3,5,6,0,11,1.2857142857142856,11,4
"['101', '0101', '0101100', '0000']",1,4,11,7,2,18,3.3337662337662337,16,17
"['001', '0001010', '011101', '00', '1011', '1100']",1,6,14,12,2,26,8.156221556221556,47,39
"['01', '11010', '1000', '00', '111000']",1,5,11,8,2,19,5.586796536796537,27,28
"['000011', '10010', '0000001', '011100']",1,4,16,8,2,24,3.167832167832168,22,17
"['0', '110010', '010010', '01100']",1,4,11,7,2,18,3.1926406926406927,20,23
"['101001', '0011110', '1000000', '1100101', '10', '111101']",1,6,17,18,5,35,7.789377289377289,58,40
"['001', '010001', '001101', '0011010', '1111', '1000', '0101']",1,7,18,16,5,34,12.314701964701964,60,62
"['0011', '01010', '110', '1']",1,4,6,7,0,13,2.9714285714285715,16,12
"['001', '010000', '0101011', '111011', '1110110', '1110', '0100']",1,7,17,20,6,37,11.626517926517927,67,71
"['1', '00110', '11010', '0011100']",1,4,9,9,2,18,3.0166666666666666,23,15
"['1000001', '010100', '00', '1100111', '01100']",1,5,16,11,2,27,5.684426684426684,37,23
"['1101', '0110111', '1001011']",1,3,6,12,2,18,2.168831168831169,9,11
"['1111100', '000110', '11011', '010111', '000', '0101']",1,6,14,17,2,31,8.125313575313575,48,44
"['110010', '100001', '11', '011011', '1100010', '1001', '100', '0101010', '01110']",1,9,23,23,5,46,21.47967587967588,111,101
"['101011', '0011', '10111', '10000', '1101110', '0111', '010011']",1,7,15,22,6,37,13.541686091686092,52,71
"['01101', '0001001', '0111001', '01111']",1,4,11,13,4,24,4.347619047619048,14,24
"['01', '0010', '0110', '1100110', '1011', '00010']",1,6,14,12,3,26,9.864357864357864,37,43
"['11', '100100', '0010100', '100111', '1011100']",1,5,14,14,4,28,5.885225885225886,33,34
"['1011', '01', '11100', '1111']",1,4,4,11,2,15,2.8968253968253967,15,21
"['0', '1010100', '0111', '00010', '110']",1,5,11,9,0,20,4.4446608946608945,34,25
"['01', '0110', '01100']",1,3,6,5,0,11,2.126984126984127,6,13
"['1101011', '10011', '00101']",1,3,7,10,2,17,2.3,7,11
"['1010', '11010', '011100']",1,3,7,8,0,15,2.216161616161616,7,9
"['001101', '01', '011', '01100']",1,4,8,8,0,16,4.0153679653679655,15,18
"['1', '00', '1100110', '01000']",1,4,9,6,0,15,2.265873015873016,23,12
"['10001', '111110', '0101110', '0010111']",1,4,10,15,2,25,3.451548451548452,20,15
"['111000', '1111110', '01000']",1,3,8,10,0,18,1.675990675990676,10,11
"['1101000', '110', '1111']",1,3,5,9,0,14,1.7168831168831167,10,12
"['0', '010', '111', '0110110', '0110001']",1,5,10,11,4,21,4.447619047619048,38,26
"['0', '00111', '1100110']",1,3,6,7,0,13,1.25,13,7
"['1101001', '111', '010110', '000', '1101010']",1,5,12,14,4,26,5.399023199023199,32,25
"['100', '1111', '010110', '0111', '1110']",1,5,7,14,3,21,5.859523809523809,22,31
"['110000', '1101', '10011']",1,3,7,8,0,15,1.5898989898989897,8,12
"['1001110', '001111', '010010', '0100']",1,4,12,11,2,23,3.783916083916084,19,19
"['0011101', '100001', '1110000', '101', '00', '111000', '0110001']",1,7,21,17,5,38,12.133089133089133,74,65
"['1010001', '01110', '0111100']",1,3,9,10,2,19,1.7380952380952381,10,7
"['00100', '01', '000000']",1,3,11,2,0,13,1.5487012987012987,10,12
"['1011', '00110', '01111']",1,3,5,9,2,14,1.9333333333333331,6,5
"['0101111', '0010111', '1', '0000']",1,4,9,10,2,19,2.266233766233766,27,14
"['1011001', '011', '01100', '1100000', '11101', '10', '0111', '0100101', '0100']",1,9,22,22,7,44,21.43008658008658,112,99
"['000110', '00010', '10001', '01111']",1,4,12,9,3,21,3.7818181818181817,16,14
"['0011', '01', '100']",1,3,5,4,0,9,1.638095238095238,7,7
"['011111', '1', '001101']",1,3,4,9,2,13,1.2380952380952381,12,6
"['0', '0101', '10010']",1,3,6,4,0,10,1.4,10,6
"['0100011', '001', '0011100']",1,3,10,7,2,17,1.7714285714285714,13,9
"['00010', '0101011', '10000', '011110']",1,4,13,10,2,23,3.1706293706293707,19,18
"['10101', '010110', '1111']",1,3,5,10,0,15,1.793939393939394,8,4
"['001101', '01101', '10']",1,3,6,7,0,13,1.9805194805194803,8,10
"['0001010', '10', '111']",1,3,6,6,0,12,1.2444444444444445,12,5
"['00', '010', '1', '01100']",1,4,7,4,0,11,2.954761904761905,14,15
"['101000', '0101000', '111010']",1,3,11,8,2,19,2.2051282051282053,6,11
"['101100', '01', '010000', '101', '0011111', '01001', '000100']",1,7,20,15,3,35,11.934015984015984,71,61
"['011', '0101101', '010110', '1100011', '00010', '011010', '0000110', '1001011']",1,8,25,23,6,48,18.520712620712622,83,84
"['100001', '1', '001000']",1,3,9,4,2,13,1.2380952380952381,13,4
"['101', '01', '1000', '110111']",1,4,6,9,0,15,3.2714285714285714,17,16
"['0', '11110', '1110000', '1001', '1101110']",1,5,10,14,2,24,4.84011544011544,39,25
"['0', '0000100', '000101', '11111', '111000', '110', '110101']",1,7,17,17,3,34,9.613591963591963,81,61
"['0010010', '0101', '0101110', '111']",1,4,10,11,2,21,3.74025974025974,20,14
"['00110', '100', '001', '011']",1,4,8,6,3,14,3.6666666666666665,13,16
"['01', '010000', '1', '0100']",1,4,9,4,0,13,3.319047619047619,17,16
"['11', '111001', '0000']",1,3,6,6,0,12,0.9,12,6
"['0', '0101111', '010']",1,3,5,6,0,11,1.35,12,10
"['010001', '001', '11']",1,3,6,5,0,11,1.5666666666666667,9,8
"['10010', '001111', '00000']",1,3,10,6,2,16,1.509090909090909,10,8
"['01', '111110', '000']",1,3,5,6,0,11,0.8722222222222222,12,6
"['111', '101', '10', '0100001', '01100']",1,5,10,10,2,20,5.549206349206349,30,21
"['0101', '1010', '111110', '00010']",1,4,9,10,2,19,3.246969696969697,17,16
"['11001', '111100', '00', '1010', '1011', '01001', '0111110', '01000']",1,8,18,20,5,38,16.16078921078921,81,71
"['11001', '0011101', '1']",1,3,5,8,0,13,1.25,13,9
"['0', '10', '0111', '101110', '01100']",1,5,8,10,0,18,5.2844155844155845,29,26
"['01', '00', '00101']",1,3,6,3,2,9,1.6428571428571428,7,9
"['0', '0001', '0111']",1,3,5,4,2,9,1.3,8,6
"['11001', '00010', '100', '0110']",1,4,10,7,2,17,3.7547619047619047,15,12
"['1001100', '01', '10100', '01011']",1,4,10,9,2,19,3.3539682539682536,20,16
"['101', '01101', '01111']",1,3,4,9,2,13,2.05,6,10
"['01101', '001110', '011']",1,3,6,8,0,14,2.143939393939394,8,8
"['0', '010100', '0111', '0001011', '0110011']",1,5,13,12,2,25,5.1573426573426575,38,31
"['0', '10001', '1001', '0010011', '1110']",1,5,11,10,2,21,4.974242424242425,34,23
"['01100', '10', '000001', '0111']",1,4,10,7,0,17,2.585064935064935,20,15
"['111', '101000', '01111', '1101011', '011101', '001001']",1,6,13,20,3,33,8.903224553224554,45,47
"['1001001', '110', '000001']",1,3,10,6,0,16,1.083760683760684,11,8
"['11011', '001110', '000', '1001100', '1110']",1,5,12,13,0,25,5.811005661005661,30,28
"['0001', '0010100', '100111', '0011111', '10']",1,5,13,13,2,26,5.146953046953047,38,27
"['111100', '00101', '1110011', '00', '1011', '1110', '001100']",1,7,15,19,4,34,11.957054057054057,65,68
"['0010110', '100', '111', '0']",1,4,7,7,2,14,1.8833333333333333,21,11
"['00', '0111001', '1111101', '0010100']",1,4,11,12,3,23,2.9682539682539684,25,15
"['11011', '0000110', '10']",1,3,7,7,0,14,1.5158730158730158,12,5
"['11', '00111', '0111', '011001', '0001011']",1,5,10,14,0,24,6.257209457209457,28,34
"['1101', '001', '10', '1110000']",1,4,8,8,0,16,3.027994227994228,20,15
"['110110', '1101100', '110011', '10100', '10', '0111', '1000011']",1,7,16,21,4,37,12.644721944721944,68,72
"['11110', '00101', '111', '110001', '0010100', '1001001']",1,6,16,17,4,33,8.83981018981019,48,46
"['1000', '001101', '01010']",1,3,9,6,0,15,1.793939393939394,9,7
"['001', '100', '00110', '011111', '1101', '1110']",1,6,10,15,4,25,8.212121212121211,41,39
"['0110001', '01', '0000010', '000']",1,4,14,5,2,19,3.2031746031746033,23,20
"['100', '100111', '000']",1,3,7,5,2,12,1.7777777777777777,8,8
"['0010111', '10110', '110111', '010011', '1110']",1,5,10,18,2,28,6.6068376068376065,26,36
"['01', '0100000', '100', '010110', '0000', '101111']",1,6,17,11,2,28,7.577333777333777,53,44
"['0001', '1110000', '11']",1,3,7,6,0,13,1.323232323232323,12,10
"['01', '00001', '10110', '0010011', '00']",1,5,13,8,4,21,5.241269841269841,33,26
"['11110', '0000100', '0011', '101', '00110', '10100', '01010', '1100', '0100']",1,9,24,18,7,42,21.915800865800865,90,118
"['0010011', '0110', '110001', '0000']",1,4,13,8,2,21,3.4342657342657343,19,13
"['0001011', '101100', '1', '0111']",1,4,8,10,0,18,2.6965534465534464,24,14
"['0000111', '100000', '0000']",1,3,13,4,0,17,2.1426573426573428,9,21
"['11001', '010', '0101111', '00111', '100', '0000101', '0111111', '000', '1011']",1,9,20,24,8,44,19.38881673881674,120,99
"['0001101', '0011', '001']",1,3,8,6,0,14,2.1844155844155844,8,11
"['00100', '001010', '000010', '0100']",1,4,16,5,2,21,4.5919191919191915,10,39
"['11110', '01011', '11']",1,3,3,9,2,12,1.5428571428571427,9,11
"['0100010', '0110000', '010010', '000']",1,4,17,6,2,23,4.416117216117216,16,36
"['001111', '101101', '010010', '1010', '1000', '11111', '101111']",1,7,14,23,6,37,12.38030303030303,57,71
"['101010', '0010', '010', '1001']",1,4,10,7,2,17,4.245238095238095,13,17
"['0110101', '101000', '101100']",1,3,10,9,2,19,2.217948717948718,8,9
"['0101001', '1110011', '0100100', '0100']",1,4,14,11,3,25,4.0,19,20
"['1110101', '0001001', '0100']",1,3,10,8,2,18,1.844155844155844,11,6
"['1', '00', '001110', '10010', '1010001', '110101']",1,6,14,13,2,27,7.022616272616273,56,31
"['000110', '11010', '0100111', '1', '100011', '100101']",1,6,15,16,3,31,8.217865467865469,50,36
"['0011011', '0111', '11']",1,3,4,9,0,13,1.8383838383838382,10,11
"['0', '0000100', '000011', '1100100', '1000111', '10010', '110111', '1011']",1,8,23,20,5,43,14.883000333000332,97,85
"['0010', '1', '0100']",1,3,6,3,2,9,1.55,8,5
"['10001', '100', '0000000', '0101100']",1,4,16,6,2,22,3.0357142857142856,22,18
"['11001', '0001', '1000111', '110100', '1110001', '100011', '01010']",1,7,20,20,6,40,13.73029193029193,60,71
"['10001', '1010', '1001']",1,3,7,6,2,13,2.3055555555555554,5,14
"['11001', '0011', '1000110', '00000']",1,4,13,8,2,21,3.405050505050505,18,13
"['00111', '11000', '011100', '00001']",1,4,12,9,3,21,3.418181818181818,19,20
"['10111', '1000', '010111', '110', '011000']",1,5,11,13,2,24,5.781529581529582,30,29
"['0100000', '1110010', '11010', '011', '001', '01101', '1111', '0000010', '1110']",1,9,23,22,9,45,19.407359307359307,116,111
"['1100', '1', '10000', '01010']",1,4,9,6,2,15,3.0,18,11
"['01', '0000001', '10']",1,3,8,3,2,11,1.1666666666666665,13,7
"['0', '0011', '111101']",1,3,4,7,0,11,1.0857142857142859,12,5
"['01', '010', '11010', '00110', '101111']",1,5,9,12,2,21,6.078210678210678,28,24
"['011101', '011', '1100011']",1,3,6,10,0,16,1.7282051282051283,11,11
"['001', '0010111', '1100000', '11101', '110111']",1,5,12,16,2,28,5.331057831057831,38,42
"['01', '0001', '1111110', '1111', '001110', '0000011', '000', '001011']",1,8,19,20,6,39,13.78003663003663,99,92
"['10001', '0101111', '010011', '0110001']",1,4,12,13,2,25,4.170496170496171,16,21
"['0001001', '001', '101', '111000', '01100']",1,5,14,10,2,24,5.411033411033411,32,29
"['0010001', '100', '1111110', '011101', '1000', '11100']",1,6,15,17,2,32,8.61958596958597,51,42
"['110011', '101', '0110001', '11']",1,4,7,11,0,18,3.7803418803418802,19,23
"['01', '10000', '1100001', '10']",1,4,10,6,2,16,3.079365079365079,21,14
"['01101', '111', '0100010', '1001', '1110001', '1000']",1,6,15,15,4,30,9.202741702741703,43,41
"['010', '01111', '1001010']",1,3,7,8,0,15,1.6,11,9
"['1011', '10100', '0011']",1,3,6,7,2,13,1.8611111111111112,6,11
"['1', '001010', '000001', '000', '1101']",1,5,13,7,2,20,4.09047619047619,35,24
"['1000', '1010100', '111011']",1,3,8,9,0,17,1.5608391608391607,10,8
"['11001', '001', '10', '1101', '1110']",1,5,7,11,2,18,6.217460317460318,21,31
"['001101', '1000000', '10']",1,3,10,5,0,15,1.4059829059829059,13,8
"['110000', '101011', '00', '111110']",1,4,9,11,3,20,2.4166666666666665,23,15
"['1011110', '01', '001', '10']",1,4,6,8,2,14,2.988888888888889,20,15
"['0', '1110100', '010110']",1,3,7,7,0,14,1.151098901098901,14,8
"['1111010', '0001', '1', '0000']",1,4,9,7,2,16,2.1272727272727274,24,14
"['11001', '111', '001000', '0011', '10']",1,5,10,10,0,20,5.1605339105339105,30,26
"['1010', '11101', '0111', '1001']",1,4,6,11,3,17,3.75,14,18
"['100101', '01', '00', '010111']",1,4,8,8,4,16,3.1666666666666665,20,12
"['110000', '11', '101', '1001101', '011111']",1,5,9,15,2,24,5.143589743589744,38,34
"['101011', '100', '0111']",1,3,5,8,0,13,1.5523809523809522,8,8
"['1011', '10001', '0011010', '111']",1,4,8,11,0,19,3.3835497835497836,18,15
"['0', '010', '01111']",1,3,4,5,0,9,1.3333333333333333,9,9
"['0011001', '010', '0110', '0101100']",1,4,12,9,2,21,4.368831168831169,17,24
"['01', '0111010', '0101000', '111', '10', '0011100']",1,6,14,14,5,28,7.852380952380952,56,36
"['110110', '01', '11', '00100', '0001101', '10100']",1,6,14,13,4,27,8.243667443667444,48,38
"['010', '001', '10', '11']",1,4,5,5,4,10,3.166666666666667,10,11
"['1000010', '1000011', '10011', '0001000']",1,4,17,9,3,26,4.142857142857142,17,22
"['011111', '01', '001110', '0111011']",1,4,7,14,2,21,3.8034188034188032,19,18
"['11', '001010', '000', '1011', '01011']",1,5,10,10,0,20,5.406637806637806,27,25
"['01', '01010', '001110', '000000']",1,4,13,6,2,19,3.094155844155844,20,22
"['10001', '1', '01010']",1,3,6,5,2,11,1.2666666666666666,11,4
"['11001', '10001', '10', '000', '1101', '001011', '1110']",1,7,14,15,4,29,12.171861471861472,54,57
"['010', '100', '111']",1,3,4,5,3,9,1.3333333333333333,6,4
"['10111', '00', '000001', '011000']",1,4,12,7,2,19,2.6948051948051948,23,16
"['0000101', '110110', '0001', '001']",1,4,12,8,0,20,3.4903984903984906,20,20
"['11000', '1111010', '1110100', '110', '01100']",1,5,12,15,4,27,7.190476190476191,27,33
"['101100', '01', '001101', '101', '000101', '01110']",1,6,14,14,3,28,9.371428571428572,41,43
"['0', '101000', '0001100']",1,3,10,4,0,14,1.151098901098901,14,11
"['010110', '000', '11']",1,3,6,5,0,11,1.1666666666666665,10,4
"['1010110', '111110', '00010', '11']",1,4,8,12,0,20,2.863025863025863,22,16
"['110000', '010', '000100', '00']",1,4,13,4,2,17,3.411111111111111,19,27
"['101110', '1', '1111001']",1,3,4,10,0,14,1.304945054945055,14,8
"['01101', '0010111', '111', '1011110', '101', '1001', '0000110']",1,7,15,21,5,36,12.733189033189033,66,57
"['1011010', '1000110', '110010']",1,3,10,10,2,20,2.2527472527472527,7,11
"['1101101', '000', '011100']",1,3,8,8,0,16,1.45982905982906,11,6
"['01', '1110010', '0101110', '1010', '00', '11101', '010110', '10011']",1,8,17,21,6,38,16.814940614940614,87,73
"['1', '011', '0011', '1001000', '0000']",1,5,12,7,2,19,4.283766233766234,33,27
"['100', '010', '100000', '0000001']",1,4,15,4,2,19,3.347008547008547,21,20
"['111110', '01011', '0100']",1,3,6,9,0,15,1.4303030303030302,9,9
"['1', '1111110', '0100']",1,3,4,8,0,12,1.0136363636363637,14,4
"['00111', '01', '000']",1,3,6,4,0,10,1.4714285714285715,8,8
"['110110', '10000', '1111', '1011', '0111110', '0100']",1,6,12,18,3,30,7.941841491841492,44,36
"['0010001', '00010', '1']",1,3,9,4,0,13,1.25,13,5
"['111111', '110101', '0111100']",1,3,5,14,2,19,1.8974358974358974,8,6
"['0', '100011', '011000']",1,3,8,5,2,13,1.2380952380952381,14,4
"['01', '001', '011', '00011', '0001', '01111', '0111111', '100000']",1,8,17,18,4,35,15.727294927294928,85,90
"['000110', '0001', '100', '10110', '1100']",1,5,13,9,2,22,6.361399711399711,25,33
"['00011', '11000', '10110', '000101', '10']",1,5,13,10,3,23,5.728571428571429,32,30
"['101', '100111', '1', '0000']",1,4,7,7,0,14,2.138095238095238,21,13
"['111000', '1100', '01011', '11']",1,4,7,10,0,17,3.346176046176046,18,22
"['1111101', '11', '0011', '11000', '1001', '0101011']",1,6,11,18,4,29,8.28030303030303,52,53
"['0', '0111000', '10', '110111']",1,4,7,9,0,16,2.762210012210012,26,10
"['010', '0001', '1111', '1101', '0100']",1,5,9,10,4,19,5.035714285714286,21,22
"['0001010', '010001', '1', '0111']",1,4,10,8,0,18,2.6965534465534464,24,11
"['0001', '100111', '10', '000', '001001']",1,5,13,8,2,21,5.568253968253968,29,28
"['1111101', '1', '0110000', '1010', '1011000']",1,5,12,14,3,26,4.8253246753246755,41,22
"['001', '0110110', '0111', '00011']",1,4,9,10,0,19,3.615367965367965,16,16
"['1110000', '010', '100111', '001001']",1,4,12,10,2,22,3.100854700854701,24,13
"['10101', '011', '01110']",1,3,5,8,2,13,1.9,7,6
"['0001001', '001', '1100', '0110']",1,4,11,7,2,18,3.5837662337662337,19,17
"['101', '00', '110', '000001']",1,4,9,5,2,14,2.6333333333333333,19,13
"['01', '11000', '111111', '111110', '0000111', '1110']",1,6,10,20,2,30,7.341114441114441,56,62
"['11001', '0111101', '1111000']",1,3,7,12,2,19,2.0476190476190474,9,8
"['10101', '1011011', '0110', '11101']",1,4,7,14,2,21,4.105050505050505,13,17
"['1010001', '11011', '010111', '1110']",1,4,8,14,0,22,3.6396270396270394,17,20
"['00', '110', '101001']",1,3,6,5,0,11,1.3444444444444446,9,4
"['1', '00101', '100110', '1001001', '1110']",1,5,11,12,0,23,5.206965256965257,34,28
"['1100', '001010', '00101', '0111100']",1,4,12,10,0,22,3.321833721833722,17,25
"['0', '10001', '11101']",1,3,5,6,2,11,1.2666666666666666,10,5
"['11001', '0110101', '1']",1,3,5,8,0,13,1.4166666666666667,12,9
"['0010110', '0010', '100011']",1,3,10,7,0,17,1.9426573426573426,9,8
"['0', '110111', '11']",1,3,2,7,0,9,0.7857142857142857,11,8
"['010', '0011', '100', '1101011', '01010']",1,5,11,11,2,22,6.57012987012987,27,26
"['0000001', '111', '0001111']",1,3,9,8,2,17,1.3714285714285714,13,12
"['0', '0010000', '1111']",1,3,7,5,0,12,0.4318181818181818,16,4
"['01', '0011', '011101', '110011', '110']",1,5,8,13,2,21,5.871428571428571,29,30
"['01', '0001110', '111011']",1,3,6,9,0,15,1.5598290598290598,14,4
"['01', '010000', '111', '1000110', '100111', '01010']",1,6,15,14,2,29,8.182617382617382,51,37
"['1100011', '01', '1']",1,3,4,6,0,10,1.3611111111111112,12,8
"['1111100', '1010', '1100000', '0']",1,4,10,9,2,19,2.5623376623376624,26,14
"['11', '10001', '10', '000', '0100']",1,5,10,6,2,16,5.030952380952381,23,19
"['011111', '0100101', '1111']",1,3,5,12,0,17,1.9608391608391609,9,13
"['1011', '00', '01111', '11111']",1,4,4,12,2,16,2.53015873015873,17,19
"['110110', '101', '111001', '11']",1,4,5,12,2,17,3.8,18,24
"['010', '000100', '1101010']",1,3,10,6,0,16,1.882051282051282,10,10
"['0010', '01', '001111', '1101000', '1010', '110']",1,6,13,13,2,26,8.195498945498946,46,42
"['1010', '1100', '001110', '10110']",1,4,9,10,2,19,4.032828282828283,13,19
"['01', '110010', '11011', '0011', '1111']",1,5,7,14,2,21,6.054256854256854,25,37
"['111110', '0100', '11']",1,3,4,8,0,12,1.2333333333333334,11,6
"['0010110', '11011', '0100010', '101', '1001', '10', '0111']",1,7,15,17,4,32,12.373953823953823,63,48
"['101', '1111110', '0110011']",1,3,5,12,2,17,1.4285714285714286,13,7
"['0110100', '111010', '10110', '1101', '1100']",1,5,11,15,2,26,7.301048951048951,23,25
"['11110', '0001', '11']",1,3,4,7,0,11,1.126984126984127,10,8
"['00111', '1011', '001', '010000']",1,4,10,8,0,18,3.196176046176046,18,15
"['11011', '00', '110001']",1,3,6,7,0,13,1.512987012987013,10,7
"['010', '001', '011110']",1,3,6,6,2,12,1.7777777777777777,9,10
"['1001000', '1111', '100000', '010111', '1100101', '1101']",1,6,16,18,6,34,8.26894771894772,50,54
"['1101010', '10', '11']",1,3,4,7,2,11,1.3888888888888888,11,9
"['100000', '110', '1']",1,3,6,4,0,10,1.2301587301587302,11,6
"['0010', '010', '100', '10011', '01011', '01110']",1,6,13,12,5,25,9.845238095238095,33,43
"['11010', '010', '11011', '101', '000111']",1,5,9,13,4,22,6.196464646464646,27,27
"['10111', '00110', '110111']",1,3,5,11,2,16,2.0545454545454547,6,9
"['100', '0110', '1111010', '00', '100101', '111000', '110']",1,7,15,16,4,31,12.847530247530248,61,55
"['10101', '00', '010001', '10']",1,4,9,6,2,15,3.37012987012987,17,12
"['0011110', '010110', '011000']",1,3,10,9,2,19,2.051282051282051,8,16
"['0110101', '010', '11', '101011', '10000']",1,5,11,12,0,23,5.211510711510711,35,22
"['11110', '011', '0101011', '10', '000', '1110110', '0100']",1,7,14,17,4,31,10.784632034632034,67,62
"['1001', '10010', '111', '000101']",1,4,9,9,0,18,3.732034632034632,15,18
"['1110001', '010', '0101011', '10']",1,4,9,10,2,19,2.9746031746031747,24,14
"['1111101', '111', '0011', '00', '000100']",1,5,10,12,0,22,4.053868353868354,39,31
"['101', '1001', '001']",1,3,5,5,2,10,2.380952380952381,3,13
"['11101', '0011010', '0110011']",1,3,8,11,2,19,1.9047619047619047,9,5
"['0110100', '111', '10', '10011', '011001']",1,5,10,13,0,23,5.679043179043179,32,24
"['01', '001', '0010000', '10011', '1101']",1,5,12,9,0,21,5.934271284271285,30,25
"['010', '01111', '00000']",1,3,8,5,2,13,1.2,10,9
"['0001010', '010', '10011', '111']",1,4,9,9,2,18,3.0,19,12
"['10111', '00', '100011', '10']",1,4,7,8,2,15,3.0844155844155843,18,14
"['0', '11011', '01100']",1,3,5,6,2,11,1.2666666666666666,11,4
"['111', '00000', '100000', '0111', '1101']",1,5,12,10,2,22,4.39004329004329,32,33
"['1010', '1101', '0010010', '11000']",1,4,11,9,2,20,3.840909090909091,16,15
"['01', '100010', '1', '0001111']",1,4,8,8,0,16,2.762210012210012,25,12
"['110011', '01', '111011']",1,3,4,10,2,14,1.8333333333333335,9,13
"['100110', '111100', '1001101', '11']",1,4,8,13,2,21,3.482905982905983,20,21
"['110110', '1101101', '1100100', '000', '1011', '1100', '0110001']",1,7,18,20,5,38,13.27031857031857,64,67
"['1', '1100', '01100']",1,3,5,5,0,10,1.6222222222222222,8,7
"['100', '001010', '1101010']",1,3,9,7,0,16,2.0358974358974358,9,11
"['01', '011011', '1000110', '0001', '000001', '10', '1001111']",1,7,18,16,6,34,11.00966255966256,75,56
"['0010', '111', '100', '100101', '1011']",1,5,9,11,4,20,5.566666666666666,22,27
"['0', '010', '01101', '00101', '111']",1,5,8,9,4,17,5.05,25,21
"['100001', '00', '010101', '01001', '111000']",1,5,15,10,3,25,6.086580086580087,31,26
"['0', '001', '10110']",1,3,5,4,0,9,1.3333333333333333,9,6
"['101', '0110110', '0110001', '010110']",1,4,11,12,2,23,4.119413919413919,19,20
"['00', '100', '10110', '11111']",1,4,6,9,2,15,2.7714285714285714,17,13
"['0', '101011', '01', '1111']",1,4,4,9,0,13,2.1857142857142855,19,12
"['00', '111', '01100']",1,3,5,5,0,10,1.0714285714285714,9,6
"['01', '10001', '001001']",1,3,8,5,0,13,1.7987012987012987,9,10
"['10101', '010', '1100', '0100']",1,4,9,7,2,16,4.261904761904762,10,14
"['11010', '11', '00001', '101', '10011']",1,5,9,11,3,20,5.628571428571428,26,33
"['0001', '10', '011110']",1,3,6,6,0,12,1.2333333333333334,11,7
"['010100', '1011', '01', '11010']",1,4,8,9,0,17,3.732034632034632,16,12
"['10000', '0111', '000010', '1100011', '001001']",1,5,17,11,2,28,5.6045066045066045,32,25
"['001', '001101', '101000', '000101', '1010', '11100']",1,6,17,13,3,30,8.985569985569985,43,49
"['0', '110000', '100', '0111', '1011']",1,5,9,9,2,18,4.65952380952381,32,23
"['01', '00', '100010']",1,3,7,3,2,10,1.5,9,6
"['101', '10', '101110', '1111011']",1,4,5,13,0,18,3.6264957264957265,20,19
"['10111', '1000000', '10', '000', '101001']",1,5,14,9,0,23,4.732461982461983,35,29
"['011111', '111000', '0100']",1,3,7,9,2,16,1.5,11,10
"['101100', '010001', '1', '110100', '10011', '0000010', '1001100']",1,7,22,16,5,38,11.454212454212454,74,58
"['010100', '1010111', '1011001']",1,3,9,11,2,20,2.098901098901099,9,6
"['01', '10101', '1001', '10110', '001110', '0111', '1100']",1,7,13,17,5,30,13.172655122655122,52,52
"['01', '11010', '1001', '10010', '0000011']",1,5,13,10,2,23,5.988311688311688,30,27
"['1111010', '0101', '1111110']",1,3,5,13,2,18,1.6233766233766234,10,10
"['111100', '0110', '1101011', '110100', '100111', '01001', '110']",1,7,15,22,3,37,13.234221334221335,61,65
"['01101', '0100010', '0011', '100', '0101']",1,5,13,10,2,23,6.487806637806638,27,27
"['101010', '0001001', '1', '1110']",1,4,9,9,0,18,2.3147352647352646,25,13
"['001', '101', '11000', '10110', '0011010', '01011']",1,6,14,14,5,28,9.166666666666666,41,37
"['0', '111110', '1011100', '11']",1,4,5,11,0,16,2.2493894993894994,24,12
"['0', '101', '11011', '0100']",1,4,6,7,0,13,2.999206349206349,16,8
"['1000101', '1', '1011110', '10001', '1000010', '001100']",1,6,18,15,3,33,7.4767732267732265,58,45
"['001001', '111', '011110']",1,3,6,9,2,15,1.6111111111111112,11,4
"['010', '0011000', '101101', '1011', '010011', '01000']",1,6,17,14,2,31,9.848157398157397,42,42
"['11011', '00101', '101', '0001', '000001']",1,5,13,10,2,23,5.936075036075036,25,35
"['101', '1011101', '111100', '00110']",1,4,8,13,0,21,3.525796425796426,19,15
"['0010', '00001', '11', '10101', '1100']",1,5,11,9,4,20,5.201587301587302,26,24
"['010', '100', '0111011']",1,3,6,7,2,13,1.6666666666666665,11,7
"['01', '111', '101010', '10001', '001100']",1,5,11,11,2,22,5.355266955266956,32,20
"['00111', '0101', '10']",1,3,5,6,0,11,1.619047619047619,8,6
"['01', '010000', '11', '101', '100', '000111']",1,6,12,10,6,22,7.816666666666666,44,37
"['11000', '1101', '01111', '100001']",1,4,9,11,2,20,3.4242424242424243,17,19
"['0', '1010110', '011000']",1,3,8,6,0,14,1.151098901098901,15,8
"['0', '001010', '01011']",1,3,7,5,0,12,1.3463203463203464,11,8
"['01', '1000101', '11010']",1,3,7,7,0,14,1.6825396825396823,11,7
"['1000101', '10', '011100', '111']",1,4,8,10,0,18,3.0726495726495724,22,11
"['1101', '00', '111', '11010']",1,4,5,9,0,14,3.4007936507936507,13,17
"['100101', '01011', '01110', '1110']",1,4,8,12,2,20,3.4242424242424243,16,15
"['1111', '010', '100', '1001']",1,4,6,8,4,14,3.1666666666666665,14,12
"['00111', '00', '010', '001']",1,4,8,5,2,13,4.088095238095238,12,20
"['0110101', '11001', '0100000', '001', '0010', '01010', '0011011', '01110']",1,8,24,19,6,43,17.88809523809524,80,86
"['10001', '10101', '0001', '1110101', '000001']",1,5,15,12,2,27,6.195571095571095,24,48
"['11000', '010', '1111000']",1,3,8,7,0,15,1.7333333333333334,10,11
"['0001100', '110', '10011']",1,3,8,7,0,15,1.7666666666666666,10,5
"['1000001', '1000100', '0010', '111', '011', '10', '01011']",1,7,17,14,4,31,11.097330447330448,68,54
"['0010101', '01110', '0100']",1,3,9,7,0,16,2.0606060606060606,8,10
"['0010', '000111', '01111', '1']",1,4,7,9,0,16,2.790764790764791,20,13
"['0', '0110111', '000011']",1,3,7,7,0,14,0.9972527472527473,14,7
"['01', '10', '0000011']",1,3,7,4,2,11,1.1666666666666665,13,6
"['0', '010', '0101000', '1011', '000111']",1,5,12,9,0,21,4.658580308580309,37,25
"['11000', '1010', '11100', '111001']",1,4,9,11,2,20,4.369696969696969,11,19
"['11', '101011', '0110', '100010', '1000', '011001', '1011000']",1,7,18,17,5,35,12.732323232323232,63,58
"['010100', '111000', '10', '000']",1,4,11,6,2,17,3.1777777777777776,19,21
"['01', '1010', '10010', '0101011']",1,4,9,9,0,18,3.7987012987012987,17,16
"['101100', '0010', '10001']",1,3,9,6,0,15,1.612121212121212,9,6
"['11001', '010', '1010', '1100111', '111000']",1,5,11,14,0,25,6.18969918969919,31,29
"['01', '0100010', '1111', '01010', '0001011']",1,5,13,12,2,25,5.179653679653679,36,26
"['001111', '1000', '000', '00010', '110']",1,5,13,8,2,21,5.5129148629148625,28,38
"['1101', '01101', '110', '1011111']",1,4,5,14,0,19,4.108152958152958,16,21
"['111110', '0000010', '000', '11111']",1,4,10,11,0,21,2.2056721056721056,26,23
"['0', '0100111', '100', '00110', '010110', '0100101']",1,6,16,13,2,29,8.469896769896769,49,48
"['10111', '0110', '11']",1,3,3,8,0,11,1.9047619047619047,7,6
"['0', '110110', '001001', '0110']",1,4,9,8,2,17,2.8714285714285714,22,17
"['11', '0011', '011', '00001']",1,4,7,7,0,14,3.776190476190476,13,19
"['110010', '11', '0000111', '00010', '110']",1,5,12,11,0,23,5.452303252303253,34,35
"['0', '11000', '100', '1101111']",1,4,7,9,0,16,2.7333333333333334,23,14
"['000101', '10', '11111']",1,3,5,8,0,13,1.1493506493506493,12,6
"['11001', '110111', '10011', '01110']",1,4,7,14,3,21,4.181818181818182,15,18
"['000110', '1000', '1110']",1,3,8,6,2,14,1.7,8,10
"['000010', '001101', '000']",1,3,11,4,2,15,2.0,9,15
"['10001', '10', '111', '000']",1,4,7,6,2,13,2.6214285714285714,15,11
"['01', '100', '111110']",1,3,4,7,0,11,1.0944444444444446,11,6
"['01011', '0010', '101110']",1,3,7,8,0,15,1.993939393939394,8,7
"['00111', '10', '010010', '000']",1,4,10,6,0,16,2.897835497835498,19,17
"['0', '01011', '101', '0010001']",1,4,9,7,0,16,3.1,21,11
"['00', '1000', '1100']",1,3,7,3,2,10,2.083333333333333,5,11
"['1010', '00', '1011011', '111']",1,4,6,10,0,16,3.00981240981241,19,14
"['110000', '01', '1']",1,3,5,4,0,9,1.2023809523809523,11,6
"['00111', '101011', '0001', '0101011', '001100', '01001']",1,6,17,16,4,33,9.951592851592851,37,46
"['11110', '011010', '0110']",1,3,6,9,0,15,2.012121212121212,6,15
"['001', '1110000', '11']",1,3,6,6,0,12,1.2444444444444445,12,9
"['0', '00101', '1100001', '1000110', '010101']",1,5,15,11,2,26,4.958041958041958,39,23
"['01', '11100', '1000011', '01001', '110']",1,5,11,11,2,22,5.118253968253968,34,25
"['000', '0000001', '01010']",1,3,12,3,0,15,1.6833333333333333,10,12
"['0101110', '11', '110100', '111011', '000001', '01110', '1011111']",1,7,15,24,5,39,10.817377067377068,77,58
"['0100010', '1011', '1101', '1011100']",1,4,10,12,4,22,3.5032467532467533,21,14
"['101000', '001001', '10']",1,3,9,5,2,14,1.6666666666666665,10,8
"['011011', '000101', '10000', '100011', '10', '0101', '1110']",1,7,17,16,5,33,12.211832611832612,63,58
"['1010111', '0010', '010']",1,3,7,7,0,14,2.0025974025974023,9,6
"['00001', '11', '1000010', '1100101', '0111', '0111100']",1,6,16,16,3,32,7.747474747474747,58,38
"['000110', '00', '0011']",1,3,8,4,0,12,1.9666666666666668,8,13
"['00110', '1', '0000000']",1,3,10,3,0,13,0.8333333333333333,15,6
"['1101001', '0001110', '11', '0100010', '1000', '10010', '1101', '110']",1,8,20,19,5,39,16.767243867243867,87,79
"['110011', '111100', '10', '0']",1,4,6,9,2,15,2.9047619047619047,23,12
"['01', '00', '10011']",1,3,5,4,2,9,1.6428571428571428,7,4
"['11000', '00100', '110001', '10', '0111', '0011100']",1,6,16,13,2,29,8.806726606726606,49,44
"['0010000', '1001', '1110', '11']",1,4,9,8,2,17,2.9646464646464645,22,12
"['0011', '1100', '010110']",1,3,7,7,2,14,1.9,9,8
"['0111', '101111', '01110']",1,3,4,11,0,15,2.416161616161616,5,9
"['01', '11010', '00', '1001100', '1011']",1,5,10,10,2,20,5.592352092352092,30,22
"['1111010', '00110', '100111', '11']",1,4,7,13,0,20,3.2046842046842046,22,17
"['0', '010', '1101010']",1,3,6,5,0,11,1.35,12,10
"['10010', '0000100', '1110']",1,3,10,6,0,16,1.4747474747474747,10,7
"['11110', '001', '100101', '1101110']",1,4,8,13,0,21,3.129020979020979,20,17
"['01', '001', '000', '110', '101110']",1,5,9,8,3,17,4.988888888888889,26,25
"['010011', '100011', '00001']",1,3,10,7,2,17,2.287878787878788,6,9
"['01', '0010', '11']",1,3,4,4,2,8,1.5,6,4
"['0010', '111111', '100111', '010110', '000111', '1110']",1,6,12,20,6,32,8.6,41,51
"['11001', '10100', '11011', '11100']",1,4,8,12,4,20,4.4,12,22
"['00', '010011', '11010']",1,3,7,6,0,13,1.6168831168831168,10,7
"['00', '10010', '1110000']",1,3,9,5,0,14,1.6825396825396823,11,8
"['00100', '10100', '10000']",1,3,11,4,3,15,2.0,4,14
"['01111', '110', '01100', '1111']",1,4,5,12,2,17,3.7547619047619047,13,21
"['01', '10000', '000111', '110', '01100']",1,5,12,9,2,21,5.142496392496392,33,26
"['1100', '100111', '10']",1,3,5,7,0,12,1.7666666666666666,10,8
"['1', '0001', '010010', '011001', '01011']",1,5,12,10,2,22,5.455266955266955,29,24
"['01001', '10110', '011', '100111']",1,4,8,11,2,19,4.221212121212121,15,15
"['1101', '001', '11']",1,3,3,6,0,9,1.638095238095238,6,11
"['11', '001000', '110100', '00', '100111', '011010', '001011']",1,7,18,16,7,34,11.083333333333334,71,62
"['0', '11000', '010110']",1,3,7,5,0,12,1.1645021645021645,12,8
"['010', '1', '0000011']",1,3,7,4,0,11,1.15,13,4
"['110', '011110', '00001']",1,3,7,7,0,14,1.2803030303030303,11,8
"['01101', '011', '100010', '11111', '110']",1,5,8,14,4,22,5.564646464646464,29,28
"['0', '110010', '01111', '10']",1,4,6,8,0,14,2.6168831168831166,22,14
"['110011', '0010101', '11']",1,3,6,9,0,15,1.5598290598290598,13,12
"['1000001', '010', '011', '10110', '00', '1100']",1,6,14,10,2,24,8.704184704184705,43,34
"['01', '11', '00011', '1011000', '01001', '01011']",1,6,13,13,5,26,9.05079365079365,45,43
"['0', '0011', '0001']",1,3,6,3,2,9,1.55,7,7
"['0001110', '101000', '0001100', '11100', '10100', '0101100', '110']",1,7,23,17,5,40,14.205533355533355,54,90
"['0', '0101', '0100110', '11']",1,4,7,7,0,14,2.4883838383838386,21,12
"['0100000', '00', '1']",1,3,8,2,0,10,0.6944444444444444,13,6
"['1011001', '111', '011100', '10101', '010101', '10011', '1011', '01000']",1,8,18,23,5,41,18.726051726051725,72,85
"['010', '11', '0101', '110', '0100']",1,5,8,8,4,16,6.473809523809524,16,27
"['11011', '0011', '100', '01111', '000101', '010110']",1,6,13,16,4,29,8.996176046176046,40,38
"['0110101', '10001', '0001', '0110010']",1,4,13,10,2,23,3.836940836940837,15,18
"['11000', '01', '0010010', '1110']",1,4,10,8,0,18,2.7604617604617605,21,15
"['1000', '0110', '1010110', '011100']",1,4,11,10,2,21,3.96993006993007,17,21
"['10111', '01001', '0101', '11']",1,4,6,10,2,16,3.9650793650793648,14,19
"['001', '100011', '01010']",1,3,8,6,0,14,1.712121212121212,8,4
"['011100', '1110011', '10000', '1101', '01001']",1,5,13,14,2,27,6.247008547008547,30,23
"['0', '1100', '10000', '0111011']",1,4,9,8,0,17,2.528787878787879,24,14
"['0010', '1001', '10110']",1,3,7,6,2,13,2.083333333333333,6,6
"['1111100', '01', '1110000', '101000', '1010000']",1,5,16,13,3,29,5.839438339438339,33,38
"['0001011', '00', '0110001']",1,3,10,6,2,16,1.4603174603174602,14,8
"['011', '100', '10', '0000111', '1100']",1,5,10,9,2,19,5.214430014430015,32,28
"['110010', '0110', '1111', '00', '10', '11100']",1,6,10,13,4,23,8.07012987012987,40,40
"['01001', '100', '001110']",1,3,8,6,0,14,1.7398989898989898,10,7
"['1', '101', '1111000', '1010', '0110011']",1,5,9,13,2,22,4.919480519480519,39,25
"['01', '1000110', '11111']",1,3,5,9,0,14,1.0634920634920635,13,6
"['0110101', '00000', '010101', '110', '1001011']",1,5,15,13,2,28,5.6464923964923965,33,24
"['01101', '00', '10', '1010000', '1110']",1,5,11,9,2,20,5.062049062049062,32,24
"['1', '010010', '1101', '0100011', '011000']",1,5,13,11,2,24,4.956859806859807,36,22
"['11011', '100', '0101011', '010010', '11101', '1001011']",1,6,14,19,4,33,9.804695304695304,42,50
"['11', '010001', '00011']",1,3,7,6,0,13,1.7987012987012987,9,8
"['1101001', '1', '0111011']",1,3,5,10,2,15,1.2142857142857144,15,9
"['0101111', '00110', '010']",1,3,7,8,0,15,2.0166666666666666,9,11
"['1000', '001', '1011100', '111111']",1,4,8,12,0,20,2.4006438006438007,23,16
"['11001', '101100', '001', '101', '1101100', '000', '01110']",1,7,16,16,5,32,12.266511266511266,58,59
"['010', '10011', '00011']",1,3,7,6,2,13,1.8,7,7
"['110000', '10101', '01']",1,3,7,6,0,13,1.3668831168831168,11,7
"['010011', '10', '1101']",1,3,5,7,0,12,1.5666666666666667,9,7
"['1101101', '11100', '11']",1,3,4,10,0,14,1.6825396825396823,11,13
"['1010000', '1110110', '111', '110101']",1,4,9,14,2,23,3.6227106227106227,21,21
"['0010001', '01', '011', '111']",1,4,7,8,2,15,3.311111111111111,18,16
"['1000000', '1101', '10110', '011']",1,4,10,9,0,19,3.0517316017316016,22,14
"['1000000', '11000', '10']",1,3,10,4,0,14,1.6825396825396823,11,9
"['01101', '100', '1', '0110100']",1,4,8,8,0,16,3.0166666666666666,21,16
"['11000', '001', '1', '0011010']",1,4,9,7,0,16,2.85,22,14
"['100', '1110', '11']",1,3,3,6,0,9,1.638095238095238,6,8
"['11001', '00', '10001']",1,3,7,5,2,12,1.9428571428571428,7,6
"['0111011', '00111', '1001101', '00', '010111']",1,5,11,16,2,27,6.468309468309468,31,26
"['1111', '100', '10110', '0000']",1,4,8,8,2,16,2.496031746031746,16,13
"['011010', '111', '011001']",1,3,6,9,2,15,2.1666666666666665,8,7
"['001', '101', '10010', '0000', '1011', '1111111', '011000']",1,7,15,17,4,32,10.456537906537907,69,52
"['1100', '110', '10']",1,3,4,5,0,9,2.3238095238095235,4,9
"['011', '100', '000010', '110', '1110']",1,5,10,9,3,19,5.3999999999999995,27,28
"['010100', '11010', '0011', '1001001', '101110']",1,5,14,14,2,28,6.362393162393162,28,22
"['011', '1000', '1101', '110', '01110']",1,5,8,11,4,19,6.063492063492063,22,26
"['0', '110000', '11001', '111010', '100100', '11111']",1,6,13,16,5,29,7.593506493506493,50,42
"['0011', '00100', '0100111', '10']",1,4,10,8,0,18,3.40981240981241,20,16
"['0010', '011', '110001', '10', '0101', '11100']",1,6,12,12,2,24,8.743939393939394,40,35
"['01', '001', '101101', '100', '11111']",1,5,7,12,2,19,4.808946608946609,29,27
"['0001', '011100', '111001']",1,3,8,8,2,16,1.8333333333333335,9,7
"['1', '1011101', '1000', '10011', '000001', '01000']",1,6,16,12,2,28,7.468659118659119,51,42
"['01', '00', '111']",1,3,3,4,2,7,0.9,6,4
"['010100', '000110', '0010111', '111', '00001', '111011', '000', '01001']",1,8,22,19,7,41,14.856254856254857,86,88
"['1101', '1101011', '011100', '0100']",1,4,9,12,2,21,3.7881118881118883,18,15
"['001111', '011', '0001', '1011100', '110']",1,5,10,13,2,23,5.413941613941613,33,26
"['10001', '10011', '1101010']",1,3,8,9,2,17,2.1333333333333333,7,11
"['0110010', '11000', '01', '0100']",1,4,11,7,0,18,3.624098124098124,18,18
"['101', '1010110', '00']",1,3,6,6,0,12,1.4444444444444444,11,6
"['01', '1101111', '111011']",1,3,3,12,0,15,1.7136752136752138,11,13
"['001', '1', '00101']",1,3,5,4,0,9,1.5833333333333333,8,9
"['11110', '1101', '1100', '0000']",1,4,8,9,3,17,3.0555555555555554,14,16
"['00010', '000100', '10']",1,3,10,3,0,13,1.9805194805194803,8,14
"['10111', '010', '100', '110']",1,4,6,8,3,14,3.5,13,13
"['010', '0101000', '001', '001111', '101', '100010', '1000000', '101110']",1,8,24,17,8,41,15.768864468864468,94,78
"['11010', '010000', '1001', '10', '111101']",1,5,11,12,2,23,5.710822510822511,30,22
"['0001011', '10001', '1001', '11100']",1,4,11,10,2,21,3.701010101010101,19,20
"['0001101', '00011', '11']",1,3,7,7,0,14,1.8492063492063493,10,12
"['1100010', '1101', '0011', '1']",1,4,7,9,2,16,2.8227272727272728,22,18
"['00111', '0110', '10000', '1111', '1011000', '110']",1,6,13,15,4,28,8.186147186147187,43,42
"['01', '011010', '0000']",1,3,8,4,0,12,1.4333333333333333,10,9
"['0011', '100100', '1']",1,3,6,5,0,11,1.2857142857142856,11,7
"['110', '10', '010110']",1,3,5,6,0,11,1.9666666666666668,8,10
"['1011', '0111111', '110111']",1,3,3,14,0,17,1.9608391608391609,8,14
"['0010', '1', '101', '1000', '0000', '110101']",1,6,13,9,3,22,7.530952380952381,41,36
"['001', '1', '1110000', '0001011', '110']",1,5,11,10,4,21,4.404761904761905,43,27
"['1001010', '110010', '1000', '000']",1,4,13,7,0,20,4.420313020313021,15,20
"['0010', '11010', '11', '000010', '01100']",1,5,13,9,2,22,5.346392496392497,28,32
"['0', '011101', '011000']",1,3,7,6,2,13,1.2380952380952381,12,10
"['0110101', '0011', '1100101', '10', '1100']",1,5,11,13,4,24,5.973304473304474,33,29
"['0010', '0101000', '0010011', '000', '0011011']",1,5,18,10,3,28,6.514285714285714,30,48
"['11001', '0', '00101', '1111', '100000']",1,5,11,10,2,21,3.9544011544011544,36,22
"['11001', '0', '001', '0011000', '0101101', '0011100']",1,6,17,13,3,30,8.219047619047618,55,46
"['1011101', '111111', '111001']",1,3,4,15,2,19,2.051282051282051,6,17
"['110000', '111', '0011', '0000', '0001010', '0101']",1,6,17,11,3,28,8.134504384504385,46,49
"['0001', '00', '1011', '1101', '01100']",1,5,10,9,3,19,5.432539682539682,25,23
"['00', '0111010', '111']",1,3,5,7,0,12,1.0444444444444443,12,4
"['0', '1101111', '01010', '0100']",1,4,8,9,0,17,2.735858585858586,23,14
"['0', '01', '111']",1,3,2,4,0,6,1.0666666666666667,6,4
"['0', '010', '0111', '1011', '0101001']",1,5,9,10,2,19,5.497402597402598,30,23
"['0', '1001', '010110', '0101001']",1,4,10,8,0,18,3.0322177822177823,22,16
"['1110101', '00011', '01010', '01110']",1,4,10,12,3,22,3.6666666666666665,16,13
"['0', '10001', '1110']",1,3,5,5,0,10,1.1777777777777778,10,4
"['1011', '0010', '000100', '000']",1,4,12,5,2,17,3.5095238095238095,15,22
"['1000101', '111100', '1101110', '10100', '100000', '10', '0101001']",1,7,21,19,5,40,11.93023643023643,70,57
"['1010111', '111000', '1']",1,3,5,9,0,14,0.9972527472527473,15,10
"['1000101', '111', '1001', '00', '10']",1,5,9,9,2,18,5.020923520923521,29,25
"['0', '011110', '101101']",1,3,5,8,2,13,1.2380952380952381,13,4
"['11010', '0011', '0110', '1111', '1010', '10010', '0000110', '01000']",1,8,20,18,7,38,16.881818181818183,69,83
"['1110111', '1000101', '101011', '0000', '110101']",1,5,13,17,4,30,6.190775890775891,30,33
"['11', '001111', '000', '101101']",1,4,7,10,2,17,2.5555555555555554,21,14
"['11001', '10', '11']",1,3,3,6,2,9,1.6428571428571428,7,10
"['110110', '11010', '1']",1,3,4,8,0,12,1.528138528138528,10,10
"['01', '0010', '110', '100011']",1,4,8,7,0,15,3.1825396825396823,17,12
"['0111000', '011', '0001', '0110', '111110', '01100']",1,6,14,15,2,29,9.123248973248973,43,56
"['11', '00', '010', '0100']",1,4,7,4,2,11,3.057142857142857,11,16
"['1110001', '0110111', '0010100', '1']",1,4,10,12,3,22,2.321428571428571,28,12
"['0010', '1011101', '1101', '011001', '0001010', '0110010', '101111', '0100']",1,8,22,23,8,45,18.324358974358976,84,77
"['111', '00100', '100', '1010', '0111', '010011']",1,6,12,13,4,25,8.554256854256854,37,40
"['110000', '000111', '000', '001000']",1,4,15,6,3,21,3.6666666666666665,21,37
"['0110101', '00', '100', '0100100']",1,4,12,7,2,19,3.4603174603174605,21,21
"['11', '1000110', '00', '010101', '0101100', '0110110']",1,6,16,15,5,31,7.9633699633699635,57,40
"['1001100', '1011', '000011', '1111']",1,4,9,12,2,21,3.2062937062937062,19,22
"['101011', '00', '1101', '11']",1,4,5,9,2,14,2.6,17,17
"['1000100', '11010', '10', '1011111']",1,4,9,12,2,21,3.0555555555555554,24,17
"['01', '1101101', '000', '001000']",1,4,11,7,0,18,2.8726495726495727,23,17
"['0', '1010', '0011110', '110']",1,4,7,8,0,15,2.685064935064935,20,18
"['0101111', '1100', '0111011']",1,3,6,12,2,18,1.6233766233766234,11,10
"['0010110', '0011', '1101']",1,3,7,8,2,15,1.7727272727272727,10,7
"['100', '0101', '10110']",1,3,6,6,0,12,1.9880952380952381,7,7
"['111100', '10000', '111111', '0000', '1100', '0100']",1,6,15,14,5,29,7.766161616161616,43,59
"['00', '100', '110', '0100']",1,4,8,4,2,12,3.961904761904762,9,20
"['1100001', '0110', '01000', '010111']",1,4,12,10,0,22,3.4857808857808856,20,15
"['001100', '001', '110111', '0111']",1,4,8,11,2,19,3.5825396825396822,18,17
"['0', '010001', '111', '00011', '110100', '0000010', '0101100']",1,7,21,14,4,35,9.750738150738151,79,57
"['110110', '0111010', '011']",1,3,6,10,0,16,2.0358974358974358,10,10
"['11010', '001', '1', '000001', '00010', '1011111']",1,6,14,13,2,27,6.850982350982351,56,37
"['101', '1000110', '10110', '0110000', '1010', '001100']",1,6,18,14,2,32,10.293223443223443,45,44
"['00011', '0000010', '0010011']",1,3,13,6,2,19,2.071428571428571,7,13
"['01101', '1101', '00', '010110']",1,4,8,9,0,17,3.6209235209235207,17,14
"['000110', '1011101', '001', '1100']",1,4,10,10,0,20,3.398934398934399,21,14
"['10110', '10011', '110100', '10']",1,4,8,10,2,18,3.7155844155844155,17,17
"['00111', '00', '0100101', '11']",1,4,8,8,2,16,2.698412698412698,21,14
"['0', '100111', '11']",1,3,3,6,0,9,0.7857142857142857,11,6
"['010', '11011', '0110110']",1,3,6,9,0,15,1.9333333333333333,9,6
"['010100', '1011', '00', '0011000']",1,4,12,7,0,19,3.1924630924630923,22,20
"['110011', '10011', '00011']",1,3,7,9,2,16,2.4363636363636365,4,20
"['001', '101', '0001111', '11101', '010111', '0001011', '1011011']",1,7,15,23,5,38,13.223781773781774,63,74
"['1101', '101001', '001000']",1,3,9,7,2,16,1.6666666666666665,8,5
"['011111', '00', '001000']",1,3,8,6,2,14,1.0833333333333333,13,12
"['00', '1', '001101', '111011']",1,4,6,9,2,15,1.9880952380952381,24,12
"['1101', '111000', '10110', '00001']",1,4,10,10,2,20,3.3838383838383836,20,16
"['111110', '010000', '0111100']",1,3,9,10,2,19,1.717948717948718,9,10
"['1001100', '0111111', '1', '010110']",1,4,8,13,2,21,2.4450549450549453,28,11
"['11110', '0101111', '0101110', '0011010', '1010111', '1110101', '01010', '011111']",1,8,18,33,7,51,18.46210456210456,71,99
"['101', '1110011', '101000']",1,3,7,9,0,16,1.882051282051282,10,10
"['1', '011010', '10011', '001001', '01000']",1,5,13,10,4,23,5.05021645021645,34,18
"['011010', '0010100', '111']",1,3,8,8,0,16,1.835897435897436,10,4
"['101', '10001', '111110', '100111', '011111', '0011011']",1,6,11,22,3,33,8.86010101010101,48,52
"['0101000', '00110', '000', '11111', '01000']",1,5,15,10,3,25,5.133333333333333,33,42
"['001011', '010111', '111', '000']",1,4,8,10,4,18,3.0555555555555554,18,19
"['0011011', '01', '01110']",1,3,6,8,0,14,1.6825396825396823,11,7
"['0101000', '0011101', '0101101', '1101101', '000101', '0000001', '1000000', '1000', '0000']",1,9,36,20,8,56,21.21893106893107,113,152
"['1000101', '1', '0110', '1001010']",1,4,10,9,2,19,2.848051948051948,24,13
"['110110', '00111', '00', '10', '0111']",1,5,8,11,2,19,5.058152958152958,29,28
"['110', '0001', '0010011', '10100', '100011', '100000', '1110100', '0011011', '111000', '0000110']",1,10,33,25,7,58,25.956410256410255,146,155
"['00', '001111', '111', '011001']",1,4,7,10,2,17,2.833333333333333,20,16
"['11010', '01111', '111110', '10', '0100101']",1,5,9,16,2,25,5.315340215340215,33,29
"['101000', '11000', '00', '01100']",1,4,12,6,2,18,4.079220779220779,15,25
"['0011', '0110', '000']",1,3,7,4,2,11,1.8928571428571428,6,10
"['00010', '1', '10', '00001']",1,4,9,4,2,13,2.9904761904761905,18,13
"['01', '11110', '1101111', '0110111', '10000', '100110', '1000011']",1,7,16,23,5,39,10.962604062604063,75,68
"['0', '001111', '1000', '11101', '1010001', '01001']",1,6,14,14,2,28,7.508363858363858,52,36
"['11000', '100001', '0000']",1,3,11,4,0,15,2.193939393939394,6,8
"['1000100', '111', '0111011', '00001', '0011', '100']",1,6,15,14,4,29,7.412337662337662,53,45
"['1110001', '1', '10']",1,3,4,6,0,10,1.3611111111111112,12,8
"['1010000', '111100', '10000', '000101']",1,4,15,9,2,24,3.5163170163170165,19,24
"['111111', '100000', '0111']",1,3,6,10,2,16,0.9666666666666667,13,10
"['0010', '111', '10101', '1101011', '000', '0111', '00010', '01100']",1,8,18,18,7,36,15.504401154401155,76,76
"['111', '0011110', '00', '00010', '1110']",1,5,10,11,0,21,4.894733044733044,32,34
"['1010111', '0001001', '000', '0111']",1,4,11,10,2,21,3.1298701298701297,23,17
"['101010', '0011', '1001000', '1101', '1001111']",1,5,13,15,4,28,6.01968031968032,31,31
"['111111', '1000', '1011100', '000000']",1,4,12,11,2,23,2.114685314685315,24,18
"['00', '100', '010001', '1100101']",1,4,11,7,0,18,3.6264957264957265,19,13
"['1010', '1101011', '10011', '1010011']",1,4,9,14,2,23,4.645021645021645,14,33
"['011111', '1011011', '1', '0100']",1,4,6,12,0,18,2.6503996003996004,24,12
"['0010001', '101', '01011', '0']",1,4,9,7,0,16,2.9,21,11
"['01', '000011', '11', '101010', '1000']",1,5,11,9,4,20,5.066666666666666,31,25
"['1010', '1', '10011']",1,3,4,6,0,10,1.4,9,9
"['101100', '10000', '100010']",1,3,11,6,2,17,1.9545454545454546,6,12
"['00', '10', '1011000']",1,3,7,4,2,11,1.3888888888888888,11,9
"['00111', '110', '0010111', '011001']",1,4,9,12,0,21,3.406993006993007,19,19
"['00', '110', '001111']",1,3,5,6,0,11,1.3444444444444446,10,9
"['1000100', '11', '100', '111011', '011101', '0101']",1,6,12,16,2,28,8.273293373293374,50,43
"['01101', '10', '1110']",1,3,4,7,0,11,1.9047619047619047,7,7
"['001', '011', '00011', '110111', '010011']",1,5,10,13,4,23,6.732323232323232,24,35
"['00001', '101', '0011110', '00', '1011', '101001']",1,6,14,13,0,27,8.151726051726051,48,41
"['110', '10', '000']",1,3,5,3,2,8,1.5333333333333334,5,7
"['0', '1100100', '0101010', '111111', '1011100', '1101']",1,6,13,19,3,32,6.80994005994006,60,34
"['11110', '01', '0000110']",1,3,7,7,0,14,1.2301587301587302,13,8
"['11', '00100', '10011', '1101', '110']",1,5,8,11,2,19,5.892063492063492,25,30
"['001', '00101', '1001', '10', '110']",1,5,9,8,2,17,6.116666666666666,21,28
"['0110', '0100', '1111']",1,3,5,7,3,12,1.5,6,5
"['001', '11111', '10', '0000', '0100']",1,5,10,8,2,18,3.8007936507936506,29,23
"['0011011', '00100', '10001', '11101']",1,4,11,11,3,22,3.433333333333333,18,15
"['1001100', '01', '001', '11101']",1,4,8,9,0,17,3.5825396825396822,19,16
"['01', '0011', '100', '1010', '00', '1011011']",1,6,11,11,4,22,9.056854256854256,38,39
"['01101', '100001', '00111', '11000', '0111']",1,5,12,13,3,25,6.058585858585858,28,29
"['001', '1100', '0000']",1,3,8,3,2,11,1.6428571428571428,7,11
"['0', '0110101', '11100', '10']",1,4,7,8,0,15,2.9325396825396823,22,12
"['01', '10001', '1']",1,3,4,4,0,8,1.5714285714285714,8,9
"['0', '101', '001', '011000']",1,4,8,5,2,13,2.841269841269841,18,12
"['0', '001', '1100010', '1011100', '01010', '01100']",1,6,16,12,4,28,7.704761904761905,54,44
"['1000', '0110', '10000', '11']",1,4,9,6,2,15,3.119047619047619,16,15
"['11110', '0010', '10']",1,3,5,6,0,11,1.6825396825396823,8,9
"['001101', '000011', '11', '110100', '110', '101110']",1,6,13,16,4,29,8.577777777777778,53,45
"['0010110', '000', '1100', '0110110', '1110']",1,5,13,12,4,25,6.20974025974026,28,40
"['1001010', '101', '100', '1111', '0001100', '00', '1010011', '111101']",1,8,18,21,5,39,14.286585636585636,99,82
"['1001100', '101', '111']",1,3,5,8,2,13,1.6666666666666665,9,9
"['101100', '001110', '000']",1,3,9,6,2,15,1.7777777777777777,8,13
"['00100', '00', '1001101', '011000']",1,4,13,7,0,20,3.5251970251970253,21,20
"['01', '001', '001111', '011', '11']",1,5,6,10,4,16,6.3,21,29
"['110110', '1000', '100', '0111101']",1,4,9,11,0,20,3.502830502830503,20,15
"['111100', '10110', '11']",1,3,4,9,0,13,1.7987012987012987,9,8
"['0', '011010', '0111']",1,3,5,6,0,11,1.4857142857142858,10,10
"['110000', '110110', '00100', '00', '010011', '0101']",1,6,17,12,3,29,8.856277056277056,45,46
"['1100010', '0001', '1']",1,3,7,5,0,12,1.3772727272727274,12,6
"['010', '10', '000', '1100', '01100']",1,5,11,6,2,17,6.386507936507936,18,35
"['100100', '10000', '11']",1,3,8,5,0,13,1.6948051948051948,9,9
"['1', '011', '0001011', '1100011', '0001000']",1,5,14,11,3,25,4.85,43,32
"['011100', '10', '000', '0010010', '001001']",1,5,16,8,2,24,5.760683760683761,32,40
"['00001', '011011', '1100101', '0000', '0010010']",1,5,18,11,2,29,6.024153624153624,29,29
"['1001110', '01', '111', '000011', '001000', '1001000', '1001101', '1010', '10010', '0100']",1,10,29,22,7,51,26.99023754023754,138,133
"['10001', '01010', '0100']",1,3,9,5,2,14,2.1555555555555554,7,6
"['1010', '1101000', '01000']",1,3,10,6,0,16,2.2272727272727275,7,10
"['01', '00', '11100']",1,3,5,4,2,9,1.3571428571428572,8,8
"['101100', '0001', '000', '11']",1,4,9,6,0,15,2.534920634920635,18,17
"['001101', '0011', '1111001', '10', '01001']",1,5,11,13,0,24,5.534987234987235,32,29
"['1111100', '001001', '111001']",1,3,8,11,2,19,1.8974358974358974,10,12
"['001', '1100', '011']",1,3,5,5,2,10,1.8095238095238093,7,8
"['100', '011010', '100111', '0010000']",1,4,13,9,2,22,3.6769230769230767,22,14
"['111', '00000', '100', '110', '0100']",1,5,11,7,3,18,4.575396825396825,24,26
"['0101110', '11', '11000', '0110', '1110100', '001011', '0100']",1,7,17,18,4,35,12.47009102009102,68,65
"['00', '11101', '1']",1,3,3,5,0,8,0.6190476190476191,10,4
"['01', '1011', '1010', '11010']",1,4,6,9,2,15,4.2103174603174605,11,18
"['01', '010001', '1000101', '110010', '11000', '0011110', '0011010', '110011', '100110']",1,9,27,25,7,52,22.837662337662337,114,99
"['1001', '1001000', '0100']",1,3,10,5,2,15,2.2045454545454546,8,8
"['0001011', '0', '11']",1,3,5,5,0,10,0.6944444444444444,13,6
"['1001110', '1101001', '0001']",1,3,9,9,2,18,1.844155844155844,11,8
"['11101', '01111', '01000', '11']",1,4,6,11,3,17,3.0285714285714285,18,17
"['110001', '100', '0000']",1,3,9,4,0,13,1.838095238095238,8,6
"['10', '111', '0000']",1,3,5,4,0,9,0.7333333333333334,9,4
"['111', '101101', '110111', '001100', '0101001']",1,5,11,17,3,28,6.223931623931624,30,27
"['0', '10101', '11']",1,3,3,5,0,8,0.9047619047619047,9,4
"['01101', '0011', '01111', '0011010', '0001101']",1,5,13,15,4,28,7.445021645021645,23,32
"['01', '11010', '000111', '100']",1,4,8,8,0,16,3.211327561327561,19,14
"['001100', '100110', '0100101', '000000']",1,4,17,8,3,25,3.8461538461538463,16,18
"['0', '1101', '110', '01']",1,4,4,6,0,10,3.4904761904761905,11,13
"['1000', '10', '000']",1,3,7,2,0,9,1.9238095238095236,5,11
"['0101', '1', '011110', '1010011']",1,4,7,11,0,18,2.7245254745254748,24,11
"['00', '0100111', '01000']",1,3,9,5,0,14,1.6825396825396823,11,13
"['11010', '1111000', '10', '10011', '1010000']",1,5,13,13,4,26,5.479365079365079,35,29
"['110', '0001', '111111', '110111', '000', '11100']",1,6,10,17,4,27,6.694877344877344,49,54
"['11100', '1', '011', '001010']",1,4,7,8,0,15,2.831168831168831,20,12
"['1010110', '01101', '0100', '1010111', '1010001', '1100', '101111', '0111100']",1,8,20,27,6,47,18.152564102564103,80,85
"['11110', '101', '00100', '00', '0101']",1,5,10,9,2,19,5.292063492063492,26,24
"['010', '110001', '1101011', '0000', '1100']",1,5,13,11,2,24,5.947441447441447,29,27
"['101100', '0011', '00', '101']",1,4,8,7,0,15,3.4047619047619047,16,17
"['0110101', '10111', '10101', '1000', '000']",1,5,12,12,2,24,6.163708513708514,27,30
"['110', '000101', '10']",1,3,6,5,0,11,1.7444444444444445,9,7
"['11', '11000', '1100', '1010000', '110']",1,5,11,10,0,21,6.939177489177489,24,37
"['011111', '0011', '0001', '100']",1,4,8,9,2,17,3.115079365079365,18,16
"['0', '001100', '11110', '100']",1,4,8,7,0,15,2.831168831168831,20,17
"['010', '101000', '100110', '10100', '0111111', '00', '0101100', '001001']",1,8,23,19,5,42,16.4497668997669,91,88
"['1111100', '101', '10001', '0110', '001001', '01000']",1,6,16,14,2,30,8.86074481074481,49,35
"['00100', '000110', '0101011', '110']",1,4,12,9,0,21,3.72983682983683,18,19
"['01010', '011110', '111001']",1,3,7,10,2,17,1.7575757575757576,9,6
"['10100', '1', '000']",1,3,6,3,0,9,0.8333333333333333,9,6
"['1010001', '10010', '01010', '1']",1,4,10,8,2,18,2.8499999999999996,22,13
"['01', '110010', '011', '10110', '1010001', '01110']",1,6,13,15,2,28,9.091885891885891,45,40
"['1011010', '100', '10']",1,3,6,6,0,12,1.8444444444444446,10,10
"['100', '10', '10000']",1,3,7,3,0,10,2.1214285714285714,6,11
"['101001', '100100', '1000', '1011', '01001', '0101', '01100']",1,7,19,15,7,34,14.514646464646464,46,62
"['0111000', '1010', '101111', '0']",1,4,8,10,0,18,2.6965534465534464,25,12
"['001', '1110000', '10001', '1000', '0001010', '0101', '111101', '111001']",1,8,22,20,6,42,16.74167499167499,86,90
"['0', '0010', '101', '11100', '001011']",1,5,10,9,0,19,4.865223665223665,31,24
"['1100011', '110', '10']",1,3,5,7,0,12,1.8444444444444446,10,10
"['0', '0011101', '00011', '1101', '110101']",1,5,10,13,0,23,5.068270618270618,35,31
"['01', '0101111', '10111', '11100', '1100']",1,5,8,15,2,23,5.265223665223665,33,33
"['1100011', '001', '1']",1,3,5,6,0,11,1.35,12,8
"['0', '1010111', '11']",1,3,3,7,0,10,0.6944444444444444,13,6
"['010', '101', '0111', '000000', '110', '111001']",1,6,13,12,5,25,7.514285714285714,47,33
"['0', '101', '10011', '111101']",1,4,5,10,0,15,3.081168831168831,19,16
"['10110', '00', '111111', '0111', '101110']",1,5,7,16,2,23,5.244155844155844,29,27
"['00111', '100', '1110000', '0100101']",1,4,12,10,2,22,3.438095238095238,25,17
"['1110111', '10001', '000101']",1,3,8,10,0,18,1.6888111888111887,10,9
"['101010', '00', '100', '01000']",1,4,11,5,0,16,4.0153679653679655,15,20
"['01000', '010', '1001', '1110']",1,4,9,7,2,16,3.503968253968254,15,13
"['0100010', '0011001', '100', '1001101', '010011', '1100']",1,6,19,15,3,34,10.181551781551782,46,39
"['101', '001100', '0100', '011000']",1,4,12,7,2,19,3.8936507936507936,16,19
"['0011', '0011110', '1100']",1,3,7,8,2,15,1.7727272727272727,11,12
"['0', '011', '0101011', '1000111', '1001101', '1010']",1,6,13,16,3,29,7.982467532467532,56,37
"['110000', '0001001', '010', '100010', '10', '0011100']",1,6,20,11,4,31,8.855311355311356,54,43
"['0101110', '1', '100', '000', '1101']",1,5,9,9,2,18,4.419264069264069,32,18
"['0001', '1100', '10']",1,3,6,4,2,10,1.5,8,7
"['010001', '11', '001000', '100', '1110101', '0101']",1,6,15,13,2,28,8.803402153402153,47,39
"['1000101', '101000', '0011', '10001', '1110100', '10', '0000', '101111']",1,8,22,19,6,41,14.938306138306139,91,86
"['0', '1101', '01', '11111']",1,4,3,9,0,12,2.6857142857142855,17,13
"['110010', '0111010', '001000', '0001', '100', '1010', '0000']",1,7,22,12,5,34,13.17097902097902,56,74
"['110000', '0001', '1', '11001']",1,4,9,7,0,16,3.012987012987013,19,21
"['0101111', '0010000', '0100010', '0011110', '100']",1,5,18,13,4,31,5.857142857142857,37,35
"['1', '01111', '00110', '10010', '01010']",1,5,10,11,4,21,5.133333333333333,30,23
"['11', '101000', '1101000', '011101', '10010']",1,5,13,13,2,26,5.993728493728494,34,28
"['0010', '110100', '1010', '010110', '011111', '1011']",1,6,13,17,6,30,9.1,37,39
"['1001110', '11', '0001110', '00011']",1,4,10,11,2,21,3.817460317460317,19,21
"['11001', '10111', '100100', '000000', '0101001', '1110']",1,6,18,15,4,33,7.804895104895105,47,38
"['0110101', '010100', '01101', '0011', '10', '0111', '0011011']",1,7,16,19,4,35,13.495510045510045,59,64
"['01101', '001', '100011', '011010']",1,4,10,10,2,20,3.5656565656565657,17,15
"['11001', '1011', '11']",1,3,3,8,0,11,1.6825396825396823,7,17
"['0010001', '100001', '10001', '0101', '111001']",1,5,16,12,2,28,6.761072261072261,23,49
"['101001', '1000', '111', '1111110']",1,4,7,13,0,20,2.8237096237096235,21,19
"['1000001', '0010', '00', '0011111', '110']",1,5,13,10,2,23,4.846464646464646,39,26
"['0', '1001001', '111011']",1,3,6,8,0,14,1.151098901098901,14,4
"['11000', '0011', '0010101', '11111', '1011']",1,5,10,15,4,25,5.382323232323232,30,36
"['0010000', '1010', '0111111', '00', '110']",1,5,12,11,2,23,4.299567099567099,40,28
"['00', '1110011', '10']",1,3,5,6,2,11,1.3888888888888888,11,4
"['0', '11010', '011110']",1,3,5,7,0,12,1.1645021645021645,11,9
"['11011', '0011', '1001', '110', '01000']",1,5,10,11,4,21,5.987301587301587,24,26
"['10100', '01001', '1111000']",1,3,9,8,2,17,1.9666666666666668,9,7
"['111010', '1111', '011101', '10011', '01010', '0000', '1011000', '1001011']",1,8,20,24,8,44,15.714785214785215,83,77
"['0', '011', '1000', '10010', '1001100']",1,5,12,8,0,20,5.3185425685425685,31,28
"['10101', '001101', '000']",1,3,8,6,0,14,1.712121212121212,8,8
"['1000001', '101', '01', '111']",1,4,7,8,2,15,3.311111111111111,18,22
"['11010', '1', '0000']",1,3,6,4,0,10,0.7777777777777777,11,4
"['0010', '101', '0001', '01010', '1011', '0100011', '01100']",1,7,18,14,5,32,13.066666666666666,51,52
"['100010', '0110110', '0000']",1,3,11,6,0,17,1.9608391608391609,9,9
"['1101101', '001101', '0000']",1,3,9,8,0,17,1.732867132867133,10,10
"['101', '0000100', '10000', '0100']",1,4,14,5,0,19,3.532034632034632,18,20
"['101011', '00', '00100', '11']",1,4,8,7,2,15,2.4025974025974026,20,14
"['11', '00000', '00001', '0001011', '0111100']",1,5,16,10,4,26,4.403174603174603,39,36
"['1', '001010', '001111', '101001']",1,4,9,10,3,19,2.6904761904761902,23,12
"['0001011', '101', '011101']",1,3,7,9,0,16,1.882051282051282,10,8
"['11010', '1', '001111', '0001', '0111', '001011']",1,6,11,15,4,26,7.84011544011544,45,41
"['0', '0011', '1111', '11001']",1,4,5,9,2,14,2.5666666666666664,18,15
"['001', '0110', '10011', '011000']",1,4,10,8,0,18,3.777994227994228,17,14
"['010100', '1001', '1101011', '011101', '101111']",1,5,11,18,3,29,6.373426573426573,28,25
"['1', '100001', '00110', '1011100', '0001000']",1,5,16,10,2,26,4.646187146187146,41,22
"['11110', '11010', '0110', '1100', '1111011']",1,5,8,17,4,25,6.82979797979798,23,35
"['0', '101011', '001']",1,3,5,5,0,10,1.2301587301587302,10,4
"['001', '11', '0000011', '1011', '01100']",1,5,11,10,0,21,5.466089466089466,32,27
"['1011', '1000', '100', '1']",1,4,6,6,2,12,3.2285714285714286,13,19
"['010', '110', '0111']",1,3,4,6,2,10,1.8095238095238093,5,9
"['10101', '010', '110', '0010100']",1,4,10,8,2,18,3.583333333333333,16,11
"['0011', '11101', '111011']",1,3,4,11,0,15,1.9535353535353535,7,17
"['0110101', '111100', '101', '1100000', '100010', '110']",1,6,16,16,6,32,8.775702075702075,52,39
"['11001', '01001', '010', '1100']",1,4,9,8,2,17,4.176984126984127,11,18
"['000000', '110', '1', '01010']",1,4,10,5,0,15,2.1010101010101008,22,11
"['01', '0000011', '1010011']",1,3,9,7,2,16,1.6031746031746033,12,9
"['110000', '111000', '0011101']",1,3,10,9,2,19,1.9102564102564104,10,11
"['00', '10', '011', '0110011']",1,4,7,7,2,14,2.7888888888888888,19,16
"['0100000', '01111', '111111', '10', '1000011', '0010010', '0100']",1,7,20,18,3,38,10.00999555999556,83,57
"['0', '11001', '011101', '011110', '0111']",1,5,8,14,2,22,5.677489177489178,32,29
"['00001', '0101101', '1000111', '001100', '0100']",1,5,17,12,2,29,6.161527361527361,30,27
"['0010', '011', '1111']",1,3,4,7,2,11,1.3928571428571428,7,6
"['0011', '000101', '10']",1,3,7,5,0,12,1.6333333333333333,9,7
"['0', '11110', '11010', '0010000', '101', '11101', '100111', '100101']",1,8,17,21,5,38,14.786230436230436,93,75
"['011', '10001', '011101', '1101', '0100011', '01011']",1,6,13,17,2,30,9.404179154179154,39,54
"['1010', '010000', '1', '01001']",1,4,10,6,0,16,3.012987012987013,20,13
"['101', '0101', '111', '0010101']",1,4,7,10,2,17,4.022510822510823,15,21
"['010100', '1001', '1']",1,3,6,5,0,11,1.2857142857142856,11,4
"['010100', '001', '010111', '1']",1,4,8,8,2,16,2.626984126984127,20,14
"['101010', '1', '0000111']",1,3,7,7,0,14,0.9972527472527473,15,6
"['0011', '1', '110100']",1,3,5,6,0,11,1.0857142857142859,12,8
"['1', '1101000', '10011', '0000', '01011']",1,5,12,10,2,22,4.151010101010101,37,26
"['00100', '11011', '10011']",1,3,7,8,3,15,1.8,8,7
"['01101', '01', '1001', '11']",1,4,5,8,2,13,3.4206349206349205,13,18
"['11011', '10', '111']",1,3,2,8,0,10,1.7214285714285715,7,12
"['110110', '01', '0011', '100', '0111']",1,5,8,11,2,19,5.707142857142857,26,25
"['0', '11101', '0100100', '0101', '1100', '0111110', '0100']",1,7,16,16,5,32,11.185569985569986,67,66
"['0', '0010', '0111', '0101', '0110001']",1,5,11,9,3,20,5.45,30,27
"['10111', '0010', '1']",1,3,4,6,0,10,1.1777777777777778,10,4
"['0001110', '00101', '1001001', '1100', '1110']",1,5,14,13,4,27,5.892135642135642,30,26
"['0001001', '1', '011']",1,3,6,5,0,11,1.35,12,6
"['0100101', '1', '110100']",1,3,7,7,0,14,1.151098901098901,14,6
"['11001', '1110011', '010111', '111101']",1,4,7,17,2,24,3.836829836829837,15,31
"['1010000', '1101', '1', '000000']",1,4,12,6,0,18,2.010839160839161,26,16
"['0100000', '1', '1100100']",1,3,10,5,2,15,1.0714285714285714,14,5
"['0', '110010', '1001010', '0001', '000101']",1,5,15,9,2,24,5.372011322011322,34,26
"['01', '1101', '001']",1,3,4,5,0,9,2.038095238095238,5,9
"['00001', '0101011', '1000', '00', '001011']",1,5,15,9,0,24,5.596525696525696,30,34
"['0001', '100', '100111', '00001']",1,4,11,7,0,18,3.772438672438672,15,21
"['100101', '000', '1']",1,3,6,4,0,10,0.9523809523809523,11,4
"['0', '111110', '0110', '1100101']",1,4,7,11,0,18,2.5427072927072927,24,13
"['10101', '0000010', '0010010', '001001', '0100']",1,5,20,9,2,29,6.743223443223443,24,34
"['0010001', '00101', '111', '00', '0100']",1,5,13,8,0,21,5.095526695526695,31,30
"['11110', '111100', '011', '111000', '01100']",1,5,10,15,4,25,6.663131313131313,23,38
"['001', '00001', '001000', '11000', '0101']",1,5,16,7,2,23,5.849711399711399,24,38
"['1000101', '11', '0010101', '011110', '11100', '0100']",1,6,15,16,2,31,8.031013431013431,52,36
"['1011110', '101011', '00101', '011110']",1,4,9,15,2,24,3.8111888111888113,15,17
"['000110', '0110', '1011', '011010', '1110', '0100']",1,6,14,14,6,28,9.416666666666666,34,51
"['101101', '1011110', '00011', '1001', '10', '111001']",1,6,12,18,2,30,9.017804417804419,48,51
"['101', '1001', '010111', '000']",1,4,8,8,2,16,3.4730158730158727,15,12
"['111', '11000', '101', '1110101', '0000', '1100']",1,6,12,14,4,26,8.108369408369407,42,52
"['0', '1010', '01001', '0010111']",1,4,9,8,0,17,2.862121212121212,23,12
"['0001', '0110', '1111', '0000101', '1011', '1110']",1,6,12,15,5,27,7.795454545454545,42,40
"['01001', '100', '10']",1,3,6,4,0,10,2.1214285714285714,6,7
"['11110', '10111', '10001', '0101010', '0100']",1,5,12,14,3,26,5.5494949494949495,29,22
"['11', '101', '10001', '111110', '0010010', '11100']",1,6,12,16,2,28,8.347014097014096,49,40
"['1', '1101111', '1001010', '011101', '1000', '10011', '01100']",1,7,15,20,4,35,10.851548451548451,76,54
"['00001', '100', '11']",1,3,6,4,0,10,1.1857142857142857,9,7
"['01', '1000110', '110']",1,3,6,6,0,12,1.4444444444444444,11,8
"['010', '0101111', '10000', '00', '001100']",1,5,14,9,0,23,5.576712176712177,34,36
"['11', '100', '1000111', '00', '100000', '1011100', '0101001']",1,7,19,15,5,34,10.621794871794872,79,62
"['100001', '0111111', '1011100', '1100110', '010110', '010011', '001001', '1111111']",1,8,21,31,8,52,15.74908424908425,93,82
"['011111', '0101010', '001111', '1']",1,4,7,13,2,20,2.8855311355311355,23,14
"['11000', '0011', '100', '1011', '0101']",1,5,10,10,3,20,6.0476190476190474,24,28
"['1100011', '1010', '01', '0001111']",1,4,9,11,2,20,3.178932178932179,25,14
"['000110', '011100', '10111', '0001', '000010']",1,5,16,11,3,27,6.080808080808081,29,31
"['010', '001', '0100110', '1111', '0101']",1,5,10,11,4,21,5.457575757575757,27,26
"['11', '100', '10110', '10', '011110', '000010']",1,6,12,12,4,24,7.822655122655123,45,39
"['0', '0100111', '1100', '001000']",1,4,11,7,0,18,2.6965534465534464,25,17
"['0', '101011', '101']",1,3,4,6,0,10,1.4523809523809523,10,6
"['0010001', '01', '1001000', '010100']",1,4,15,7,2,22,3.7844932844932844,22,17
"['01', '00101', '0001111', '0111', '0000', '01100']",1,6,15,12,4,27,8.121139971139971,43,50
"['110000', '1101110', '10', '0101', '101001']",1,5,12,13,2,25,5.754001554001554,35,25
"['010', '00001', '000100', '01100', '1011111']",1,5,15,11,2,26,5.312237762237762,34,28
"['0101000', '0101110', '101110', '000']",1,4,13,10,2,23,3.897191697191697,18,30
"['001', '1', '10111', '000010', '01100']",1,5,11,9,2,20,4.446320346320347,34,19
"['1101001', '111', '001000', '000', '1001011']",1,5,14,12,4,26,4.691086691086691,35,27
"['000110', '1011010', '001', '111', '10001', '100110', '10010', '0000', '110', '01110']",1,10,25,22,8,47,27.266000666000664,118,131
"['0000', '10', '10011', '11111']",1,4,7,9,2,16,2.034920634920635,20,13
"['0100111', '100001', '01101', '001000', '110001', '10000', '00110', '000000', '11111']",1,9,30,21,8,51,19.84778554778555,109,104
"['1111101', '111', '00101', '0000001', '0011100', '011000']",1,6,18,17,3,35,7.534587634587634,55,45
"['1110010', '1', '100100', '1101011', '000', '1010000']",1,6,17,14,3,31,7.456227106227106,59,38
"['0', '0110', '10110', '1111', '011101', '1000000', '010011', '1001011']",1,8,19,21,6,40,13.203463203463203,101,69
"['0101', '1001', '11']",1,3,4,6,2,10,1.8333333333333333,6,9
"['010011', '1', '10000']",1,3,7,5,0,12,1.1645021645021645,12,6
"['0000101', '101000', '100', '00000']",1,4,16,5,0,21,3.406993006993007,19,29
"['100110', '0100000', '010']",1,3,11,5,0,16,1.6598290598290597,10,11
"['1100011', '011100', '001010', '000']",1,4,13,9,2,22,3.6085470085470086,21,17
"['10111', '0011', '10', '0000001']",1,4,10,8,0,18,2.6724386724386724,23,15
"['00', '110', '011', '10011']",1,4,6,7,2,13,3.288095238095238,14,14
"['010001', '1011110', '100011', '1100101', '0000', '0100001']",1,6,21,16,5,37,9.394971694971694,45,39
"['00110', '000010', '11']",1,3,8,5,0,13,1.5487012987012987,10,6
"['0', '101', '10011']",1,3,4,5,0,9,1.5833333333333333,8,5
"['0', '111', '11001']",1,3,3,6,0,9,1.0833333333333333,9,6
"['00010', '010', '1', '01110']",1,4,8,6,2,14,3.2666666666666666,16,17
"['0000', '111', '111001']",1,3,6,7,0,13,1.0666666666666667,11,8
"['010', '011100', '11', '10001', '001100']",1,5,12,10,2,22,5.729004329004329,31,21
"['110000', '0011', '01']",1,3,7,5,0,12,1.3166666666666667,11,8
"['0110100', '00101', '111010', '000101', '01111', '1111', '0101100', '0101', '110']",1,9,21,26,8,47,22.617282717282716,100,113
"['00', '00010', '1101']",1,3,7,4,0,11,1.349206349206349,9,6
"['01', '001110', '000000', '1101']",1,4,11,7,2,18,2.716666666666667,23,13
"['100100', '100101', '10000']",1,3,11,6,2,17,2.4696969696969697,4,15
"['011', '101101', '11', '0010100', '1001101', '100011', '010111']",1,7,16,21,5,37,13.577533577533577,67,65
"['0010', '100', '0010011', '011110', '01010', '01000']",1,6,18,12,2,30,9.644078144078144,39,58
"['1010111', '01', '1101']",1,3,4,9,0,13,1.6565656565656566,10,10
"['0010', '11011', '0101110', '1']",1,4,7,10,0,17,2.63989898989899,22,9
"['1', '0110', '111011', '00', '00010']",1,5,9,9,0,18,4.137445887445887,33,19
"['01', '10010', '11111']",1,3,4,8,2,12,1.2571428571428571,10,6
"['101', '0010', '0011', '1']",1,4,6,6,2,12,3.192857142857143,13,12
"['10010', '110', '111']",1,3,4,7,2,11,1.6666666666666665,6,9
"['01', '101', '110010', '000011']",1,4,9,8,2,17,3.411111111111111,19,14
"['0010', '010000', '1110', '0100']",1,4,12,6,3,18,3.55,15,25
"['1001', '111110', '10', '0111', '0100001', '001001', '01110']",1,7,16,18,4,34,11.704917304917306,69,60
"['1100', '01111', '10']",1,3,4,7,0,11,1.3968253968253967,9,7
"['1001', '110', '10011', '00001']",1,4,9,8,2,17,3.476984126984127,14,20
"['01', '010000', '1111101', '0001', '100', '100110', '0011011', '1110']",1,8,19,20,6,39,14.78883893883894,98,73
"['0', '11010', '011011']",1,3,5,7,0,12,1.3463203463203464,11,7
"['11000', '0101', '10']",1,3,6,5,0,11,1.6825396825396823,8,6
"['11101', '10', '000010']",1,3,7,6,0,13,1.435064935064935,11,5
"['11', '10011', '1011', '01001', '001011']",1,5,9,13,2,22,6.919624819624819,23,40
"['010', '110', '0010000']",1,3,9,4,2,13,1.6666666666666665,10,9
"['0011', '01', '00']",1,3,5,3,2,8,1.8333333333333333,5,8
"['0', '0010111', '0001111']",1,3,7,8,2,15,1.3571428571428572,14,9
"['1011', '100000', '000', '0111']",1,4,10,7,2,17,2.5880952380952382,20,16
"['0101010', '0010101', '1101110']",1,3,10,11,3,21,2.142857142857143,8,7
"['01101', '110', '10', '000']",1,4,7,6,2,13,3.354761904761905,13,13
"['00011', '101', '0101011', '0110', '000', '1010010', '1111011']",1,7,17,19,5,36,12.41103896103896,68,55
"['1010', '0101000', '1101']",1,3,8,7,2,15,2.0227272727272725,9,4
"['01', '10101', '100', '01111', '00110', '001110', '0110110']",1,7,15,18,3,33,12.139072039072039,61,60
"['110000', '101', '0001000']",1,3,11,5,0,16,1.45982905982906,12,8
"['1000011', '01', '00111', '11']",1,4,7,9,2,16,3.198412698412698,20,19
"['11010', '10', '0000']",1,3,7,4,0,11,1.349206349206349,9,7
"['00', '110', '0000011', '101001']",1,4,11,7,0,18,2.804273504273504,23,13
"['110110', '11101', '100010']",1,3,7,10,2,17,1.9393939393939394,8,8
"['010', '001', '001110', '00000']",1,4,12,5,2,17,3.5454545454545454,17,25
"['0001101', '0100000', '1', '111101']",1,4,11,10,2,21,2.28021978021978,29,15
"['0100110', '100001', '1101000', '100', '010010', '0000101', '1000011']",1,7,27,16,6,43,14.057142857142857,66,58
"['1011110', '100100', '1001010', '011000']",1,4,14,12,4,26,4.007326007326007,15,20
"['010', '1001', '010111', '001110', '1101', '01110']",1,6,12,16,4,28,9.956998556998556,40,38
"['011111', '10001', '1']",1,3,4,8,0,12,0.9826839826839826,13,8
"['1', '1011110', '0000', '001100', '001011', '0100']",1,6,16,12,4,28,7.327955377955378,52,45
"['01101', '111', '100010']",1,3,6,8,0,14,1.7398989898989898,10,6
"['0', '010', '11011', '101011', '100101']",1,5,9,12,2,21,5.707792207792208,30,21
"['111', '1001', '1010101', '10', '001011']",1,5,9,13,0,22,5.723487623487624,30,32
"['101100', '0001110', '1', '001010', '1110100']",1,5,14,13,4,27,5.0787545787545785,40,26
"['1000', '0101', '1']",1,3,5,4,2,9,1.3,9,6
"['0111001', '0100010', '0011110', '0110', '00110', '11101', '000', '0011011', '0101', '001011']",1,10,28,27,8,55,29.969591519591518,127,151
"['00100', '100', '0011100']",1,3,10,5,0,15,2.1833333333333336,8,20
"['0010', '110011', '110111', '000', '111001']",1,5,11,14,3,25,5.901587301587302,31,28
"['01100', '00010', '100', '000']",1,4,12,4,4,16,3.7666666666666666,13,30
"['00001', '1111', '0001100', '10', '0000010', '0111', '0011011']",1,7,20,16,5,36,10.61147186147186,76,61
"['001', '1001', '10100', '000', '1011', '0101']",1,6,13,10,5,23,9.345238095238095,28,41
"['0011001', '1000100', '00', '111']",1,4,11,8,2,19,2.6031746031746033,25,15
"['1101', '0101', '010001', '1110']",1,4,8,10,3,18,3.8,15,19
"['101', '11000', '0001', '0101011', '00']",1,5,12,9,0,21,5.117604617604617,31,26
"['10111', '10010', '110', '100111']",1,4,7,12,2,19,3.680808080808081,14,25
"['1100001', '0001', '011']",1,3,8,6,0,14,1.6987012987012986,10,10
"['0011', '10111', '100']",1,3,5,7,0,12,1.7380952380952381,8,9
"['0100010', '00', '0101', '0110010']",1,4,13,7,2,20,3.6854256854256855,19,25
"['0010110', '010', '10', '0011111', '110']",1,5,10,12,4,22,5.647619047619048,34,32
"['1011', '0001110', '1']",1,3,5,7,0,12,1.1954545454545453,13,4
"['101010', '0011', '0001', '0110010', '1101010']",1,5,15,13,4,28,6.327422577422578,28,31
"['101', '10010', '0000000', '001000']",1,4,16,5,0,21,3.083255633255633,21,17
"['1000', '01111', '0111']",1,3,5,8,2,13,1.3611111111111112,9,11
"['0010', '1111101', '1', '10100', '1010']",1,5,9,12,2,21,5.097979797979798,33,24
"['1000011', '0110000', '01010']",1,3,12,7,2,19,1.880952380952381,11,5
"['1', '010111', '101101']",1,3,4,9,2,13,1.4047619047619047,12,8
"['101000', '101', '1010', '01011', '101001']",1,5,12,12,2,24,7.313203463203463,21,39
"['0101', '010000', '110']",1,3,8,5,0,13,1.615873015873016,9,8
"['0', '10101', '1111000']",1,3,6,7,0,13,1.0833333333333333,14,4
"['0', '101', '00110']",1,3,5,4,0,9,1.3333333333333333,9,4
"['011011', '11', '0010110', '0000']",1,4,10,9,0,19,2.687101787101787,22,14
"['0101011', '1111', '0110000', '00', '001110']",1,5,13,13,2,26,4.375502275502275,40,28
"['01', '0100111', '010', '01111', '10011', '0110010', '1100']",1,7,15,18,4,33,12.467965367965368,65,61
"['101', '1111110', '1111']",1,3,2,12,0,14,1.6987012987012986,10,14
"['101', '0110111', '0000']",1,3,7,7,0,14,1.2493506493506494,12,4
"['0111000', '100001', '0011001', '111011', '1000', '100011', '1001001', '0101']",1,8,25,22,8,47,18.003296703296705,82,94
"['101000', '0001010', '001001', '000111']",1,4,16,9,3,25,3.9871794871794872,18,22
"['101', '111', '01110']",1,3,3,8,2,11,1.9166666666666665,6,4
"['101010', '100', '1', '0100']",1,4,8,6,0,14,3.5095238095238095,16,13
"['101011', '1100', '1']",1,3,4,7,0,11,1.2857142857142856,11,9
"['01', '100', '110']",1,3,4,4,2,8,1.4666666666666668,5,6
"['0100000', '001', '0111010', '100001', '010000', '1000', '010101', '01110', '1111111', '111001']",1,10,30,27,7,57,24.614518814518814,150,130
"['011101', '01', '0101000', '1011001']",1,4,11,11,2,22,3.487789987789988,22,16
"['1001000', '111010', '11']",1,3,7,8,0,15,1.5598290598290598,12,8
"['1', '10', '0000']",1,3,5,2,0,7,1.0,8,4
"['010000', '1100', '000']",1,3,10,3,0,13,1.838095238095238,8,15
"['010100', '11', '1010010', '11100', '01011']",1,5,12,13,2,25,6.044411144411145,32,28
"['00100', '10001', '0001010', '110']",1,4,13,7,2,20,3.5,18,13
"['0', '01100', '0001000']",1,3,10,3,0,13,1.25,13,14
"['101', '011110', '0000']",1,3,7,6,0,13,1.1301587301587301,11,4
"['01', '101101', '00111', '10110', '000']",1,5,10,11,2,21,5.723665223665224,27,25
"['100101', '1', '011']",1,3,4,6,0,10,1.4523809523809523,10,8
"['0011010', '1011', '10', '11111']",1,4,6,12,0,18,2.886724386724387,21,14
"['010001', '0011101', '00100', '1001', '11111', '110', '011000']",1,7,18,18,4,36,11.964513264513265,65,51
"['10100', '00101', '10011']",1,3,8,7,3,15,2.0,7,8
"['0000111', '11110', '110111']",1,3,6,12,0,18,1.6608391608391608,10,15
"['1111101', '0110100', '10110', '000', '1011']",1,5,11,15,2,26,5.2702741702741704,34,22
"['00', '010', '0000110', '1110000']",1,4,13,6,2,19,3.2603174603174603,25,26
"['11001', '1011001', '111', '1000000', '000']",1,5,14,11,4,25,4.811904761904762,35,31
"['101010', '011100', '001', '000']",1,4,11,7,4,18,3.1666666666666665,17,19
"['0010', '100', '1000000', '000', '1110']",1,5,15,6,4,21,5.561471861471861,28,36
"['11', '00000', '10000', '0010011', '11101', '10011', '001100', '01110']",1,8,22,18,5,40,14.665889665889665,88,82
"['1000000', '0001', '100', '11000']",1,4,14,5,0,19,3.80021645021645,18,23
"['00110', '001', '0000010', '00001']",1,4,15,5,2,20,4.2,16,26
"['0100010', '00', '1011110', '111']",1,4,9,10,2,19,2.4603174603174605,26,11
"['0110000', '1011101', '000']",1,3,10,7,2,17,1.5714285714285714,13,8
"['0', '10110', '0111', '00001']",1,4,8,7,2,15,2.5777777777777775,20,12
"['01', '00', '001', '011']",1,4,6,4,4,10,3.966666666666667,7,16
"['0', '010', '00101', '011011', '010110', '1110']",1,6,12,13,2,25,8.425180375180375,44,45
"['01', '11010', '1111', '10', '0010010']",1,5,9,11,2,20,4.728715728715729,34,24
"['00111', '10', '111', '1110']",1,4,4,10,0,14,3.626190476190476,14,23
"['101100', '0011', '001']",1,3,7,6,0,13,1.9015873015873015,8,10
"['101', '01', '0100']",1,3,5,4,0,9,2.038095238095238,5,6
"['001', '1111', '1111010', '10', '0111', '0001000']",1,6,12,15,4,27,6.80945165945166,55,43
"['101011', '1000', '110', '10010']",1,4,9,9,0,18,3.732034632034632,13,18
"['0', '011', '0111']",1,3,3,5,0,8,1.7571428571428571,6,9
"['01', '000000', '111011']",1,3,8,6,2,14,0.9166666666666666,14,4
"['110001', '110', '000']",1,3,7,5,2,12,1.6666666666666665,8,6
"['00', '010', '001110']",1,3,7,4,0,11,1.9666666666666668,8,15
"['1000010', '01111', '00', '0010111']",1,4,11,10,2,21,2.746031746031746,25,16
"['01', '1010', '00', '111111', '0111110']",1,5,7,14,2,21,4.505089355089355,36,20
"['111100', '00001', '11', '10111', '0001', '10110', '0100100', '1000011', '0101', '0100']",1,10,26,23,8,49,25.285631035631035,138,128
"['0000100', '001000', '1001', '0110', '100111', '1110100']",1,6,20,14,6,34,8.66093906093906,50,42
"['1011', '0100110', '1111']",1,3,5,10,2,15,1.5909090909090908,8,6
"['1001110', '11110', '011', '0000000', '0110010', '0101', '01000']",1,7,22,16,5,38,11.294227994227994,72,66
"['1', '101110', '01000', '0111100']",1,4,9,10,0,19,2.8503996003996,24,12
"['00011', '1001', '0010100', '11']",1,4,10,8,0,18,3.5613275613275612,19,14
"['001', '10', '1110']",1,3,4,5,0,9,1.3523809523809525,7,7
"['1000', '00', '110010']",1,3,8,4,0,12,1.9666666666666668,8,8
"['11', '10000', '0110011']",1,3,7,7,0,14,1.2301587301587302,13,8
"['00100', '1001', '1111', '0000101', '000100', '101111', '0100']",1,7,20,16,5,36,11.635819735819735,65,65
"['00010', '10000', '0111']",1,3,9,5,2,14,1.4666666666666668,9,8
"['1000000', '001', '10']",1,3,9,3,0,12,1.2444444444444445,12,8
"['1101', '10000', '000011']",1,3,9,6,0,15,1.5717171717171716,10,10
"['01', '100011', '000101', '1']",1,4,8,7,2,15,3.071428571428571,21,15
"['11', '101', '1001000', '0110', '1010', '1000', '01100']",1,7,16,13,3,29,13.122943722943722,54,55
"['010011', '1100', '000']",1,3,8,5,0,13,1.615873015873016,8,9
"['0110101', '00111', '10001', '0010011', '0110011']",1,5,15,16,5,31,6.409523809523809,26,32
"['000011', '0011', '1001', '1111', '101110']",1,5,10,14,5,24,5.85,27,31
"['001', '100111', '10', '01010']",1,4,8,8,0,16,3.1835497835497835,18,12
"['110110', '11', '10010', '1101110']",1,4,7,13,0,20,3.8328893328893328,18,24
"['10111', '01', '0011', '000111']",1,4,7,10,0,17,3.932034632034632,15,18
"['01', '011011', '0011', '001110', '01011']",1,5,10,13,2,23,6.83001443001443,25,33
"['0011101', '11011', '001101', '010', '101000', '10001', '10111', '0010010']",1,8,22,22,7,44,17.48887778887779,82,75
"['1110111', '01111', '1111', '10', '01110']",1,5,5,18,2,23,6.051082251082251,29,40
"['0', '1001', '0111', '101111']",1,4,5,10,2,15,2.9857142857142858,19,13
"['010', '1110000', '101', '110001', '110']",1,5,11,11,3,22,5.947008547008547,31,24
"['0100000', '0001110', '001101', '0010011', '1011']",1,5,18,13,3,31,5.93966033966034,35,28
"['001', '011', '0111', '00001']",1,4,8,7,2,15,3.7896825396825395,12,18
"['101', '1101', '00001']",1,3,6,6,0,12,1.8015873015873014,7,12
"['0', '01111', '1001011']",1,3,5,8,0,13,1.0833333333333333,13,5
"['0', '11110', '011']",1,3,3,6,0,9,1.3333333333333333,9,7
"['0', '0011101', '001000']",1,3,9,5,0,14,1.151098901098901,14,11
"['01', '001', '11010', '011000']",1,4,9,7,0,16,3.543145743145743,17,15
"['0', '1100', '111']",1,3,3,5,0,8,0.9714285714285714,8,6
"['111', '0101010', '00', '1000', '00010', '0100101']",1,6,17,11,2,28,7.8886724386724385,47,40
"['0', '11001', '101', '10001', '110100']",1,5,10,10,2,20,5.691774891774892,28,27
"['011', '001011', '000']",1,3,7,5,2,12,1.6666666666666665,8,10
"['11001', '1011', '111111', '001']",1,4,5,13,0,18,2.9335497835497835,17,25
"['10101', '0101111', '10011']",1,3,6,11,2,17,2.1333333333333333,8,10
"['01', '010001', '01100', '0000']",1,4,12,5,0,17,3.1764790764790765,16,20
"['0000101', '00111', '011', '11']",1,4,8,9,0,17,3.8325396825396822,18,18
"['011011', '01', '111', '101001']",1,4,6,11,2,17,3.4,19,18
"['011', '00111', '0001', '100', '0100']",1,5,11,8,4,19,5.765873015873016,23,29
"['01', '111100', '111', '000', '1110']",1,5,7,11,2,18,4.4373015873015875,28,30
"['111100', '11', '00111', '100101', '011111', '0101']",1,6,10,19,3,29,8.871428571428572,46,50
"['111110', '010', '0100']",1,3,6,7,0,13,1.7015873015873015,9,11
"['0000101', '00', '00110', '001110', '0101', '01011']",1,6,17,12,2,29,10.021878121878121,42,55
"['0111000', '100', '1']",1,3,6,5,0,11,1.35,12,5
"['001000', '1001', '1111', '00110', '011110', '1011']",1,6,13,16,5,29,8.482323232323232,40,32
"['01', '0010', '11', '0100010', '10000']",1,5,13,7,2,20,5.187590187590187,31,23
"['011011', '111', '1001010']",1,3,6,10,0,16,1.882051282051282,10,8
"['0', '101', '01101', '0001111']",1,4,7,9,0,16,2.9,22,12
"['10100', '1101000', '01111']",1,3,8,9,2,17,1.7333333333333334,11,8
"['01', '1', '0100']",1,3,4,3,0,7,1.7333333333333334,6,5
"['101100', '01001', '000', '11']",1,4,9,7,0,16,2.7431457431457433,18,12
"['1101', '1100', '011']",1,3,4,7,2,11,1.8928571428571428,6,10
"['01', '010', '0101110', '11', '1110001']",1,5,9,12,4,21,5.049206349206349,38,24
"['0010', '1', '0000000']",1,3,10,2,0,12,0.9454545454545454,14,6
"['0100111', '011', '000', '0100']",1,4,10,7,2,17,3.2034632034632033,16,22
"['110000', '110', '101', '100010', '1100', '01110']",1,6,14,13,4,27,9.376551226551227,39,41
"['1011', '011010', '110', '1110']",1,4,6,11,2,17,3.795238095238095,13,17
"['110000', '000101', '1100100', '1000', '000001', '11100']",1,6,22,12,3,34,9.515151515151516,41,59
"['010', '1001', '1000111', '0011011', '110']",1,5,11,13,4,24,5.796536796536796,34,24
"['0011', '100', '000001', '01110', '0110011']",1,5,14,11,0,25,5.755500055500056,32,28
"['10111', '100', '000101', '10110', '010101', '0000010', '1001001']",1,7,22,17,6,39,12.713891663891664,62,59
"['000110', '1011001', '10111', '0001', '00100', '100101', '001100', '1101']",1,8,23,20,7,43,17.894949494949493,71,81
"['1100011', '101', '11111', '0']",1,4,5,11,0,16,2.5166666666666666,23,16
"['100', '1110101', '10', '01011', '111001']",1,5,9,14,0,23,6.035919635919636,30,29
"['110001', '100', '1010101', '1010', '110', '01000']",1,6,15,13,2,28,9.681834831834832,37,38
"['01', '01111', '1101']",1,3,3,8,0,11,1.6825396825396823,7,9
"['0', '0101', '00001', '1111']",1,4,7,7,2,14,1.9,19,11
"['010', '011110', '0100']",1,3,7,6,0,13,2.123809523809524,7,17
"['11001', '010', '111', '1001010', '1101000', '10001', '1001111']",1,7,17,20,7,37,12.807142857142857,65,69
"['0', '1111', '001110', '10', '1100']",1,5,7,10,2,17,4.552380952380952,30,22
"['111000', '100', '10100', '001010', '0101']",1,5,14,10,2,24,6.4759740259740255,25,28
"['001000', '1011110', '000101', '10', '01010', '0000']",1,6,19,11,2,30,8.49046509046509,48,53
"['0', '10101', '001', '100011']",1,4,8,7,0,15,3.012987012987013,18,12
"['01', '0001', '101110']",1,3,6,6,0,12,1.5666666666666667,10,7
"['101', '1100', '00000']",1,3,8,4,0,12,1.2658730158730158,9,6
"['0011', '01', '011', '11']",1,4,4,7,2,11,4.29047619047619,8,19
"['0010110', '1110101', '1']",1,3,6,9,2,15,1.0714285714285714,16,4
"['11011', '001', '10110', '00010', '01110']",1,5,11,12,4,23,5.85,25,23
"['010', '1000110', '10001', '110', '01110', '1111011']",1,6,13,17,6,30,9.004761904761905,48,42
"['101011', '010', '000', '1111']",1,4,7,9,2,16,2.4634920634920636,17,10
"['100110', '0011', '0000100', '1110']",1,4,12,9,2,21,3.4706293706293705,19,17
"['01', '0000100', '00110', '0111111', '0111', '110', '101111']",1,7,14,20,2,34,11.225191475191474,73,59
"['01', '0111111', '100010', '11']",1,4,6,11,2,17,2.6965811965811968,24,15
"['10111', '10100', '000']",1,3,7,6,2,13,1.35,8,8
"['1110111', '00', '101110']",1,3,5,10,0,15,1.4914529914529915,13,4
"['0', '0011', '001', '1110']",1,4,6,6,2,12,2.942857142857143,15,15
"['01', '1010100', '0110', '110']",1,4,8,8,0,16,3.131890331890332,17,15
"['0', '110010', '0110111', '0111011', '10']",1,5,9,14,2,23,4.929181929181929,40,26
"['01', '00110', '010110', '000000']",1,4,13,6,2,19,3.2759740259740258,19,24
"['011011', '01111', '10', '0100101', '1001011']",1,5,11,16,2,27,6.145965145965146,31,30
"['00', '100001', '111', '0111']",1,4,7,8,0,15,2.534920634920635,19,14
"['0', '011', '111']",1,3,2,5,2,7,1.1666666666666665,6,6
"['0', '10111', '110110']",1,3,4,8,0,12,1.3463203463203464,11,5
"['0', '10101', '100']",1,3,5,4,0,9,1.5833333333333333,8,5
"['00100', '010', '100101', '11101']",1,4,10,9,2,19,3.7712121212121215,15,10
"['0100110', '011', '011100', '001000', '100101', '000001', '1100']",1,7,23,15,4,38,12.275002775002775,66,60
"['11011', '10', '1110100', '0111']",1,4,6,12,0,18,3.2279942279942277,20,18
"['1110011', '0110', '1', '111110']",1,4,5,13,0,18,2.6965534465534464,24,15
"['11010', '1111001', '00', '010111', '011110', '0101100', '1010001', '001001', '1111011']",1,9,23,30,7,53,21.444666444666446,119,99
"['000110', '01', '10011', '111']",1,4,7,9,0,16,3.1431457431457432,17,12
"['010', '11011', '011011', '0011', '1010', '1100110', '011110']",1,7,14,21,4,35,13.547918747918748,53,67
"['001100', '111111', '011', '1010']",1,4,7,12,2,19,3.015873015873016,20,12
"['00', '011', '101111']",1,3,4,7,0,11,1.3166666666666667,10,5
"['0010', '1', '1101000', '010101', '001001']",1,5,14,10,2,24,5.230985680985681,35,24
"['100', '1111111', '0110011']",1,3,5,12,2,17,1.3714285714285714,13,8
"['1001001', '00', '0110']",1,3,8,5,0,13,1.4747474747474747,11,4
"['011011', '1011', '00100', '1101100']",1,4,10,12,0,22,3.953069153069153,17,18
"['01101', '110000', '001']",1,3,8,6,0,14,1.4898989898989898,10,8
"['1001', '0101110', '111001']",1,3,7,10,0,17,1.9608391608391609,10,7
"['11000', '1010', '10000']",1,3,9,5,2,14,2.1333333333333333,5,9
"['110100', '1111111', '0110', '0111']",1,4,6,15,2,21,3.3206293706293706,21,19
"['1000100', '01001', '11']",1,3,8,6,0,14,1.6825396825396823,12,6
"['1100', '0101011', '1']",1,3,5,7,0,12,1.0136363636363637,13,7
"['111', '00001', '011010', '10000', '000000', '1011000', '00010', '1011011', '110']",1,9,28,19,9,47,19.16238206238206,115,116
"['1110010', '11', '101', '00', '1001100', '01110']",1,6,12,14,4,26,7.868253968253968,52,32
"['0', '1111101', '1111', '0000010', '1011']",1,5,9,14,4,23,3.503896103896104,44,25
"['0010111', '1100100', '1111']",1,3,7,11,2,18,1.6623376623376622,12,14
"['1111000', '0001010', '01011']",1,3,10,9,2,19,1.4285714285714284,12,9
"['1100', '111', '1110']",1,3,3,8,2,11,2.1785714285714284,4,13
"['11011', '1', '101010', '00110', '1001111']",1,5,9,15,2,24,4.842007992007992,35,24
"['01101', '1', '1001101', '1001100', '0100011']",1,5,13,14,3,27,5.369047619047619,38,32
"['10101', '010', '10010', '001']",1,4,9,7,4,16,4.216666666666667,12,14
"['1101', '000', '11']",1,3,4,5,0,9,0.9523809523809523,8,6
"['001', '100000', '111011']",1,3,8,7,2,15,1.222222222222222,12,7
"['1101101', '100', '111110', '100000', '011111']",1,5,11,17,3,28,4.805128205128205,37,29
"['111010', '1110000', '111', '00001', '101', '100101']",1,6,14,16,4,30,8.71037296037296,48,55
"['0', '000110', '0101', '1110100']",1,4,10,8,0,18,2.5427072927072927,25,15
"['01000', '000010', '11']",1,3,9,4,0,13,1.081168831168831,11,6
"['10001', '0010101', '00', '1001111', '0111100']",1,5,14,14,3,28,5.285714285714286,39,24
"['1', '011', '01000']",1,3,5,4,0,9,1.3333333333333333,9,5
"['101001', '00', '01110', '11']",1,4,7,8,2,15,2.5064935064935066,20,8
"['11001', '00101', '00100', '1101010', '10000', '1111', '0111', '1100', '0110011']",1,9,22,24,9,46,22.00165945165945,98,111
"['11001', '101', '1010100']",1,3,7,8,0,15,2.0166666666666666,9,11
"['001011', '10', '01011']",1,3,6,7,0,13,1.9805194805194803,8,10
"['01', '0001', '011', '111001']",1,4,7,8,0,15,3.5825396825396822,16,18
"['1000001', '0110101', '11110', '010000', '0001', '001010', '10', '0101100', '011111', '0111101']",1,10,29,28,7,57,23.82785547785548,152,129
"['1', '0101110', '0110', '00110', '01010', '000']",1,6,14,11,2,25,8.95981240981241,41,57
"['1000110', '10', '00011']",1,3,8,6,0,14,1.5634920634920635,11,8
"['1111100', '000', '11']",1,3,5,7,0,12,0.8444444444444444,13,8
"['0011110', '110110', '11011', '001']",1,4,8,13,0,21,3.568919968919969,19,19
"['101', '11000', '010', '1101']",1,4,7,8,2,15,3.761904761904762,13,14
"['11011', '0001', '100', '10000', '10']",1,5,11,8,2,19,5.608730158730158,25,28
"['100', '1100', '1111']",1,3,4,7,2,11,1.6428571428571428,6,10
"['0', '10111', '1010', '00011']",1,4,7,8,2,15,2.7777777777777777,18,13
"['10010', '010111', '10110', '10']",1,4,8,10,2,18,3.7155844155844155,16,18
"['101010', '0101', '1111']",1,3,5,9,2,14,1.9,7,6
"['0', '0010', '101', '110001', '1111010']",1,5,10,11,0,21,5.034648684648684,36,20
"['01', '001010', '0010', '01110']",1,4,10,7,0,17,3.932034632034632,15,26
"['001101', '011101', '00', '10100', '0100001', '111001']",1,6,17,15,3,32,8.85969585969586,46,43
"['00', '010', '100', '101110']",1,4,8,6,2,14,4.1,14,18
"['00', '011010', '01110', '1110']",1,4,8,9,0,17,3.8027417027417028,14,25
"['101001', '11010', '0000010', '01100']",1,4,14,9,2,23,3.5494172494172496,19,13
"['101', '1010100', '111011', '000', '1001001', '110']",1,6,14,15,5,29,7.976800976800977,49,39
"['011011', '1010111', '00010', '1100', '01110']",1,5,12,15,2,27,6.065190365190365,29,25
"['111', '00100', '1000111', '11101', '10010', '0011111']",1,6,13,19,5,32,8.547619047619047,51,53
"['1110101', '011', '0111']",1,3,4,10,0,14,1.8025974025974025,9,12
"['11110', '010001', '1111010', '1110001', '000000', '110']",1,6,17,17,4,34,7.8764069264069265,53,47
"['01', '1001', '1100110', '100010']",1,4,10,9,0,19,3.9076146076146077,18,16
"['11000', '1111', '01010', '0111', '0001010', '01000']",1,6,16,14,5,30,8.35909090909091,42,52
"['001', '011', '00001', '10010', '1011', '0100']",1,6,14,10,6,24,9.06031746031746,34,37
"['0111', '1', '1100', '110100']",1,4,6,9,2,15,2.7857142857142856,20,18
"['11001', '111', '10000', '00', '10011']",1,5,10,10,3,20,5.214285714285714,26,29
"['1011', '1000', '110111', '0011000']",1,4,10,11,2,21,3.4342657342657343,20,17
"['0010110', '000110', '010', '01101', '111010', '101', '010110']",1,7,18,18,5,36,14.3006216006216,57,72
"['001', '00101', '0100010', '0000001', '111110', '10', '000000', '101001']",1,8,27,15,5,42,13.724875124875124,100,85
"['01101', '110001', '10000', '0100011']",1,4,13,10,2,23,3.7904428904428906,17,15
"['1', '01110', '00000']",1,3,7,4,2,11,0.7333333333333334,12,4
"['000110', '0010', '01', '0101101', '1001', '1101']",1,6,14,13,3,27,9.35003885003885,41,37
"['110100', '1000010', '1000', '010110', '1011000', '1111111']",1,6,18,19,5,37,7.863836163836164,51,41
"['1011110', '0111010', '1']",1,3,5,10,2,15,1.3571428571428572,14,5
"['1010110', '11011', '1000000', '1000', '010101', '10', '1100011', '0100']",1,8,23,19,5,42,17.053707403707403,89,75
"['0010', '011', '111110', '010101', '010110', '0000', '101110']",1,7,17,18,6,35,12.218253968253968,59,66
"['01', '100', '0001101', '100110', '1110']",1,5,11,11,0,22,5.4305583305583305,32,26
"['010', '00011', '101101', '00100', '11']",1,5,11,10,2,21,5.3647186147186146,30,20
"['1011110', '00100', '001111']",1,3,8,10,0,18,1.8146853146853146,9,9
"['0', '00111', '01111']",1,3,4,7,2,11,1.4666666666666668,9,8
"['1000100', '111', '0011', '1000', '000000', '01110']",1,6,18,11,2,29,7.357181707181707,50,44
"['1011110', '100110', '0011101']",1,3,8,12,2,20,2.2527472527472527,8,9
"['011', '1101101', '0010100', '1010', '10010', '1101']",1,6,14,16,4,30,9.78044733044733,43,39
"['01', '010', '011011', '0110', '100011', '10011', '001100', '0001000']",1,8,22,17,3,39,17.49088689088689,86,76
"['101110', '01101', '100', '1011100']",1,4,9,12,0,21,3.901864801864802,17,21
"['1001110', '01', '1', '0000']",1,4,8,6,0,14,2.2398989898989896,23,10
"['0001110', '111', '01110']",1,3,6,9,0,15,2.1833333333333336,8,8
"['11010', '10110', '00101', '000011']",1,4,11,10,3,21,3.4363636363636365,18,15
"['0', '11010', '101010']",1,3,6,6,0,12,1.3463203463203464,10,9
"['0', '11100', '011']",1,3,4,5,0,9,1.3333333333333333,9,7
"['01101', '1110101', '1010', '0000', '010011']",1,5,13,13,2,26,5.529526029526029,30,22
"['001', '111', '10101', '0101011', '1101', '000', '0100101', '01110']",1,8,17,20,7,37,15.825108225108226,76,73
"['001111', '011', '11', '1101000', '1001', '0001100', '001110', '010011', '1011011']",1,9,22,26,6,48,21.709024309024308,121,106
"['1001', '1', '0011000', '00001']",1,4,11,6,0,17,2.6954545454545453,22,15
"['11010', '1110100', '11']",1,3,5,9,0,14,1.8492063492063493,10,11
"['0001', '00', '110', '1101']",1,4,7,6,2,13,3.0428571428571427,13,15
"['0100111', '111', '00011', '0111111', '11101']",1,5,8,19,4,27,5.921428571428572,32,46
"['011011', '110001', '000011', '1110']",1,4,10,12,3,22,3.433333333333333,19,19
"['101', '10011', '1100011', '011010', '110']",1,5,10,14,2,24,6.444172494172494,30,30
"['0', '0011', '010', '00111']",1,4,7,6,0,13,3.1936507936507934,15,18
"['01', '000', '0111100']",1,3,7,5,0,12,1.2444444444444445,11,11
"['01', '10011', '1001010', '1101']",1,4,8,10,0,18,3.90981240981241,17,19
"['1100010', '0101', '00101', '10000']",1,4,13,8,2,21,3.9787878787878785,17,16
"['1110101', '1001001', '00', '0111']",1,4,9,11,2,20,3.027417027417027,24,13
"['0100010', '101', '01']",1,3,7,5,0,12,1.6444444444444444,10,6
"['0001', '1', '10110']",1,3,5,5,0,10,1.1777777777777778,10,6
"['0010', '0101000', '0100010', '0011111', '00010', '0101']",1,6,21,13,5,34,9.528499278499279,46,67
"['010', '110111', '000']",1,3,6,6,2,12,1.3333333333333333,10,4
"['0100000', '10000', '00110', '000000', '01000', '1011111']",1,6,24,11,5,35,8.160306360306361,50,69
"['010', '1', '00011', '1110110', '0111110']",1,5,9,14,2,23,4.604761904761904,39,24
"['010100', '0101', '10010']",1,3,9,6,0,15,2.012121212121212,8,9
"['111001', '01', '0100', '11111']",1,4,6,11,0,17,3.001875901875902,19,16
"['011', '00101', '00111', '0011', '0100']",1,5,11,10,4,21,7.117460317460317,18,35
"['1110111', '1111100', '00000', '110', '1110']",1,5,10,16,2,26,5.0553391053391055,37,37
"['0101011', '1011100', '00011']",1,3,9,10,2,19,1.9047619047619047,10,9
"['00', '1', '1111110']",1,3,3,7,0,10,0.4722222222222222,14,4
"['11000', '1111110', '000']",1,3,7,8,0,15,1.45,12,11
"['1000001', '00001', '101', '11101', '0010010', '1111111']",1,6,16,18,5,34,7.559523809523809,55,50
"['000000', '1000', '001011', '010110']",1,4,15,7,3,22,3.4333333333333336,18,21
"['1110001', '00010', '10010', '10']",1,4,11,8,2,19,3.7206349206349207,20,16
"['1010101', '1', '011']",1,3,4,7,0,11,1.35,12,8
"['010', '1100', '1111']",1,3,4,7,2,11,1.3571428571428572,7,6
"['101', '0011', '100', '00110', '00']",1,5,10,7,2,17,6.136507936507936,21,30
"['1010000', '00100', '100', '010111']",1,4,13,8,0,21,3.468104118104118,20,19
"['11', '1001010', '111001']",1,3,6,9,0,15,1.5598290598290598,13,10
"['1010110', '110', '00011', '010010', '010101', '100000', '1100']",1,7,21,16,3,37,12.71906981906982,62,57
"['01', '110', '110111']",1,3,3,8,0,11,1.5666666666666667,9,9
"['0010', '0001', '111101', '1110']",1,4,8,10,3,18,3.1,18,15
"['0011', '0001', '100', '010101']",1,4,10,7,2,17,3.5595238095238093,13,16
"['11001', '111010', '0011', '1110101', '1101']",1,5,9,17,2,26,7.011965811965812,25,45
"['1011110', '0001', '00', '010101', '1011000', '0111100']",1,6,17,16,3,33,8.304595404595405,55,47
"['0001', '000101', '0010']",1,3,10,4,2,14,2.35,6,12
"['01101', '1011001', '1010111', '0001011', '1010010', '110']",1,6,16,20,4,36,9.335714285714285,47,44
"['10101', '100', '011101', '1100', '01100']",1,5,11,12,2,23,6.829870129870129,22,30
"['110000', '1', '001011']",1,3,7,6,2,13,0.9047619047619047,15,8
"['0', '11000', '01111']",1,3,5,6,2,11,1.0666666666666667,12,7
"['010100', '00011', '00000', '110011', '111110', '010110']",1,6,18,16,6,34,7.918181818181818,43,49
"['1110111', '1011', '00', '10010']",1,4,7,11,0,18,3.020923520923521,21,13
"['1010110', '00', '111']",1,3,5,7,0,12,0.8444444444444444,12,4
"['1100', '1000000', '00100', '1']",1,4,12,5,0,17,2.6954545454545453,22,16
"['00010', '01000', '110101']",1,3,10,6,2,16,1.690909090909091,8,6
"['11110', '001', '010000', '101101', '1101110', '11111']",1,6,12,20,4,32,7.471173271173272,49,42
"['00010', '001', '00000']",1,3,11,2,2,13,2.05,6,15
"['01', '11000', '1101', '100101', '01001']",1,5,11,11,2,22,6.211688311688311,27,32
"['1000010', '0000110', '1110']",1,3,11,7,2,18,1.7662337662337662,10,10
"['101010', '00', '1', '0110110']",1,4,8,8,0,16,2.2493894993894994,25,11
"['0', '010111', '101010']",1,3,6,7,2,13,1.2380952380952381,13,6
"['01', '11', '010110', '10011', '000']",1,5,9,9,2,18,4.936796536796537,29,19
"['1100111', '01', '1']",1,3,3,7,0,10,1.3611111111111112,12,8
"['0010110', '0010', '001', '01111', '11101', '111110', '0011111', '1100', '001011']",1,9,19,28,8,47,21.36927516927517,107,130
"['11000', '0111111', '0111', '0011000']",1,4,10,13,2,23,3.3124098124098125,22,24
"['00100', '111', '1111001']",1,3,6,9,0,15,1.35,12,8
"['0101101', '11010', '010', '01100']",1,4,10,10,2,20,4.233333333333333,16,20
"['010', '100001', '1001000', '1000111', '1011', '0101']",1,6,17,14,4,31,9.142696192696192,47,44
"['0001', '010', '0010011']",1,3,9,5,0,14,1.7168831168831167,9,7
"['01', '0010', '0100010', '00111', '110001', '111011', '100110', '1000']",1,8,21,19,5,40,16.783044733044733,86,71
"['1', '000001', '00011']",1,3,8,4,0,12,1.3463203463203464,11,8
"['1101', '01001', '1']",1,3,4,6,0,10,1.4,9,9
"['0011001', '00', '010', '1111111']",1,4,8,11,2,19,2.473015873015873,27,12
"['1001010', '10001', '111110', '100101', '0111', '010011']",1,6,15,19,3,34,9.123232323232322,41,48
"['111', '01000', '1101', '0101', '0011100']",1,5,11,12,2,23,5.897258297258297,28,24
"['0001', '010', '10', '0100011']",1,4,10,6,0,16,3.4764790764790763,18,15
"['00', '11100', '10']",1,3,5,4,2,9,1.6428571428571428,7,8
"['0001110', '011', '01001', '10', '001100', '00010', '01011']",1,7,19,14,3,33,13.443112443112444,58,64
"['11001', '11000', '1100010', '100', '1100111', '110', '01011']",1,7,16,19,7,35,13.714285714285714,55,84
"['1001', '1100', '10011', '000']",1,4,9,7,2,16,3.948412698412698,13,16
"['0000111', '10110', '0']",1,3,7,6,0,13,1.0833333333333333,14,6
"['111', '00001', '10111', '1010100', '0110', '00', '0011111']",1,7,15,18,4,33,10.1995670995671,71,59
"['0', '1101', '100']",1,3,4,4,0,8,1.4714285714285715,7,4
"['00', '100', '011110']",1,3,6,5,0,11,1.7444444444444445,9,10
"['0001101', '00110', '1']",1,3,7,6,0,13,1.4166666666666667,12,5
"['001', '101010', '0110', '1101', '10011', '00010']",1,6,14,13,4,27,8.932251082251081,33,34
"['00111', '1', '000']",1,3,5,4,0,9,0.8333333333333333,10,6
"['100001', '0101001', '11']",1,3,8,7,0,15,1.5598290598290598,11,10
"['0110100', '110001', '00', '10', '01001']",1,5,13,9,2,22,5.694916194916194,33,23
"['110001', '10100', '000', '01001', '01011']",1,5,14,10,3,24,6.184848484848485,24,25
"['0111000', '0010', '0011', '101', '11101', '100011', '0100']",1,7,17,16,3,33,12.328155178155178,62,52
"['11010', '0010', '010000', '011', '10000', '1110101', '101110', '0100']",1,8,22,18,6,40,16.767254967254967,79,78
"['111111', '100', '00', '010']",1,4,6,8,2,14,2.7111111111111112,20,12
"['00001', '1001100', '1101011', '11']",1,4,10,11,2,21,2.7222222222222223,26,19
"['1010111', '0001', '001', '101111']",1,4,8,12,0,20,3.2344544344544346,18,21
"['10101', '10001', '000101', '0111', '01010', '110']",1,6,14,14,3,28,9.275468975468975,35,37
"['0', '01', '10110', '110111']",1,4,5,9,0,14,3.0844155844155843,19,10
"['101011', '01', '110', '1110000']",1,4,8,10,0,18,2.628205128205128,23,15
"['0010', '010001', '1', '00011']",1,4,10,6,0,16,3.012987012987013,19,11
"['11000', '001', '11']",1,3,5,5,0,10,1.4714285714285715,8,9
"['11001', '0011', '0110', '10100', '0000', '1101']",1,6,14,12,6,26,8.938888888888888,35,36
"['11110', '011011', '10000', '00', '00010']",1,5,13,10,3,23,4.9831168831168835,32,30
"['01', '1001010', '0001111', '10', '1110']",1,5,10,12,4,22,4.536075036075036,38,26
"['010', '1', '11000', '111011', '010011']",1,5,9,12,2,21,4.773448773448774,34,26
"['00100', '1100001', '0001111', '1000', '000', '01000', '111001']",1,7,23,14,4,37,13.28964368964369,67,73
"['101100', '011', '10111', '100', '10110', '10000', '0010011']",1,7,17,17,5,34,13.047202797202797,58,71
"['01101', '1', '01111', '1010', '00110']",1,5,8,12,3,20,5.155555555555556,28,21
"['010', '001101', '111', '0010011', '10100', '01110', '00010', '01011', '101111']",1,9,21,24,8,45,21.832789432789433,97,97
"['01101', '001111', '101', '100101', '000', '1101', '01110']",1,7,14,18,6,32,12.716089466089466,55,57
"['0101010', '0101', '100']",1,3,8,6,0,14,1.8987012987012988,9,9
"['11110', '101011', '0110', '1010111', '0011100']",1,5,11,18,2,29,6.322444222444222,30,27
"['0101000', '1', '10110', '011001', '1010000']",1,5,15,11,2,26,5.421411921411921,37,23
"['000011', '101', '1111110', '1101', '01011']",1,5,9,16,0,25,5.432006882006882,33,31
"['1001100', '000100', '0111010', '110']",1,4,13,10,2,23,3.435653235653236,20,18
"['0', '01', '001110', '1111']",1,4,5,8,0,13,2.3857142857142857,20,10
"['110011', '1011', '0', '0100']",1,4,7,8,2,15,2.9857142857142858,19,11
"['0001001', '0010', '010', '001111', '100', '0110000', '101001']",1,7,22,14,6,36,12.723154623154622,70,62
"['1000000', '0100100', '011001']",1,3,14,6,2,20,1.9450549450549453,10,8
"['11010', '001', '11', '00001', '1010100', '100000']",1,6,17,11,2,28,7.18029748029748,49,43
"['1000011', '111010', '0', '11']",1,4,7,9,0,16,1.9416971916971917,26,15
"['011100', '000', '1111']",1,3,6,7,0,13,1.0444444444444443,10,6
"['11001', '101101', '10', '00000']",1,4,10,8,2,18,2.848051948051948,20,12
"['11110', '100', '000', '0100101']",1,4,10,8,2,18,2.9499999999999997,20,14
"['001111', '101001', '0111', '1100', '01100']",1,5,11,14,4,25,6.428282828282828,26,29
"['01', '0111001', '00111', '10110', '011111', '0100001', '0100']",1,7,17,19,4,36,12.315184815184814,67,63
"['0', '0101000', '0111111', '10010', '01100']",1,5,13,12,4,25,4.3619047619047615,41,31
"['010', '001', '0000001', '11']",1,4,10,5,2,15,2.688888888888889,21,13
"['0010', '111', '111001', '000', '1001001', '1011111']",1,6,13,17,4,30,7.747075147075147,52,44
"['100100', '011', '1001111', '1']",1,4,7,10,0,17,2.6955433455433457,24,18
"['101', '0110', '00001']",1,3,7,5,0,12,1.5158730158730158,9,5
"['001100', '100100', '110']",1,3,9,6,2,15,1.9444444444444444,8,9
"['110110', '101', '0111', '11']",1,4,4,11,0,15,3.8047619047619046,15,19
"['11001', '0110', '010110', '11111', '1011011']",1,5,9,18,2,27,6.25003885003885,27,25
"['10111', '110100', '00', '11101', '0000110']",1,5,12,13,2,25,4.8501387501387505,37,25
"['11110', '101', '1001', '01111', '11100']",1,5,7,15,3,22,6.112698412698412,25,31
"['1011110', '001', '10011', '111011']",1,4,7,14,0,21,3.6037684537684536,19,18
"['00111', '01', '00', '001111']",1,4,7,8,2,15,3.551948051948052,16,22
"['111000', '1100000', '110', '110001']",1,4,12,10,2,22,4.305128205128205,16,25
"['1000001', '101', '11101', '01011']",1,4,9,11,2,20,3.7,19,24
"['110000', '0010', '101', '1010', '10010', '0011111', '1100111']",1,7,17,19,4,36,12.682095682095682,67,63
"['0', '001100', '111011']",1,3,6,7,2,13,1.0714285714285714,14,4
"['1101', '111110', '01000']",1,3,6,9,0,15,1.408080808080808,10,5
"['1000000', '1', '0000011', '0100100']",1,4,16,6,3,22,2.75,28,16
"['011111', '0101', '110']",1,3,4,9,0,13,1.615873015873016,9,8
"['11001', '1101001', '1', '101011', '1101']",1,5,8,15,0,23,5.451409701409702,30,55
"['111', '101', '11000', '100', '01111', '00']",1,6,9,12,5,21,7.373809523809523,38,41
"['0', '11011', '0111010', '1001', '1001011', '01000']",1,6,14,15,4,29,7.486147186147186,53,32
"['0110111', '1', '111010', '0100100', '1100']",1,5,11,14,2,25,4.724975024975025,38,25
"['101', '10', '0111']",1,3,3,6,0,9,1.7047619047619047,6,7
"['0010011', '011001', '1011', '1101', '00010', '111001']",1,6,15,17,4,32,9.687140637140637,41,44
"['11000', '0011', '1110101', '100110', '000', '01001', '1111011']",1,7,17,20,4,37,12.384088134088135,68,59
"['0', '11101', '010001']",1,3,6,6,0,12,1.1645021645021645,12,5
"['101000', '100', '0110', '000', '1001100']",1,5,15,8,2,23,6.085514485514485,27,38
"['101100', '1000', '0110', '11']",1,4,8,8,2,16,3.4,16,12
"['010', '0011', '111011', '011101', '1101']",1,5,8,15,4,23,6.387301587301588,26,28
"['0011', '1', '1100110']",1,3,5,7,0,12,1.3772727272727274,12,7
"['011', '1010111', '1010', '1000', '011111']",1,5,9,15,2,24,5.361921411921412,31,31
"['000110', '00000', '0001', '1001', '010010', '100110', '010111']",1,7,23,14,6,37,13.942929292929293,49,66
"['11001', '01', '11', '000010', '01010']",1,5,11,9,4,20,5.226623376623376,30,22
"['0', '0011111', '111']",1,3,3,8,0,11,0.85,13,8
"['1000100', '00101', '0110', '1111', '10100', '0000010', '0011011']",1,7,22,17,7,39,12.088455988455989,67,57
"['110011', '10010', '100111']",1,3,7,10,2,17,2.287878787878788,6,13
"['01101', '11', '000101', '01111', '00110', '100101', '111000']",1,7,16,19,6,35,13.050649350649351,62,60
"['00111', '000010', '0']",1,3,8,4,0,12,1.1645021645021645,12,9
"['011011', '1011', '011010', '111']",1,4,6,13,2,19,4.138095238095238,13,21
"['01', '0110', '111']",1,3,3,6,0,9,1.638095238095238,6,5
"['001', '0110', '10']",1,3,5,4,0,9,1.638095238095238,6,7
"['01', '00101', '000000', '001011', '0110001']",1,5,17,9,2,26,5.143495393495393,33,32
"['101', '0111010', '10']",1,3,5,7,0,12,1.8444444444444446,10,6
"['1001', '100', '00011']",1,3,7,5,0,12,2.0238095238095237,6,9
"['0', '0101110', '10', '110101']",1,4,7,9,0,16,2.762210012210012,24,11
"['0', '001', '0110', '1110']",1,4,6,6,2,12,2.907142857142857,14,16
"['0101', '111110', '00011']",1,3,6,9,0,15,1.4303030303030302,10,7
"['00001', '00111', '000101', '111110', '000', '1100']",1,6,16,13,4,29,7.714357864357864,47,54
"['1000', '1', '000011']",1,3,7,4,0,11,1.2857142857142856,11,8
"['1001100', '0001', '01', '00001']",1,4,12,6,0,18,3.6168831168831166,19,21
"['111', '011011', '1001000', '1000111', '100111', '000010', '011010', '101001']",1,8,23,24,7,47,17.26800976800977,89,88
"['011011', '1', '0101110']",1,3,5,9,0,14,1.304945054945055,14,5
"['1100001', '1010', '100']",1,3,8,6,0,14,2.0025974025974023,9,7
"['00001', '100000', '011', '11']",1,4,10,6,0,16,2.7852092352092352,20,17
"['1100001', '10', '0111', '0101', '0100']",1,5,11,10,3,21,5.747474747474747,29,24
"['1011001', '111', '101', '0110', '00', '1100', '01000']",1,7,14,14,4,28,11.856132756132755,57,47
"['0111000', '1000010', '00110', '00', '0000010']",1,5,20,8,3,28,5.761904761904762,36,49
"['10100', '1', '10', '000']",1,4,7,4,0,11,2.4714285714285715,15,13
"['1010100', '11101', '1']",1,3,5,8,0,13,1.0833333333333333,13,8
"['10010', '1101111', '1']",1,3,4,9,0,13,1.0833333333333333,14,8
"['0', '1101', '1010100']",1,3,6,6,0,12,1.1954545454545453,12,4
"['01', '1100', '010010']",1,3,7,5,0,12,1.4333333333333333,10,7
"['01', '1', '000000']",1,3,7,2,0,9,0.9166666666666666,12,4
"['01', '11000', '1000', '00', '100101']",1,5,12,7,2,19,5.773304473304473,27,28
"['01', '011011', '10100', '00', '1101', '1011111']",1,6,10,16,2,26,7.982484182484182,49,37
"['10100', '1', '1111011']",1,3,4,9,0,13,1.0833333333333333,14,8
"['1010010', '1', '011110']",1,3,6,8,0,14,0.8434065934065934,14,5
"['0001', '1010100', '10000', '11']",1,4,11,7,0,18,2.5937950937950935,20,17
"['100100', '0000011', '1001', '10000']",1,4,15,7,0,22,4.04941724941725,16,24
"['10101', '0111111', '10', '0101000']",1,4,9,12,2,21,2.833333333333333,25,12
"['00', '1', '00011']",1,3,5,3,0,8,0.9047619047619047,9,6
"['101', '11110', '0110', '1111110']",1,4,5,14,0,19,3.516883116883117,19,21
"['1', '10111', '0011', '1100000', '10100']",1,5,11,11,2,22,4.391414141414141,37,30
"['1001001', '00', '11']",1,3,6,5,2,11,0.8888888888888888,12,4
"['001101', '11', '10000', '01010', '01011', '1110']",1,6,13,14,3,27,8.32857142857143,45,38
"['0010', '001', '001010', '01110', '11111', '101111']",1,6,12,17,4,29,8.452597402597403,41,43
"['0010001', '110110', '111']",1,3,7,9,0,16,1.528205128205128,13,8
"['11001', '0010111', '11', '01110', '111101']",1,5,8,17,2,25,5.77005217005217,33,31
"['010', '0000100', '00000', '11', '101', '100100', '1001', '100110', '1110']",1,9,24,16,6,40,20.61008436008436,105,100
"['1010', '01', '100']",1,3,5,4,0,9,1.9238095238095236,5,7
"['01', '11011', '0100010', '101', '01111', '1100']",1,6,11,15,2,26,8.198629148629148,45,38
"['11001', '1011', '1']",1,3,3,7,0,10,1.1777777777777778,9,13
"['0111001', '100', '000', '1001101']",1,4,11,9,4,20,3.438095238095238,20,15
"['0010', '010', '10000', '1011', '110']",1,5,11,8,4,19,5.849206349206349,21,25
"['0', '1011', '1101']",1,3,3,6,2,9,1.55,8,5
"['01', '010', '011']",1,3,4,4,2,8,2.2666666666666666,3,9
"['0', '1011010', '11110', '1011100']",1,4,8,12,2,20,3.1904761904761902,22,16
"['0111001', '1', '00000', '100101', '011000']",1,5,15,10,2,25,4.296953046953047,40,23
"['00100', '01', '1011', '1110']",1,4,7,8,2,15,2.96031746031746,16,11
"['1100', '1110', '001010']",1,3,7,7,2,14,1.75,7,9
"['010011', '10001', '000000']",1,3,12,5,2,17,1.606060606060606,8,4
"['00111', '1', '01110']",1,3,4,7,2,11,1.4666666666666668,10,4
"['010000', '1', '00101', '011', '01010']",1,5,12,8,2,20,5.4695526695526695,30,23
"['0010010', '1010101', '1111']",1,3,8,10,2,18,1.8051948051948052,11,4
"['100', '100101', '111']",1,3,5,7,2,12,1.6666666666666665,8,10
"['010', '110', '1110000', '1101100']",1,4,10,10,4,20,3.5809523809523807,21,18
"['1010011', '101101', '111001']",1,3,7,12,2,19,2.371794871794872,6,16
"['01101', '00', '001', '01110']",1,4,8,7,2,15,3.742857142857143,14,19
"['1100011', '10001', '1010101', '0100']",1,4,12,11,2,23,4.153679653679654,17,14
"['1001', '1', '0010101', '1010011']",1,4,9,10,2,19,2.8870129870129873,24,20
"['1100011', '1010000', '000110', '1100100']",1,4,16,11,3,27,4.142857142857143,18,18
"['10101', '000100', '0011111']",1,3,9,9,0,18,1.506993006993007,11,6
"['1010', '00010', '1']",1,3,6,4,0,10,1.4,9,6
"['11', '011011', '110011', '10100', '010110', '1100110']",1,6,13,19,3,32,9.156898656898656,45,50
"['00100', '000', '001100', '1101', '01000']",1,5,16,7,2,23,6.377633477633477,24,46
"['101', '00', '0110010', '110', '101111']",1,5,9,12,2,21,5.087606837606837,35,20
"['11001', '1100110', '0']",1,3,6,7,0,13,1.4166666666666667,12,8
"['01', '00', '1100']",1,3,5,3,2,8,1.5,6,8
"['0010', '11011', '0110', '00110', '100101', '0100']",1,6,15,13,5,28,10.082323232323231,33,38
"['0', '010111', '100010']",1,3,7,6,2,13,1.0714285714285714,14,6
"['1011010', '00100', '0011', '0110', '110100', '1011', '1100', '1110']",1,8,18,20,5,38,18.006604506604507,71,87
"['010', '1110000', '00', '011110', '1101']",1,5,11,11,0,22,5.4767121767121765,34,25
"['001', '0010000', '00011', '110', '01000']",1,5,16,7,4,23,5.516666666666667,33,36
"['11011', '10', '1110000', '011000']",1,4,10,10,0,20,3.3305583305583304,21,14
"['1001', '1', '011']",1,3,3,5,0,8,1.4714285714285715,7,8
"['0010', '010', '101', '0001', '100000', '0101100', '1010000']",1,7,23,11,6,34,12.422039072039071,63,65
"['1111100', '00', '1101011', '0110']",1,4,8,12,2,20,3.217893217893218,24,14
"['1001100', '00', '100']",1,3,8,4,0,12,1.8444444444444446,10,14
"['00001', '10111', '10101', '1100', '11111', '110']",1,6,10,17,4,27,7.607142857142857,37,52
"['01', '1010100', '1111', '1100110', '000']",1,5,11,12,2,23,4.466378066378066,37,22
"['1', '01000', '100010']",1,3,8,4,0,12,1.3463203463203464,12,4
"['1110010', '011', '101', '100', '000010', '0101']",1,6,14,12,3,26,8.646553446553446,45,37
"['01', '111', '010010', '1010001', '1010010']",1,5,13,12,2,25,5.982783882783883,34,29
"['001', '100000', '11']",1,3,7,4,0,11,1.0944444444444446,11,7
"['1000110', '0001', '0111']",1,3,8,7,2,15,1.7727272727272727,9,6
"['001', '111', '100', '0110', '1001101', '1010', '0110011']",1,7,14,17,7,31,12.657359307359307,60,52
"['101', '1001', '10', '111']",1,4,4,8,2,12,3.961904761904762,9,22
"['1110010', '100100', '1010', '000', '001100', '0101', '0100']",1,7,21,13,5,34,13.80041625041625,55,70
"['1011', '01', '1010101', '1101110']",1,4,7,13,2,20,3.7243867243867244,21,18
"['1', '10100', '010111', '0111', '000', '001011']",1,6,12,13,2,25,6.97027417027417,47,39
"['0', '0011011', '0011111']",1,3,6,9,2,15,1.3571428571428572,13,10
"['001', '100111', '11']",1,3,4,7,0,11,1.5666666666666667,9,10
"['101100', '0000001', '10']",1,3,10,5,0,15,1.0299145299145298,14,8
"['000110', '0010', '010001', '101000', '0001', '10000']",1,6,22,9,5,31,10.465151515151515,36,54
"['110', '101', '10100', '11101', '1100']",1,5,8,12,4,20,7.000793650793651,18,32
"['101000', '110', '0100']",1,3,8,5,0,13,1.8158730158730159,7,7
"['0', '0110010', '100', '111011']",1,4,8,9,0,17,2.5416971916971915,24,10
"['01', '000011', '011011', '00100', '100', '1101']",1,6,14,12,2,26,8.083766233766234,44,40
"['0110001', '1010110', '000']",1,3,10,7,2,17,1.7714285714285714,13,6
"['0001', '10010', '10110', '01100']",1,4,11,8,3,19,3.7555555555555555,14,15
"['11000', '0010010', '1', '1011100']",1,4,11,9,2,20,2.738095238095238,26,13
"['101111', '100', '10011', '101001']",1,4,8,12,2,20,3.9823232323232323,15,27
"['01', '110001', '011']",1,3,5,6,0,11,1.7444444444444445,9,9
"['011101', '1010', '0']",1,3,5,6,0,11,1.2857142857142856,11,6
"['001', '101', '1111', '10', '000111', '01000']",1,6,11,12,2,23,7.3573593073593075,44,38
"['0011', '11111', '00001']",1,3,6,8,2,14,1.3111111111111111,9,9
"['0', '0001110', '0110111', '1111']",1,4,7,12,2,19,2.3051948051948052,26,14
"['0011001', '0011', '10110', '111011', '000', '1100011']",1,6,15,17,2,32,9.077666777666778,48,47
"['1011', '110', '10011']",1,3,4,8,0,12,1.9603174603174602,6,13
"['11000', '00', '0101000', '0000001']",1,4,16,5,2,21,3.2222222222222223,22,27
"['0010', '1', '011', '00001', '1010', '1100110']",1,6,13,11,2,24,7.9418470418470415,45,34
"['01', '1010110', '010', '011']",1,4,7,8,2,15,3.911111111111111,16,16
"['10001', '1001000', '10']",1,3,9,5,0,14,1.6825396825396823,11,10
"['010', '10000', '0000']",1,3,10,2,0,12,1.9603174603174602,6,14
"['011001', '0001110', '0010111', '1111110', '1000000', '0111', '0000', '1101', '0100']",1,9,26,24,8,50,18.77852147852148,127,111
"['00111', '11000', '110010', '1111']",1,4,8,12,2,20,3.5656565656565657,18,26
"['011', '11', '0001111', '1101110', '0000']",1,5,10,13,2,23,4.655122655122655,38,31
"['1001', '11100', '11101']",1,3,5,9,2,14,2.1333333333333333,6,12
"['011011', '11000', '10101', '0100100']",1,4,12,11,2,23,3.8214452214452215,18,13
"['001', '10010', '111']",1,3,5,6,2,11,1.5833333333333333,7,6
"['000110', '00000', '00100', '10100', '001010', '0101100', '11111', '1011', '0111100']",1,9,28,22,8,50,20.411610611610612,98,132
"['1010', '1', '000001', '0000']",1,4,11,4,2,15,2.3857142857142857,20,16
"['101100', '00', '00101', '101111']",1,4,9,10,2,19,3.079004329004329,20,18
"['1', '0011', '1101101', '0000001', '0010100']",1,5,15,11,3,26,4.253896103896103,43,26
"['1101', '1', '111100']",1,3,3,8,0,11,1.2857142857142856,11,9
"['1110111', '000', '111101']",1,3,5,11,0,16,1.1914529914529914,13,8
"['01101', '0110', '0001111']",1,3,7,9,0,16,2.1010101010101008,8,9
"['0', '00001', '100010', '110011', '1010', '0010010', '011000']",1,7,22,13,3,35,11.148556998556998,67,54
"['0111011', '11', '00010', '000111', '01011']",1,5,11,14,2,25,5.804850704850705,31,33
"['1001110', '0001', '11101', '111000', '11100']",1,5,12,15,2,27,6.419425019425019,30,35
"['1000110', '1111', '000', '1001001', '110', '1110']",1,6,13,15,6,28,7.711904761904762,47,43
"['010', '101101', '10100', '1000', '110', '1110']",1,6,12,13,4,25,9.559812409812409,30,38
"['11', '0011', '101000', '11101', '0111']",1,5,8,13,2,21,5.6113275613275615,28,33
"['10111', '10010', '1100', '000']",1,4,9,8,2,17,3.2825396825396824,15,14
"['1101', '110001', '100011', '11']",1,4,7,11,2,18,3.7,17,35
"['0110101', '011', '1001011']",1,3,7,10,2,17,1.9142857142857141,11,10
"['0', '101000', '0111']",1,3,6,5,0,11,1.0857142857142859,12,6
"['0000111', '01101', '010110', '00001']",1,4,13,10,2,23,3.606293706293706,17,18
"['010010', '0101', '000001']",1,3,11,5,2,16,1.8666666666666667,8,9
"['010', '10', '110111', '001000']",1,4,9,8,2,17,3.2444444444444445,21,11
"['010100', '0111101', '001111']",1,3,8,11,2,19,1.8846153846153846,9,8
"['010', '100', '1111']",1,3,4,6,2,10,1.2380952380952381,8,4
"['1', '111010', '011100', '00100', '0110', '0111']",1,6,12,14,4,26,8.471933621933623,43,43
"['1', '11000', '101000', '1001', '011111', '1101010']",1,6,13,16,2,29,7.618864468864469,53,40
"['10111', '00110', '11000']",1,3,7,8,3,15,1.6,10,6
"['0000101', '0110', '10000', '01110']",1,4,13,8,2,21,3.4454545454545453,19,21
"['0010', '010', '000', '11']",1,4,8,4,2,12,3.1142857142857143,11,16
"['001', '101', '0110', '110', '01110']",1,5,8,10,3,18,6.305555555555555,21,27
"['101', '011', '00001']",1,3,6,5,2,11,1.6666666666666665,8,7
"['1110111', '101011', '1100001', '1010101', '1111010', '1000', '0101', '11100']",1,8,19,28,6,47,17.58786768786769,84,100
"['1001', '1', '0010011', '0000']",1,4,10,6,2,16,2.6045454545454545,21,12
"['10001', '0110000', '1011', '1101', '011010', '110']",1,6,14,15,2,29,9.7508325008325,42,36
"['01', '10110', '111', '0000']",1,4,7,7,0,14,2.249206349206349,17,10
"['0111010', '10000', '1000111']",1,3,10,9,2,19,1.7380952380952381,12,7
"['1010', '1110110', '1000111']",1,3,7,11,2,18,1.7012987012987013,10,10
"['101010', '01101', '1', '1001']",1,4,7,9,0,16,2.808946608946609,19,16
"['1010', '10010', '110']",1,3,6,6,0,12,1.9603174603174602,4,11
"['11110', '11011', '001111', '00001', '100', '110011', '0100']",1,7,15,19,5,34,11.486435786435786,63,64
"['011100', '1101', '0101010', '101001']",1,4,11,12,2,23,3.9505827505827504,16,10
"['1010110', '111', '110010']",1,3,6,10,0,16,1.682051282051282,9,9
"['0', '0101', '10000']",1,3,7,3,0,10,1.1777777777777778,10,6
"['100000', '1', '011000']",1,3,9,4,2,13,1.2380952380952381,13,6
"['0', '0111000', '101', '1100001', '10110']",1,5,12,11,2,23,4.964285714285714,40,19
"['0', '11011', '010001', '101', '10011']",1,5,9,11,2,20,5.4695526695526695,28,25
"['01', '01101', '0110011']",1,3,6,8,0,14,1.8492063492063493,10,12
"['0101101', '011010', '111100', '1']",1,4,8,12,2,20,2.8727106227106227,25,11
"['11110', '100', '0110', '0010100', '1111', '01100']",1,6,13,15,4,28,8.953607503607504,39,49
"['1111100', '00111', '10']",1,3,5,9,0,14,1.2301587301587302,13,9
"['101', '100', '011', '000000']",1,4,10,5,3,15,2.5555555555555554,20,13
"['11010', '011', '1011110', '0101101', '110001', '00', '1011011', '001001']",1,8,19,24,5,43,16.455633255633256,95,73
"['0011', '011', '000']",1,3,6,4,2,10,1.7619047619047619,5,10
"['0', '110', '100011']",1,3,5,5,0,10,1.2301587301587302,11,5
"['0010', '01', '100001', '000', '11111', '001100']",1,6,15,11,2,26,7.392352092352092,49,36
"['01', '111100', '00101', '111', '0000', '1011', '01011']",1,7,13,16,4,29,10.274891774891774,59,60
"['101', '1010100', '0010111']",1,3,8,9,2,17,1.7714285714285714,11,9
"['0111', '101010', '010010', '110100']",1,4,11,11,3,22,3.9333333333333336,17,16
"['101', '0011', '1100000', '0101']",1,4,10,8,2,18,3.305844155844156,20,16
"['001111', '000011', '11', '100', '0110', '1011', '01110']",1,7,13,17,4,30,12.48145743145743,60,56
"['11011', '0101110', '011', '10', '0100011']",1,5,10,14,2,24,5.8579365079365076,34,31
"['01100', '01010', '000000']",1,3,12,4,2,16,1.709090909090909,8,15
"['01', '10000', '111011', '10100', '1000', '110']",1,6,13,12,2,25,7.793217893217893,40,41
"['110011', '0010011', '0111100']",1,3,9,11,2,20,1.9560439560439562,12,10
"['01', '001001', '1']",1,3,5,4,0,9,1.4523809523809523,10,7
"['0', '11110', '011001', '1010001', '01110']",1,5,11,13,2,24,4.711005661005661,35,25
"['010', '01000', '011111', '0001010', '101001']",1,5,15,12,2,27,5.795609945609946,34,28
"['101100', '1000', '0111001', '10']",1,4,10,9,0,19,3.525796425796426,20,16
"['0001', '010000', '0111011']",1,3,10,7,0,17,1.425174825174825,11,9
"['0', '01111', '0111111', '0101', '1110']",1,5,6,15,2,21,5.140909090909091,33,33
"['0010110', '01', '000']",1,3,8,4,0,12,1.4444444444444444,11,10
"['0', '0011', '1001', '01011']",1,4,7,7,2,14,3.4388888888888887,15,12
"['00', '001001', '000001']",1,3,11,3,2,14,1.5,9,13
"['0101', '111100', '0101100']",1,3,8,9,0,17,1.8965034965034966,9,12
"['101000', '100100', '0110111', '10']",1,4,11,10,2,21,3.200854700854701,24,16
"['0100111', '0011010', '111111', '110', '01000']",1,5,12,16,2,28,4.93029193029193,38,30
"['00100', '01010', '000']",1,3,10,3,2,13,2.3,6,16
"['100', '1001', '1010', '1000011', '0101']",1,5,12,10,3,22,6.953896103896104,25,32
"['0001', '10', '111010', '010111']",1,4,8,10,2,18,2.6333333333333333,22,15
"['000110', '1', '11000', '1001', '0000']",1,5,13,7,2,20,4.797835497835497,31,26
"['0', '011010', '10110', '10']",1,4,7,7,0,14,3.0844155844155843,20,18
"['0', '1011101', '0101', '11100', '0100']",1,5,10,11,2,21,5.002020202020202,32,24
"['1011', '110010', '10']",1,3,5,7,0,12,1.7666666666666666,9,9
"['001', '100', '010110', '00000']",1,4,12,5,2,17,3.323232323232323,17,19
"['0', '100011', '011', '101101']",1,4,7,9,2,16,3.071428571428571,21,13
"['101100', '1010110', '01', '10111', '1101101', '00', '10011', '0110110']",1,8,17,24,7,41,17.466999666999666,86,73
"['0', '0010001', '011', '010110']",1,4,10,7,0,17,2.9177655677655676,24,15
"['1', '10101', '01111', '0001010', '000100']",1,5,13,11,2,24,4.801215451215451,37,21
"['11001', '0', '01101', '101101', '1011110', '100']",1,6,11,16,2,27,8.591308691308692,47,39
"['1001100', '11101', '1110000']",1,3,9,10,2,19,2.0476190476190474,10,10
"['10001', '1110011', '1', '101101']",1,4,7,12,0,19,3.0322177822177823,23,26
"['1010', '110', '10000', '011001']",1,4,10,8,0,18,3.55021645021645,16,14
"['11110', '101', '00', '01010', '110']",1,5,8,10,4,18,5.223809523809524,24,23
"['010100', '00', '11101']",1,3,7,6,0,13,1.331168831168831,11,6
"['1101', '1000', '00', '100011', '001110', '01001']",1,6,15,12,4,27,8.544155844155844,45,36
"['01', '0001', '110001']",1,3,7,5,0,12,1.9666666666666668,8,11
"['011', '000011', '100', '10100', '11111', '0101']",1,6,12,14,4,26,7.711399711399711,44,42
"['010000', '0101110', '00011', '0001111', '1010', '000001', '001100', '0100011', '1011']",1,9,30,22,8,52,22.163641913641914,108,117
"['1101101', '001', '100010']",1,3,8,8,0,16,1.682051282051282,10,7
"['1011', '010011', '0100000', '01010']",1,4,13,9,0,22,3.8396270396270396,17,19
"['10101', '1001', '0100']",1,3,7,6,2,13,2.3055555555555554,5,6
"['11', '10011', '1010011']",1,3,5,9,0,14,1.8492063492063493,10,21
"['1011001', '0101', '001111', '0011010']",1,4,11,13,2,24,3.78981018981019,17,14
"['00', '0110111', '10', '11111']",1,4,5,11,2,16,2.1746031746031744,22,14
"['0010', '1001', '0000100']",1,3,11,4,2,15,2.0227272727272725,9,6
"['01', '11010', '1001', '0000', '111000']",1,5,12,9,2,21,5.35981240981241,28,24
"['101111', '1100000', '001110', '0111']",1,4,10,13,2,23,3.3995337995337995,22,15
"['1010111', '11011', '00000']",1,3,8,9,2,17,1.3666666666666667,11,6
"['11110', '0011', '111111', '1100110', '0000111', '01001', '110101']",1,7,15,25,6,40,12.208413808413809,64,76
"['1011', '110', '010110']",1,3,5,8,0,13,2.038095238095238,7,7
"['110', '10', '01000', '111']",1,4,6,7,2,13,3.1880952380952383,14,13
"['1', '100', '100011', '110', '110101']",1,5,8,11,4,19,5.349206349206349,31,32
"['1111100', '1010', '1100000', '0111']",1,4,10,12,4,22,3.071428571428571,24,17
"['10101', '1011', '00', '1']",1,4,5,7,0,12,2.526984126984127,16,14
"['010', '1', '1110000', '0110', '11101']",1,5,9,11,0,20,5.119264069264069,33,21
"['0', '0100111', '111', '1001010', '1100100', '1101', '1100']",1,7,15,18,5,33,11.307792207792208,71,62
"['00011', '11000', '1000', '0000', '010011']",1,5,16,8,4,24,6.693434343434343,23,44
"['1001110', '00100', '1100', '0']",1,4,10,7,0,17,2.6954545454545453,22,17
"['01', '011', '100', '0000101', '0100']",1,5,12,7,2,19,5.618470418470419,29,28
"['0010', '001', '00000', '101', '0011', '1110101', '11100']",1,7,17,14,6,31,11.681385281385282,60,64
"['0001100', '1000', '10', '11111', '1101', '1100', '0100101']",1,7,16,17,5,33,11.873737373737374,66,57
"['10001', '11010', '111001']",1,3,7,9,2,16,2.0545454545454547,8,11
"['1101', '111110', '1001', '11']",1,4,4,12,2,16,3.583333333333333,16,24
"['01', '00010', '1110010']",1,3,8,6,0,14,1.6825396825396823,11,9
"['11010', '0111', '11']",1,3,3,8,0,11,1.9047619047619047,8,11
"['0', '1001', '1000111', '010101', '0011100']",1,5,13,12,2,25,5.2034965034965035,40,19
"['111000', '100010', '1010111', '10011', '0110010', '000111', '11100', '01100']",1,8,23,24,8,47,18.22294372294372,87,91
"['101101', '01111', '111110', '10', '000111']",1,5,8,17,3,25,5.550865800865801,33,29
"['101100', '10100', '1101']",1,3,7,8,0,15,2.175757575757576,6,10
"['00111', '10', '01100']",1,3,6,6,2,12,1.457142857142857,10,7
"['001', '0010111', '0100110', '101011', '10', '000', '011111']",1,7,16,18,6,34,10.747924297924298,72,53
"['0', '0010', '010101', '0111']",1,4,8,7,2,15,2.9857142857142858,17,15
"['0000111', '1001', '011', '11']",1,4,7,9,0,16,3.627994227994228,18,19
"['0010110', '010100', '01', '010', '11', '1110011']",1,6,13,14,4,27,8.1004884004884,54,36
"['0011', '00', '0111010', '01100']",1,4,10,8,0,18,3.7279942279942277,19,25
"['1001001', '01', '1', '1011100']",1,4,8,9,2,17,2.484126984126984,26,16
"['1011010', '11', '100', '0110', '10']",1,5,8,10,2,18,5.820923520923521,27,24
"['0', '101', '00110', '1110001']",1,4,8,8,0,16,2.683333333333333,24,9
"['00111', '10101', '00010', '1']",1,4,8,8,3,16,2.8,19,11
"['0010111', '0100110', '010010', '00', '1100', '01011', '1110']",1,7,18,17,4,35,12.284854034854035,64,72
"['100', '10', '011', '1101100']",1,4,7,8,2,15,3.1777777777777776,19,16
"['010011', '1', '111011']",1,3,4,9,2,13,1.2380952380952381,12,11
"['001', '00011', '101', '0110', '1000111', '001110', '001010', '1010001', '111001']",1,9,24,23,7,47,23.255316905316906,109,96
"['1000', '100', '001000']",1,3,10,3,0,13,2.3238095238095235,6,15
"['0101101', '011100', '1', '1110']",1,4,7,11,0,18,3.0783716283716283,21,11
"['0', '0001000', '110011']",1,3,9,5,0,14,0.9972527472527473,16,4
"['10', '000', '11111', '11100', '0110110']",1,5,9,13,2,22,4.734920634920635,34,25
"['10111', '0110', '00', '10', '0111']",1,5,7,10,4,17,5.662698412698412,22,25
"['1010001', '00', '10', '11']",1,4,7,6,3,13,2.333333333333333,19,11
"['01101', '1001', '11']",1,3,4,7,0,11,1.6825396825396823,7,9
"['010000', '1', '110011', '1000', '1010', '011000']",1,6,16,11,5,27,8.407142857142857,45,35
"['111', '0110001', '1110']",1,3,5,9,0,14,2.0025974025974023,9,10
"['100110', '111', '00000']",1,3,8,6,0,14,0.9898989898989898,11,4
"['0', '001101', '10', '1110']",1,4,6,7,0,13,3.119047619047619,18,13
"['000110', '111100', '101', '000', '0111']",1,5,11,11,4,22,4.89047619047619,32,27
"['101100', '01', '0111010', '101010', '110100', '1000011', '01110']",1,7,19,20,5,39,12.550893550893552,69,58
"['1101001', '0010', '011', '1111']",1,4,7,11,2,18,3.0655844155844156,18,15
"['000110', '0010', '0011', '0100']",1,4,12,6,3,18,4.0,13,26
"['0110101', '011', '00111', '101000', '1101', '101110']",1,6,13,18,2,31,9.213114663114663,45,40
"['011', '0110', '000', '01010', '0111110']",1,5,11,11,2,22,6.544733044733045,25,45
"['01', '0010', '0011111']",1,3,6,7,0,13,1.6565656565656566,11,8
"['11', '1010', '010110', '110', '0111100']",1,5,9,13,0,22,6.21004551004551,28,25
"['110010', '10', '001101', '000']",1,4,10,7,2,17,3.4,20,15
"['000110', '11011', '111000']",1,3,8,9,2,17,1.5909090909090908,11,8
"['0', '10', '1110', '11001']",1,4,5,7,0,12,3.3047619047619046,15,12
"['10111', '1001', '11101']",1,3,4,10,2,14,1.9333333333333331,6,16
"['1110100', '00', '1', '0111110']",1,4,7,10,2,17,1.9603174603174602,27,12
"['0', '01', '0110', '11010']",1,4,6,6,0,12,3.3047619047619046,15,16
"['1001100', '100110', '101']",1,3,8,8,0,16,2.18974358974359,8,13
"['0', '100', '1110101', '110111', '01100', '1110']",1,6,10,16,0,26,8.11021201021201,49,37
"['0', '1111010', '110', '111']",1,4,4,10,2,14,2.6166666666666667,20,18
"['01', '1110', '11']",1,3,2,6,2,8,1.5,6,8
"['011', '1000', '11101', '0111', '0000', '00010', '1100']",1,7,16,13,6,29,10.844444444444445,54,63
"['010000', '10', '01000']",1,3,10,3,0,13,1.9805194805194803,8,14
"['0100010', '10', '111101', '1111']",1,4,7,12,0,19,2.749106449106449,23,17
"['111011', '110011', '1111010', '10', '010110', '001100']",1,6,13,20,4,33,9.05982905982906,49,39
"['0111010', '11', '0001', '1001', '110100', '00']",1,6,13,12,4,25,7.468725718725719,48,35
"['1011', '10010', '01010']",1,3,7,7,2,14,1.9333333333333331,6,7
"['1010111', '11110', '0101', '111']",1,4,5,14,0,19,3.593145743145743,17,24
"['01001', '010101', '1']",1,3,6,6,0,12,1.528138528138528,10,9
"['101', '100', '11']",1,3,3,5,2,8,1.8666666666666667,4,9
"['001111', '101', '1100100', '10', '1111011']",1,5,9,16,2,25,5.231684981684982,40,31
"['101', '011', '01011']",1,3,4,7,2,11,2.1666666666666665,6,9
"['01', '10111', '0000', '01100', '0111100']",1,5,12,11,2,23,5.050937950937951,33,31
"['1', '00101', '01000']",1,3,7,4,2,11,1.2666666666666666,11,5
"['010', '0011000', '1100100', '0111', '000000', '110101']",1,6,20,13,4,33,8.282606282606283,53,45
"['001101', '0011', '101000', '00', '000010']",1,5,16,8,3,24,5.633333333333333,32,39
"['111', '1001010', '1111000', '0011111', '011111', '1100', '0110001', '0100']",1,8,19,26,6,45,16.206077256077258,97,93
"['1110010', '001', '11', '11101', '000']",1,5,9,11,2,20,4.8658730158730155,31,28
"['00', '0011010', '11']",1,3,6,5,2,11,0.8888888888888888,12,6
"['0010', '001', '10', '11']",1,4,6,5,2,11,3.157142857142857,11,13
"['100', '100001', '1111110', '1101110']",1,4,9,14,2,23,3.293040293040293,22,18
"['0010', '011', '00101', '0111111', '0000110']",1,5,13,13,2,26,6.096464646464646,32,31
"['01', '101011', '1011101', '110011', '0001101', '100011']",1,6,14,20,5,34,9.295482295482296,48,60
"['11001', '11010', '1001', '0011100']",1,4,10,11,2,21,4.234343434343434,18,15
"['101011', '0011111', '1010011', '00010', '1010010']",1,5,15,17,3,32,6.543623043623044,26,37
"['1100010', '000110', '1', '01000']",1,4,12,7,0,19,2.8503996003996,24,13
"['1011', '10110', '00101', '1']",1,4,6,9,2,15,3.2222222222222223,17,17
"['011110', '0011', '00', '000010']",1,4,11,7,2,18,3.3666666666666667,19,24
"['01101', '100110', '00', '100100']",1,4,11,8,2,19,3.6774891774891776,18,17
"['001', '010', '0111010', '11', '0001', '0000101', '1010', '100000']",1,8,22,14,6,36,15.417421467421468,90,77
"['0010', '1000', '1', '0100']",1,4,9,4,3,13,3.45,15,13
"['0100001', '10011', '011000', '1101100']",1,4,14,11,2,25,3.822011322011322,19,13
"['00', '101110', '010110', '011000']",1,4,11,9,3,20,3.6666666666666665,20,23
"['11001', '1010', '011010']",1,3,7,8,0,15,2.193939393939394,8,7
"['11', '11000', '0010101', '011001', '1101']",1,5,11,13,0,24,5.883472083472084,29,33
"['0', '1010', '000111']",1,3,6,5,0,11,1.0857142857142859,12,6
"['11', '0011', '0001', '10100', '1011100', '0101', '0011100']",1,7,17,16,5,33,12.312409812409811,62,67
"['1110001', '10001', '0']",1,3,7,6,0,13,1.4166666666666667,12,8
"['100100', '1', '0111110', '10010']",1,4,9,10,0,19,2.5858308358308357,24,15
"['01101', '011100', '1010100', '1100000', '1000', '010111']",1,6,19,16,4,35,8.717504717504717,48,44
"['1001110', '00', '0010010', '10']",1,4,11,7,4,18,2.992063492063492,24,20
"['000110', '01', '00101', '11']",1,4,8,7,2,15,3.37012987012987,18,12
"['110111', '110', '011']",1,3,3,9,2,12,2.0,8,12
"['100', '1', '10010']",1,3,5,4,0,9,1.5833333333333333,8,8
"['0101000', '0010111', '11', '1101101', '1001', '10100', '101110']",1,7,17,21,3,38,12.894538794538795,70,55
"['1110', '110', '000', '11']",1,4,5,7,2,12,2.9428571428571426,12,17
"['0010', '11', '0001', '10010', '110']",1,5,10,8,2,18,5.700793650793651,22,26
"['10000', '1', '1111110', '01000']",1,4,9,9,2,18,2.3833333333333333,26,12
"['0010', '101101', '1001', '0011010', '00110', '0101100', '0111']",1,7,19,18,5,37,14.598129648129648,52,58
"['1000100', '010', '1', '0011000', '0011']",1,5,14,8,2,22,5.015584415584415,37,25
"['00111', '10000', '010010', '00', '0100100']",1,5,17,8,2,25,6.016439116439116,31,40
"['1011110', '00111', '100', '1000', '000', '00010', '110']",1,7,17,13,5,30,12.05894660894661,58,72
"['111111', '010', '11101', '1010010']",1,4,7,14,0,21,3.011033411033411,21,16
"['101', '100100', '110', '011']",1,4,7,8,3,15,3.5555555555555554,16,14
"['10100', '001', '1011001', '111100']",1,4,10,11,0,21,3.8742812742812744,18,20
"['00111', '101', '10110']",1,3,5,8,2,13,1.85,7,8
"['001', '0101011', '0010011', '1000', '110111', '0101100']",1,6,17,17,3,34,8.737950937950938,50,44
"['0001', '1101101', '1111000', '1110100', '10', '00010', '1110', '0111100']",1,8,20,23,6,43,15.248556998556998,99,83
"['11000', '0010', '10', '111']",1,4,7,7,0,14,2.8682539682539683,16,14
"['00', '001', '00101', '111']",1,4,7,6,2,13,2.954761904761905,14,17
"['010', '001111', '11', '10001', '1111000']",1,5,10,13,0,23,5.087823287823288,39,26
"['0001001', '11010', '010101', '1']",1,4,10,9,0,19,2.8655511155511157,23,13
"['110000', '0001110', '10101', '1001', '100010', '10', '110111']",1,7,18,18,3,36,12.796370296370297,65,58
"['01100', '0111101', '1', '0110111']",1,4,7,13,2,20,2.738095238095238,24,17
"['00111', '100000', '0110100', '11']",1,4,11,9,0,20,2.7577145077145078,24,15
"['0', '100110', '11011']",1,3,5,7,0,12,1.3463203463203464,11,4
"['110000', '0010', '1000', '010']",1,4,12,5,2,17,3.8230158730158728,14,20
"['001', '1101', '100110', '01001', '000100', '1110']",1,6,15,13,4,28,8.956132756132757,41,37
"['011011', '110', '01111', '000']",1,4,7,10,2,17,3.1035353535353534,17,17
"['11', '1000', '01111', '011001']",1,4,7,10,0,17,2.954256854256854,19,16
"['1101', '1000', '10110']",1,3,6,7,2,13,1.8333333333333333,7,7
"['001100', '01000', '11']",1,3,8,5,0,13,1.512987012987013,10,6
"['0010', '100', '00010', '10011']",1,4,11,6,2,17,3.976984126984127,12,18
"['101', '010', '1011000']",1,3,7,6,2,13,1.8666666666666667,10,6
"['0', '101', '1111010']",1,3,4,7,0,11,1.35,12,4
"['11', '1101011', '1010', '0011111', '001100']",1,5,10,16,2,26,5.548662448662449,39,30
"['1110010', '0100110', '10011', '1010101']",1,4,12,14,3,26,4.333333333333333,17,13
"['00111', '1010', '110', '111010']",1,4,7,11,0,18,3.527994227994228,16,21
"['101', '110010', '011100', '11111']",1,4,7,13,2,20,3.3686868686868685,19,12
"['1010', '000111', '0011010']",1,3,9,8,0,17,1.8965034965034966,10,10
"['0111010', '101', '100000', '10', '0001000']",1,5,16,9,2,25,5.281684981684982,37,26
"['000110', '0011', '10000', '10100', '11101', '1010']",1,6,16,13,5,29,8.691919191919192,37,42
"['11110', '011', '00', '100011', '001010', '1011', '110']",1,7,13,16,4,29,11.224891774891775,59,58
"['011111', '0111101', '001', '111']",1,4,5,14,2,19,3.3675213675213675,18,21
"['010100', '011', '10']",1,3,6,5,0,11,1.5666666666666667,9,7
"['1001', '011', '11']",1,3,3,6,0,9,2.038095238095238,5,10
"['11011', '001101', '11']",1,3,4,9,0,13,1.7987012987012987,10,12
"['101001', '1010', '0010', '01010']",1,4,11,8,2,19,4.432828282828282,11,20
"['01', '010001', '00101', '11', '10001', '0111111', '0000']",1,7,16,15,4,31,10.654323454323453,68,56
"['1010110', '001010', '0010', '0100']",1,4,13,8,2,21,4.238111888111888,14,27
"['101', '0011', '111010']",1,3,5,8,0,13,1.638095238095238,9,7
"['00', '010', '0010101']",1,3,8,4,0,12,1.8444444444444446,10,10
"['00', '000010', '110111', '1001011']",1,4,11,10,2,21,2.9123931623931623,23,12
"['00001', '0000', '11']",1,3,8,3,0,11,1.1746031746031744,9,10
"['0010001', '1', '0110111', '10011', '0000', '1011']",1,6,14,14,4,28,6.736580086580086,54,37
"['1101000', '00110', '10', '01011', '011000']",1,5,14,11,2,25,5.929259629259629,33,30
"['0000', '01', '0011101', '0100']",1,4,11,6,2,17,2.8535353535353534,19,21
"['001110', '1011011', '1']",1,3,5,9,0,14,1.151098901098901,14,4
"['1110010', '00101', '101', '1010100', '10011', '000', '011001']",1,7,19,17,6,36,13.21991896991897,61,54
"['0010', '01', '11', '00111', '000101']",1,5,10,9,2,19,5.836796536796537,26,25
"['010', '11', '1000', '10010', '001010', '0110110']",1,6,15,12,0,27,9.034815184815185,43,43
"['01101', '101101', '10001', '110001', '1111', '0111110']",1,6,12,21,4,33,9.454700854700855,43,51
"['11011', '1001', '001110', '000', '0101']",1,5,11,11,2,22,5.888311688311688,28,19
"['11', '101', '00', '0010010', '0000110']",1,5,13,8,4,21,4.692063492063492,36,22
"['10001', '100', '010111']",1,3,7,7,0,14,1.7398989898989898,9,8
"['1000010', '11110', '11100', '11']",1,4,8,11,2,19,3.2206349206349207,20,19
"['0001101', '01011', '01101', '10']",1,4,9,10,2,19,3.8873015873015873,18,17
"['0101', '100010', '10', '11']",1,4,7,7,2,14,3.433333333333333,16,14
"['10001', '1101101', '0001']",1,3,8,8,0,16,1.9191919191919191,8,13
"['00110', '001110', '1', '00101']",1,4,9,8,2,17,3.3887445887445886,18,19
"['100110', '10001', '01101', '1011']",1,4,9,11,2,20,4.1878787878787875,15,19
"['0', '11000', '0001', '000101']",1,4,11,5,0,16,3.031168831168831,21,20
"['00', '10001', '110', '1110']",1,4,7,7,0,14,3.1063492063492064,15,13
"['01', '010000', '011100', '1011', '1110', '0111100']",1,6,14,15,4,29,8.622299922299922,47,45
"['1000', '00', '010', '11']",1,4,7,4,2,11,2.7714285714285714,12,12
"['0', '1011011', '11101']",1,3,4,9,0,13,1.4166666666666667,12,5
"['010', '1000110', '100', '0011110', '10001', '000', '1100']",1,7,19,13,5,32,13.205194805194806,61,64
"['0', '11000', '10010', '0010101']",1,4,11,7,2,18,2.8833333333333333,23,13
"['01', '010', '00011', '011011', '00', '010111']",1,6,12,12,4,24,9.182251082251081,40,45
"['1010', '1111101', '1001111']",1,3,5,13,2,18,1.6623376623376622,11,12
"['0011001', '110', '00000']",1,3,10,5,0,15,1.5166666666666666,11,8
"['000110', '011101', '10', '0111', '1011000', '01100']",1,6,15,15,2,30,9.146642246642246,47,45
"['010', '1', '001101', '000', '1110']",1,5,9,8,2,17,4.642857142857142,28,21
"['0010', '111', '11101', '100101', '0111', '1100']",1,6,10,16,3,26,9.136002886002887,36,47
"['001', '0101110', '00111', '1001', '0110001']",1,5,13,13,2,26,6.26948051948052,31,27
"['1111100', '10', '0100100']",1,3,8,8,2,16,1.3174603174603174,13,8
"['01', '010000', '1010', '11101', '110', '01011']",1,6,12,13,2,25,8.417821067821068,41,37
"['0101010', '000110', '01110']",1,3,10,8,0,18,2.0093240093240095,6,17
"['11110', '0101000', '11111', '11101', '10', '011001', '00010', '0011100', '110101']",1,9,21,27,8,48,20.863314463314463,111,96
"['101100', '01', '010', '0011', '11000', '00100', '001110']",1,7,18,13,4,31,12.761399711399712,57,70
"['0', '1100010', '01111', '001010', '11111', '1011']",1,6,11,17,2,28,6.668270618270618,54,41
"['1000101', '111', '001000']",1,3,9,7,0,16,1.4376068376068376,13,4
"['110011', '0011', '011', '1111']",1,4,5,12,2,17,4.195238095238095,12,31
"['0011', '00', '100', '0111']",1,4,7,6,2,13,3.407142857142857,13,18
"['1001100', '100', '010101']",1,3,9,7,0,16,1.882051282051282,11,10
"['1011', '0011', '100000']",1,3,8,6,2,14,1.55,9,10
"['0', '0001011', '110', '111101']",1,4,7,10,0,17,2.5639194139194137,25,13
"['0', '01', '1110010']",1,3,5,5,0,10,1.3611111111111112,12,6
"['01', '11', '0100010', '10001', '0000', '0000111', '1010011']",1,7,20,14,5,34,11.437229437229437,72,52
"['1000010', '1001101', '11']",1,3,8,8,2,16,1.6031746031746033,13,10
"['01', '10100', '00', '1101110']",1,4,8,8,2,16,3.198412698412698,20,14
"['11', '1001', '111011', '000', '01110']",1,5,8,12,0,20,4.803463203463203,32,20
"['01', '00101', '11', '101', '100']",1,5,7,8,4,15,5.95952380952381,19,28
"['001100', '1001', '110', '1111']",1,4,7,10,2,17,3.3095238095238093,17,12
"['0001101', '100011', '1', '001010']",1,4,11,9,2,20,3.0265567765567765,25,11
"['0', '0100010', '1011011']",1,3,8,7,2,15,1.0714285714285714,16,4
"['10100', '001101', '11']",1,3,6,7,0,13,1.6168831168831168,10,7
"['01', '100000', '10']",1,3,7,3,2,10,1.25,11,7
"['11011', '011', '1001011', '0000']",1,4,9,10,0,19,3.2367243867243864,19,19
"['1100111', '000100', '1']",1,3,7,7,0,14,0.9972527472527473,15,4
"['110000', '1', '110100']",1,3,7,6,2,13,1.4047619047619047,11,9
"['00101', '10001', '1101000', '1000110', '1010111', '00', '00010']",1,7,22,16,6,38,12.938095238095238,69,57
"['0001011', '0001', '101110', '000']",1,4,12,8,0,20,3.6442446442446443,20,23
"['101100', '01', '0010', '11', '01111', '0001111']",1,6,11,15,2,26,7.761971361971362,49,40
"['1100011', '0110000', '1']",1,3,8,7,2,15,1.2142857142857144,15,4
"['0110101', '0101110', '1', '0100010', '10011']",1,5,13,14,3,27,4.773809523809524,39,21
"['010', '100', '11']",1,3,4,4,2,8,1.4666666666666668,6,4
"['0', '101', '10000']",1,3,6,3,0,9,1.3333333333333333,9,5
"['101100', '001', '11']",1,3,5,6,0,11,1.3444444444444446,10,7
"['10000', '11010', '111']",1,3,6,7,2,13,1.6,8,8
"['1110010', '0101110', '0110111', '0001', '100', '0110']",1,6,15,17,5,32,8.372727272727273,51,44
"['11001', '111', '0011', '100', '0110']",1,5,8,11,4,19,6.2023809523809526,23,24
"['0', '0011', '0111111', '010']",1,4,6,9,0,15,2.666883116883117,22,16
"['00101', '1001010', '00011', '10001', '100', '10101', '1000111', '1110']",1,8,21,20,6,41,18.23924963924964,72,93
"['00', '11011', '001110', '0100']",1,4,9,8,0,17,2.842279942279942,20,17
"['101100', '101', '0011110', '100111', '000']",1,5,12,13,4,25,5.6068376068376065,33,25
"['1001001', '10001', '101']",1,3,8,7,0,15,2.1833333333333336,8,20
"['1101', '0111010', '01011']",1,3,6,10,0,16,1.893939393939394,8,6
"['0010', '01101', '110010', '000011', '00001', '10110', '1100100', '0011111', '10', '0111110']",1,10,27,27,8,54,25.19161394161394,151,133
"['0011', '100', '00', '10011', '1010011', '1100011', '1011111']",1,7,15,20,3,35,13.435714285714285,66,86
"['01111', '01', '110']",1,3,3,7,0,10,1.4714285714285715,8,8
"['0', '101', '01011']",1,3,4,5,0,9,1.5833333333333333,8,4
"['001011', '10001', '11100', '10']",1,4,9,9,2,18,3.151948051948052,20,15
"['0010110', '0010000', '110100', '1010', '0111', '110']",1,6,17,14,4,31,8.654578754578754,47,47
"['110011', '10100', '100001', '1110']",1,4,10,11,2,21,3.3838383838383836,16,17
"['1', '1100010', '1001', '10000', '1000010']",1,5,15,9,2,24,5.878354978354978,32,34
"['10111', '01', '0111101', '00110']",1,4,7,12,2,19,3.5206349206349206,19,12
"['0', '100011', '11111']",1,3,4,8,0,12,0.6493506493506493,13,6
"['0001101', '11011', '111011']",1,3,6,12,0,18,2.191142191142191,9,15
"['010011', '100', '000', '011010']",1,4,11,7,4,18,3.6111111111111107,15,17
"['0', '0101', '0011111']",1,3,5,7,0,12,1.1954545454545453,13,6
"['0', '0001101', '11']",1,3,5,5,0,10,0.6944444444444444,13,4
"['1011', '1000', '010010', '000']",1,4,11,6,2,17,3.7095238095238097,14,15
"['0', '0101110', '01110', '101101']",1,4,8,11,0,19,3.198884448884449,23,17
"['1111110', '0110', '10', '101111']",1,4,5,14,0,19,3.371950271950272,20,18
"['0', '0010', '10110', '1111']",1,4,6,8,2,14,2.0944444444444446,18,11
"['000110', '1100', '10']",1,3,7,5,0,12,1.7666666666666666,10,8
"['101', '10110', '011', '1110']",1,4,5,10,2,15,4.198412698412699,11,17
"['00100', '01', '000']",1,3,8,2,0,10,1.7214285714285715,7,12
"['11110', '001', '1110100', '000', '1011']",1,5,10,12,2,22,4.48037518037518,31,27
"['011111', '010101', '11100']",1,3,6,11,2,17,1.7575757575757573,8,9
"['010', '01101', '01001', '0111011']",1,4,9,11,2,20,4.4,14,21
"['1010', '100101', '0010', '0000']",1,4,12,6,3,18,4.0,11,15
"['0', '10111', '0010', '110']",1,4,6,7,0,13,2.749206349206349,17,12
"['00001', '10001', '100', '0010100', '010101', '1011']",1,6,18,12,2,30,9.204800754800754,39,43
"['1100111', '01111', '110001', '100000']",1,4,11,13,2,24,3.1095571095571097,20,22
"['00001', '101011', '11001', '001000']",1,4,13,9,4,22,3.2818181818181817,15,16
"['0', '001100', '11001']",1,3,7,5,0,12,1.3463203463203464,12,4
"['00100', '11101', '11']",1,3,5,7,2,12,1.2571428571428571,10,6
"['11110', '1', '10000']",1,3,5,6,2,11,1.0666666666666667,11,6
"['110010', '011', '00011', '110001', '110']",1,5,11,12,4,23,6.244949494949495,30,36
"['0010', '10001', '10110', '11']",1,4,8,8,2,16,3.4095238095238094,17,12
"['111', '011100', '000', '110', '01011', '1110', '0100']",1,7,13,15,5,28,11.462914862914863,48,65
"['1101001', '01101', '000']",1,3,8,7,0,15,1.5666666666666667,10,5
"['11', '011101', '011001', '1011', '0100']",1,5,9,13,4,22,5.933333333333334,28,25
"['0', '11000', '11101', '1111']",1,4,5,10,2,15,2.5999999999999996,18,17
"['11001', '00000', '11', '0001', '0000111', '1010010']",1,6,18,12,4,30,8.052958152958153,50,47
"['1010110', '0010', '1000110', '10', '0111']",1,5,12,12,4,24,5.609668109668109,31,31
"['010', '101101', '0001', '100', '1111000', '0100011', '0110011']",1,7,19,18,5,37,12.942857142857143,71,55
"['110010', '010001', '110', '0111']",1,4,9,10,2,19,3.549206349206349,19,18
"['1000001', '101', '1110100', '000', '00010', '1001011']",1,6,19,13,5,32,8.53095238095238,51,39
"['1000', '000101', '1']",1,3,7,4,0,11,1.2857142857142856,11,8
"['01101', '111100', '0111011', '11']",1,4,6,14,0,20,3.51004551004551,20,19
"['0101000', '0011', '0001', '1100', '01011']",1,5,14,10,3,24,6.012626262626262,28,34
"['101', '00101', '111']",1,3,4,7,2,11,1.9166666666666665,6,10
"['0111011', '10', '101110', '01010']",1,4,8,12,0,20,3.679043179043179,20,17
"['001', '0101110', '011', '101', '100110', '0000', '0001011']",1,7,18,15,5,33,12.514485514485514,63,54
"['001100', '0001', '111']",1,3,7,6,0,13,1.33015873015873,10,6
"['1011010', '1110011', '100', '010010', '0000', '0101001']",1,6,19,15,3,34,8.756976356976358,48,35
"['101', '10', '0111011']",1,3,4,8,0,12,1.8444444444444446,10,7
"['100110', '001010', '10', '11']",1,4,8,8,4,16,3.3333333333333335,19,14
"['010', '00101', '00', '100011', '0011111', '1100']",1,6,14,13,0,27,8.565817515817516,49,41
"['101', '01001', '01110']",1,3,6,7,2,13,1.85,8,6
"['0', '101100', '11110', '000001']",1,4,10,8,2,18,2.1471861471861473,25,13
"['11010', '011011', '101', '100100', '1110']",1,5,10,14,2,24,6.275974025974026,25,25
"['0101', '100000', '0110', '01000']",1,4,13,6,2,19,3.6106060606060604,16,20
"['0', '001100', '1010100']",1,3,9,5,0,14,1.304945054945055,13,11
"['01', '100110', '1101']",1,3,5,7,0,12,1.7666666666666666,9,7
"['0100110', '101', '1000111', '00', '1110']",1,5,11,12,2,23,5.180663780663781,35,21
"['101100', '01', '1', '10000']",1,4,8,6,0,14,2.6168831168831166,20,14
"['1101001', '11', '100', '0101100', '0000', '1110']",1,6,14,13,4,27,7.119841269841269,49,37
"['1100011', '100', '10000']",1,3,9,6,0,15,2.0166666666666666,9,9
"['0101101', '0011', '10101', '1111', '0001100', '00', '1011', '11100']",1,8,17,21,7,38,16.01017316017316,80,83
"['101100', '0010010', '000111', '10000']",1,4,15,9,2,24,3.488344988344988,19,20
"['100', '1000010', '1000', '110111', '1110']",1,5,12,12,2,24,5.525463425463426,31,32
"['1101000', '100000', '0010100', '111']",1,4,14,9,2,23,3.0134310134310134,22,18
"['0100010', '010001', '1111011']",1,3,10,10,2,20,1.8131868131868132,9,9
"['101100', '1101011', '100010', '100011', '0000', '1110']",1,6,17,16,5,33,8.559090909090909,45,43
"['101010', '100', '10000', '1001101', '1000010', '01110', '0000110', '1001011']",1,8,27,20,6,47,17.18999333999334,83,93
"['11', '00111', '01111', '000', '01010', '0110001']",1,6,13,14,3,27,8.092063492063492,46,40
"['101011', '1', '10110', '001000']",1,4,9,9,2,18,2.6774891774891776,22,12
"['11000', '101000', '1001', '111111', '10011', '0000']",1,6,15,15,6,30,7.881818181818182,43,51
"['0', '11011', '010001']",1,3,6,6,0,12,1.1645021645021645,12,4
"['101100', '001', '011', '10000', '110', '111001']",1,6,13,13,5,26,8.396464646464645,43,39
"['1011010', '0101', '10000', '00011']",1,4,12,9,2,21,3.423232323232323,18,15
"['01', '01101', '11010', '10111', '00110', '110']",1,6,10,15,4,25,9.635714285714286,37,38
"['0011011', '00', '010101']",1,3,8,7,0,15,1.7136752136752138,12,8
"['0110010', '1', '11010']",1,3,6,7,0,13,1.4166666666666667,12,6
"['11001', '00010', '00101']",1,3,9,6,3,15,2.0,8,6
"['01', '10010', '0110', '11']",1,4,6,7,2,13,3.4206349206349205,13,12
"['11110', '100', '100111', '1011', '1101', '111000']",1,6,10,18,4,28,9.01002886002886,41,54
"['0010001', '0110', '01011']",1,3,9,7,0,16,1.8787878787878787,9,7
"['00', '0110111', '111']",1,3,4,8,0,12,1.0444444444444443,12,8
"['101', '100', '1101111', '1000111']",1,4,7,13,4,20,3.5809523809523807,20,25
"['0111', '0', '110100', '11']",1,4,5,8,0,13,2.2523809523809524,20,15
"['001', '111', '011001', '0001010', '111000']",1,5,13,12,4,25,5.521367521367521,34,28
"['101000', '1000', '100']",1,3,9,4,0,13,2.3238095238095235,6,15
"['1100011', '1', '0001000', '00000']",1,4,14,6,2,20,2.4047619047619047,28,16
"['101', '001', '110100', '00000']",1,4,11,6,2,17,2.8914141414141414,18,16
"['101', '100001', '010110']",1,3,8,7,2,15,1.8333333333333333,10,6
"['11110', '1010', '000111', '000']",1,4,9,9,0,18,2.877994227994228,19,19
"['00111', '000110', '00110', '1011000']",1,4,13,10,2,23,4.2184149184149184,15,27
"['0', '0001', '00011']",1,3,7,3,0,10,1.6222222222222222,8,9
"['01101', '1011010', '001']",1,3,7,8,0,15,1.7333333333333334,8,7
"['101', '100', '1', '000010']",1,4,8,5,2,13,2.841269841269841,18,12
"['1111100', '01', '111', '101011', '1001', '00']",1,6,9,15,2,24,7.169019869019869,49,41
"['10', '111', '000000']",1,3,7,4,0,11,0.65,13,4
"['0', '11110', '001101']",1,3,5,7,0,12,1.1645021645021645,12,6
"['10110', '100010', '0000010', '0111', '1011', '0100']",1,6,17,13,3,30,8.674786324786325,44,42
"['11001', '0100110', '011', '001000', '11000']",1,5,15,11,2,26,6.21973581973582,30,28
"['0110000', '010', '011']",1,3,8,5,2,13,1.8666666666666667,9,12
"['0100011', '100011', '0100100']",1,3,12,8,2,20,2.2527472527472527,8,12
"['1101', '0111010', '11']",1,3,4,9,0,13,1.8383838383838382,10,6
"['10101', '0011110', '1001', '110111', '101110']",1,5,10,18,2,28,6.640170940170941,28,28
"['0100001', '10100', '00010', '0100']",1,4,15,6,2,21,4.2161616161616156,15,22
"['10101', '110', '01111', '0110001']",1,4,8,12,2,20,3.533333333333333,18,16
"['11001', '101', '0']",1,3,4,5,0,9,1.5833333333333333,8,5
"['00', '011', '10000', '0010101']",1,4,11,6,0,17,2.765873015873016,22,17
"['0010110', '00', '110', '11100']",1,4,9,8,0,17,3.4325396825396823,20,22
"['1101', '10101', '10', '01100']",1,4,7,9,2,16,3.742857142857143,14,13
"['101', '001', '000', '0100']",1,4,9,4,3,13,3.380952380952381,9,16
"['0010', '1', '01100']",1,3,6,4,0,10,1.1777777777777778,9,5
"['00001', '110001', '0011010', '10', '0110110']",1,5,15,12,2,27,5.323121323121323,37,25
"['1011001', '011', '100111', '0000010', '10', '0100']",1,6,16,13,2,29,8.214729714729714,54,33
"['100', '0110', '0010101', '10011', '000010', '0000']",1,6,19,10,2,29,9.23046398046398,41,46
"['0010110', '1001100', '0']",1,3,9,6,2,15,1.2142857142857144,15,9
"['111100', '011', '0011', '101', '100', '0000', '0100']",1,7,15,12,6,27,11.265079365079364,53,63
"['0001', '1', '0100110']",1,3,7,5,0,12,1.3772727272727274,12,4
"['110', '00000', '111100']",1,3,8,6,0,14,1.2803030303030303,11,9
"['0110101', '010', '10', '110', '001011']",1,5,10,11,2,21,6.291452991452991,29,25
"['0010', '100', '1111']",1,3,5,6,2,11,1.1071428571428572,8,5
"['0011', '10001', '01111']",1,3,6,8,2,14,1.7333333333333334,8,7
"['001', '100001', '111', '0111', '1100011', '1011']",1,6,11,16,4,27,9.007831057831057,41,61
"['01', '0110111', '11']",1,3,3,8,2,11,1.3888888888888888,11,9
"['0010001', '01', '001', '011100', '101101', '1110011']",1,6,15,16,4,31,8.63125763125763,52,40
"['000110', '01', '011110']",1,3,7,7,2,14,1.6666666666666665,10,11
"['1011', '1010', '00101', '01100']",1,4,9,9,4,18,3.8166666666666664,13,13
"['001111', '101101', '10111', '0001', '1111010', '000', '1100', '1001011']",1,8,18,24,6,42,15.948523698523699,84,87
"['0010', '1', '1110']",1,3,4,5,2,9,1.3,8,5
"['011', '01001', '1101011', '0010100']",1,4,11,11,2,22,3.8547619047619044,20,14
"['1011010', '101', '1110100']",1,3,7,10,2,17,2.057142857142857,10,8
"['100', '000', '1001010']",1,3,9,4,2,13,1.8666666666666667,9,10
"['01101', '1', '00001', '10101', '11100']",1,5,10,11,4,21,4.333333333333333,30,27
"['11110', '01', '0011001', '00111', '101011', '1101011', '00']",1,7,14,20,6,34,11.292862692862693,71,62
"['110010', '11110', '1001010', '1110101', '1000', '1010011', '0101', '1100']",1,8,20,24,6,44,17.653074703074704,75,83
"['1111', '01', '01110', '0100']",1,4,6,9,2,15,3.1547619047619047,15,13
"['0', '10', '1011111']",1,3,3,7,0,10,1.3611111111111112,12,5
"['000110', '11', '110100', '00', '011001']",1,5,12,10,5,22,4.833333333333333,36,25
"['001100', '01011', '1111']",1,3,6,9,0,15,1.5717171717171716,9,6
"['0110100', '111', '00110', '10010', '101001']",1,5,13,13,2,26,6.441958041958042,30,19
"['1011101', '1000', '10', '000000', '011111']",1,5,13,12,2,25,4.2001554001554,41,25
"['01', '010001', '000001']",1,3,10,4,2,14,1.8333333333333335,9,12
"['010', '100111', '111010', '11']",1,4,6,11,2,17,3.011111111111111,21,18
"['011', '0001', '0010100', '1010', '1101']",1,5,12,10,3,22,5.882467532467532,27,22
"['0110', '0110111', '0100']",1,3,7,8,2,15,2.0227272727272725,8,13
"['1010100', '1110011', '0011111', '0100100', '1011', '01110']",1,6,16,21,4,37,8.831168831168831,53,41
"['0101', '00', '000111']",1,3,7,5,0,12,1.7666666666666666,9,8
"['0011', '1000', '0101111', '00010']",1,4,11,9,2,20,3.4242424242424243,19,17
"['0', '11010', '0011000', '1000', '1100110', '1010001', '1111111']",1,7,18,20,4,38,10.608874458874459,83,50
"['10101', '010101', '0001', '11']",1,4,8,9,0,17,3.1582972582972584,15,20
"['0000010', '0100101', '111']",1,3,10,7,2,17,1.5142857142857142,13,4
"['0001010', '00100', '1']",1,3,9,4,0,13,1.4166666666666667,12,6
"['01001', '1', '00101']",1,3,6,5,2,11,1.4666666666666668,10,7
"['001101', '101', '10', '10000']",1,4,9,7,0,16,3.5835497835497834,18,18
"['00', '10', '01000']",1,3,7,2,2,9,1.6428571428571428,7,10
"['10111', '10001', '10', '11']",1,4,5,9,4,14,3.3857142857142857,15,23
"['101', '000111', '1']",1,3,4,6,0,10,1.2301587301587302,11,8
"['10101', '1', '1001111']",1,3,4,9,0,13,1.25,13,13
"['11001', '11000', '00', '1011', '1100']",1,5,10,10,4,20,6.109523809523809,22,35
"['101000', '000111', '110100']",1,3,10,8,3,18,1.6666666666666667,11,11
"['0101', '001', '0100']",1,3,7,4,2,11,1.8928571428571428,4,10
"['0', '101', '00110', '11101']",1,4,6,8,2,14,3.0166666666666666,18,10
"['01001', '010001', '101110', '01000']",1,4,13,9,4,22,4.209090909090909,14,24
"['101', '0001101', '1000', '10', '0000', '1110110']",1,6,15,12,4,27,8.2492784992785,50,44
"['1010110', '010', '111100', '0000']",1,4,11,9,0,20,3.3305583305583304,21,17
"['0100001', '1', '000', '111001']",1,4,10,7,0,17,2.1955433455433457,25,12
"['1001', '0000110', '000001', '1']",1,4,12,6,0,18,2.8503996003996006,23,15
"['110000', '11001', '11011', '1', '000100']",1,5,12,11,4,23,4.71991341991342,35,32
"['110001', '100011', '011010']",1,3,9,9,3,18,2.0,9,5
"['010', '1100100', '010000', '111']",1,4,11,8,2,19,3.0376068376068375,20,15
"['110010', '01101', '1110000', '101101', '001011', '01000', '0100']",1,7,21,18,5,39,13.35998445998446,60,59
"['00111', '100000', '0110', '1111101']",1,4,10,12,0,22,2.7834498834498835,23,13
"['0111101', '010', '101101']",1,3,6,10,0,16,2.0358974358974358,9,8
"['0010', '1011001', '0000001']",1,3,12,6,2,18,1.6623376623376622,11,7
"['01', '10100', '1101111', '10']",1,4,6,10,2,16,3.0317460317460316,22,13
"['0010', '11', '101', '10000', '1101']",1,5,9,9,2,18,5.625396825396825,24,26
"['01', '10', '1011000', '01011', '1001111']",1,5,10,13,4,23,5.325396825396825,39,25
"['0', '11011', '000011', '010010', '0100']",1,5,13,9,2,22,4.706782106782106,33,27
"['0101111', '111', '10111', '0011', '0001', '001010', '1100']",1,7,14,19,3,33,11.777289377289378,60,66
"['0010110', '1000111', '00', '000001', '10']",1,5,15,9,4,24,4.818986568986569,39,25
"['11001', '01', '1']",1,3,3,5,0,8,1.5714285714285714,8,9
"['1111100', '001010', '011001']",1,3,9,10,2,19,1.576923076923077,11,7
"['0', '11', '100', '1011000']",1,4,7,6,0,13,2.1944444444444446,21,12
"['11', '00100', '0110', '10', '000']",1,5,10,6,2,16,5.078571428571428,23,25
"['1011', '010011', '1011011']",1,3,6,11,0,17,2.1426573426573428,7,18
"['0', '11110', '0010111', '011100', '00110']",1,5,11,13,2,24,5.038977688977689,36,34
"['011101', '0101', '001']",1,3,6,7,0,13,1.8158730158730159,6,11
"['11100', '011', '1111']",1,3,3,9,0,12,1.7380952380952381,7,13
"['000111', '011', '11']",1,3,4,7,0,11,1.9666666666666668,8,11
"['001000', '0100', '0000']",1,3,12,2,2,14,1.9,5,22
"['000110', '01101', '100101', '10', '000100']",1,5,15,10,3,25,6.238095238095238,29,26
"['10111', '100100', '00000']",1,3,10,6,2,16,1.4727272727272727,9,7
"['1000010', '1001', '11']",1,3,7,6,0,13,1.8383838383838382,10,10
"['01', '000101', '10011', '01001', '01011']",1,5,12,11,3,23,6.796103896103896,24,29
"['1001110', '1011001', '101101', '100', '0000', '0000111', '1010010', '1100', '0100']",1,9,27,22,7,49,22.48839493839494,111,108
"['01', '0100111', '10011', '1011', '1101']",1,5,8,14,2,22,6.579004329004329,26,36
"['0', '011111', '111']",1,3,2,8,0,10,0.9523809523809523,11,8
"['1', '10000', '000']",1,3,7,2,0,9,1.0833333333333333,9,8
"['01', '01101', '111', '0100', '111001']",1,5,8,12,0,20,5.834415584415584,26,28
"['00', '110', '10', '11']",1,4,4,5,3,9,3.0,8,13
"['0', '011100', '11']",1,3,4,5,0,9,0.7857142857142857,11,4
"['0111000', '01', '001101', '1100010', '110001', '0111101', '111001']",1,7,19,22,6,41,13.282051282051283,66,66
"['1010', '0110', '0111']",1,3,5,7,3,12,1.75,6,9
"['010100', '11010', '00', '10', '000111']",1,5,12,9,4,21,5.165584415584416,33,29
"['001001', '10010', '1011111']",1,3,8,10,0,18,1.6888111888111887,11,7
"['00110', '01', '000']",1,3,7,3,0,10,1.7214285714285715,7,10
"['0', '10010', '11']",1,3,4,4,0,8,0.9047619047619047,9,4
"['110000', '1011010', '1000101', '1001000', '0000000', '0011111', '0111', '01110']",1,8,28,22,5,50,14.956721056721056,100,82
"['111010', '0011001', '1011101', '00', '0101100', '0110001']",1,6,18,18,4,36,9.618437118437118,52,38
"['0', '11110', '0111']",1,3,3,7,0,10,1.4,9,8
"['0101111', '0101110', '1001010', '101', '101001']",1,5,13,17,3,30,6.455677655677656,33,29
"['00100', '1100001', '0010', '011100']",1,4,14,8,0,22,3.677000777000777,18,20
"['0100001', '0100110', '0000']",1,3,13,5,2,18,1.987012987012987,9,11
"['010', '1000000', '1010', '0111', '1010001', '0110001']",1,6,19,13,5,32,8.801298701298702,51,43
"['0', '01', '1101']",1,3,3,4,0,7,1.7333333333333334,6,5
"['0001110', '001111', '101', '1010', '001100', '001001', '1100']",1,7,19,17,5,36,12.945548895548896,62,65
"['1110111', '00011', '100', '111110', '001010', '10010', '110']",1,7,15,20,6,35,11.330963480963481,64,64
"['01', '1001', '100011']",1,3,6,6,0,12,1.9666666666666668,8,11
"['0101', '110001', '1010111', '00110', '00', '011010', '01011']",1,7,17,18,4,35,12.762204462204462,61,50
"['1000010', '01', '1001010']",1,3,10,6,2,16,1.6031746031746033,11,10
"['0101111', '011', '11', '1000', '0000', '01000']",1,6,14,11,2,25,7.067748917748918,47,48
"['10111', '00', '001101', '11']",1,4,6,9,2,15,2.4025974025974026,19,14
"['00100', '11100', '000']",1,3,9,4,2,13,1.85,7,17
"['1', '011', '000011', '11100', '101001']",1,5,10,11,2,21,4.995670995670996,35,27
"['0011000', '1101100', '10100', '00', '10010', '0011100']",1,6,20,13,5,33,9.395238095238096,49,68
"['0000', '01001', '001001', '11']",1,4,11,6,0,17,3.224963924963925,16,16
"['1', '0111011', '101011', '100110', '00']",1,5,9,13,2,22,4.483821733821734,39,22
"['00', '10010', '0110', '111']",1,4,7,7,0,14,2.753968253968254,15,11
"['1101', '10001', '110', '111']",1,4,5,10,2,15,4.0476190476190474,11,25
"['0', '10100', '01110', '11']",1,4,6,7,2,13,2.2095238095238097,19,10
"['0', '001010', '000010', '1101', '1110']",1,5,12,9,4,21,4.588095238095238,33,26
"['0', '1001001', '110101']",1,3,7,7,0,14,1.304945054945055,13,5
"['101', '10110', '000']",1,3,6,5,2,11,1.5833333333333333,7,6
"['011', '00101', '101', '00100', '0111111', '110']",1,6,11,15,5,26,8.533333333333333,46,39
"['11100', '10', '000010', '1110']",1,4,9,8,0,17,3.3906204906204906,18,19
"['0011', '01', '1010100', '101110']",1,4,9,10,0,19,3.3439782439782437,20,15
"['111000', '1111011', '0000']",1,3,8,9,0,17,1.3972027972027972,12,11
"['11110', '0001010', '1011101', '10010', '1011', '1100']",1,6,14,18,6,32,8.597691197691198,44,41
"['0110000', '110', '0000']",1,3,10,4,0,14,1.612987012987013,10,14
"['1010', '10010', '1']",1,3,5,5,0,10,1.6222222222222222,8,9
"['001', '11', '10101', '100010', '0101001']",1,5,12,11,0,23,5.858530358530358,30,27
"['11110', '0110111', '0011010']",1,3,7,12,2,19,1.7142857142857144,9,9
"['1100010', '1', '101', '01100']",1,4,8,8,0,16,2.85,23,10
"['01', '111010', '1100', '0001000', '1101010']",1,5,14,12,2,26,5.5971472971472975,34,29
"['0', '01001', '000111', '011']",1,4,8,7,0,15,3.262987012987013,19,14
"['110010', '00101', '0010000', '10111', '10001', '1101000', '10', '0101100', '110101']",1,9,27,23,8,50,21.875591075591075,111,100
"['010100', '0011000', '0001111', '0000111', '0101']",1,5,18,13,3,31,6.128671328671329,35,39
"['00', '100', '0011010']",1,3,8,4,0,12,1.8444444444444446,10,13
"['0001001', '010', '00101', '1001', '0111']",1,5,13,10,2,23,6.432251082251082,27,25
"['1101001', '010', '1', '000011']",1,4,9,8,0,17,2.6955433455433457,25,11
"['1111', '1111010', '0010011', '0100']",1,4,9,13,4,22,3.042207792207792,21,20
"['100', '100110', '000', '0000111', '0100011', '1100']",1,6,18,12,4,30,9.379420579420579,47,47
"['0110001', '00', '1', '011100']",1,4,9,7,0,16,2.2493894993894994,24,14
"['1101111', '001111', '00', '101001', '1111011']",1,5,9,19,4,28,5.274114774114774,36,37
"['0100110', '100', '010111', '00010', '0100']",1,5,15,10,0,25,6.21021201021201,27,38
"['11', '10001', '1010010', '111011', '00', '1101', '000100']",1,7,16,16,4,32,10.447363747363747,71,54
"['0001001', '001000', '00100', '0110', '111110']",1,5,17,11,2,28,5.928438228438228,30,40
"['0', '01001', '10000']",1,3,8,3,2,11,1.2666666666666666,11,6
"['0101010', '01', '1100100', '000']",1,4,12,7,2,19,3.06031746031746,23,17
"['00010', '00101', '01011']",1,3,9,6,3,15,2.2,6,7
"['0010', '0111010', '1', '0100']",1,4,9,7,2,16,3.0727272727272728,20,16
"['01', '011', '01110']",1,3,4,6,0,10,2.1214285714285714,6,10
"['0011011', '10', '0000']",1,3,8,5,0,13,1.323232323232323,12,8
"['010', '111', '11000', '0110', '0100']",1,5,10,9,4,19,5.988095238095238,21,28
"['11011', '0001', '1100001', '10', '01010', '01011', '0100101']",1,7,18,17,5,35,12.138672438672439,59,61
"['0011110', '011010', '010010']",1,3,10,9,2,19,1.8846153846153846,6,17
"['1000001', '1', '010100']",1,3,9,5,0,14,0.9972527472527473,15,4
"['0', '00110', '01', '0111100']",1,4,8,7,0,15,2.9325396825396823,22,20
"['0001', '01111', '1111']",1,3,4,9,2,13,1.5833333333333333,7,12
"['101011', '00', '001011', '0101001']",1,4,11,10,2,21,3.8162393162393164,18,16
"['0011', '10001', '1', '0101100']",1,4,9,8,0,17,2.8772727272727274,22,11
"['01', '0101011', '10000', '100111', '011110', '1101']",1,6,13,17,2,30,7.893251193251193,51,37
"['01', '0010', '0111011', '1010011', '110']",1,5,10,13,2,23,5.0464646464646465,35,24
"['0', '100', '1111001']",1,3,5,6,0,11,1.35,12,4
"['101', '001110', '010101', '110']",1,4,8,10,4,18,3.5555555555555554,18,14
"['0101101', '1001', '10', '000']",1,4,9,7,0,16,3.046176046176046,18,12
"['11001', '110010', '0010', '1110000', '010010', '1010', '00']",1,7,20,14,4,34,14.044427794427794,55,69
"['1101', '1001010', '111011']",1,3,6,11,0,17,2.1426573426573428,8,10
"['11001', '0010', '11', '0000001', '110100', '000', '01001']",1,7,20,12,2,32,11.307692307692307,65,62
"['01', '1001', '10000']",1,3,7,4,0,11,1.619047619047619,8,9
"['0001', '001010', '10', '1']",1,4,8,5,0,13,2.7857142857142856,18,12
"['110110', '01', '1100', '000']",1,4,8,7,0,15,3.049206349206349,17,16
"['01', '001111', '1111000', '10011']",1,4,8,12,0,20,3.1363081363081364,26,18
"['010100', '00101', '0011', '10', '011110', '11111', '110']",1,7,13,18,4,31,11.636652236652237,60,54
"['1001110', '110110', '1', '00101', '100', '1010111', '111110']",1,7,13,22,4,35,11.084670884670885,72,60
"['01', '0110100', '10101', '1111000', '111011', '111110', '001011']",1,7,15,24,5,39,11.084665334665335,71,60
"['01', '001', '1101000', '111111', '1100011']",1,5,10,15,2,25,4.9523199023199025,40,33
"['01', '00011', '00110', '110', '0001000']",1,5,14,8,2,22,5.770634920634921,32,33
"['1010', '11101', '0000010', '011001', '1011', '001011']",1,6,16,16,4,32,8.929254079254079,44,39
"['1100111', '11000', '00101', '1110']",1,4,9,12,2,21,3.38989898989899,19,21
"['0001', '0101', '1', '01000']",1,4,9,5,2,14,2.966666666666667,15,15
"['001000', '1001000', '1011', '0101001', '1101010']",1,5,18,13,3,31,6.707692307692308,28,26
"['0101111', '00001', '11', '100100', '1001101', '100111', '10']",1,7,16,19,6,35,10.934620934620934,72,69
"['1011', '0000010', '1001111']",1,3,9,9,2,18,1.5194805194805194,12,6
"['1000001', '0100100', '1111']",1,3,10,8,2,18,1.4415584415584415,13,4
"['0001101', '10111', '011010', '1']",1,4,8,11,0,19,2.8503996003996,24,10
"['1111110', '000', '11']",1,3,4,8,0,12,0.6444444444444444,14,6
"['1100100', '011', '1110', '11']",1,4,6,10,0,16,3.427994227994228,18,21
"['01101', '111', '100', '100101', '000100']",1,5,12,11,4,23,5.744949494949495,28,25
"['01', '110', '110111', '0010011']",1,4,7,11,0,18,3.0264957264957264,22,18
"['1000001', '0001110', '0010111', '011100', '1100010', '10', '0101']",1,7,22,18,4,40,12.226762126762127,82,50
"['11', '10010', '0000']",1,3,7,4,0,11,1.2380952380952381,9,4
"['01', '0101111', '010000', '011011', '011111']",1,5,11,16,3,27,5.611111111111112,32,37
"['00', '110', '001000']",1,3,8,3,0,11,1.3444444444444446,10,12
"['100001', '10', '1101', '1100', '01000', '0110011']",1,6,15,13,2,28,9.374186924186924,43,36
"['1000110', '0010', '0100', '1111']",1,4,10,9,3,19,2.8863636363636362,19,12
"['010', '1', '1000101', '0111', '01000', '0110011']",1,6,14,13,2,27,8.01955266955267,53,35
"['0010001', '1011010', '11', '11000', '10110', '1100', '1110']",1,7,16,18,6,34,13.427922077922078,61,64
"['0101', '01000', '011001']",1,3,9,6,0,15,2.193939393939394,6,11
"['0', '10111', '0100000', '000111']",1,4,11,8,0,19,2.3911921411921413,26,15
"['0010', '10001', '0000011', '001100', '110', '01110']",1,6,18,12,2,30,9.021661671661672,49,41
"['0101010', '01', '0100']",1,3,8,5,0,13,1.8383838383838382,10,12
"['1110101', '0011', '010', '000']",1,4,9,8,2,17,3.173160173160173,18,13
"['0', '0101', '11010', '111', '000100']",1,5,10,9,0,19,4.374819624819625,32,20
"['11', '011', '0101100', '00001']",1,4,9,8,0,17,2.9634920634920636,21,14
"['010', '011', '111111', '111000', '01011', '0100']",1,6,11,16,4,27,7.844733044733045,45,50
"['00', '1100', '0100']",1,3,7,3,2,10,2.083333333333333,5,14
"['0000101', '1011', '11']",1,3,6,7,0,13,1.6565656565656566,11,10
"['1001110', '1', '0001', '1010011', '1100']",1,5,11,12,4,23,5.05974025974026,38,25
"['0011011', '01', '0111111']",1,3,5,11,2,16,1.6031746031746033,12,8
"['0', '1010100', '1110']",1,3,6,6,0,12,1.0136363636363637,12,6
"['11001', '1111011', '0001000', '00001']",1,4,13,11,4,24,3.052380952380952,22,18
"['0101101', '11011', '11001']",1,3,6,11,2,17,2.1333333333333333,7,12
"['01', '1001', '00']",1,3,5,3,2,8,1.8333333333333333,5,5
"['00010', '100000', '011001']",1,3,12,5,2,17,1.9545454545454546,9,8
"['00', '011', '110101']",1,3,5,6,0,11,1.5666666666666667,9,5
"['0', '0110101', '110001', '0010']",1,4,10,8,0,18,3.0322177822177823,23,11
"['0100010', '01', '110', '101110']",1,4,9,9,0,18,3.0264957264957264,21,17
"['100001', '0011', '101011', '1110011', '1100000', '010110', '000', '0100']",1,8,24,19,7,43,17.066189366189366,86,77
"['01', '100', '100101', '11']",1,4,6,7,2,13,2.966666666666667,16,17
"['110010', '00', '110001']",1,3,8,6,2,14,1.8333333333333335,10,7
"['11010', '11011', '00001', '100', '1101110', '1111', '0110001']",1,7,15,21,5,36,12.442496392496393,62,69
"['0', '0010', '11', '10010', '111000']",1,5,10,8,0,18,4.63997113997114,32,24
"['101', '00', '0101100', '1101']",1,4,8,8,0,16,3.1803751803751803,19,12
"['011011', '101000', '100', '100010']",1,4,12,9,3,21,3.444444444444444,20,17
"['11001', '111100', '111', '101', '1010010', '00010', '0101']",1,7,15,18,4,33,12.908097458097458,58,59
"['01', '10001', '1111110', '10', '0000', '01011']",1,6,12,13,4,25,6.6786435786435785,54,33
"['101', '1010100', '001010', '11111', '0101']",1,5,11,14,0,25,6.228393828393829,29,23
"['100100', '0010111', '01010', '1111011']",1,4,11,14,2,25,3.5422910422910423,22,14
"['1010100', '100', '10000', '00110', '1100101', '1100111']",1,6,18,16,5,34,8.926190476190476,47,44
"['00', '1', '0100110']",1,3,6,4,0,10,0.6944444444444444,13,4
"['111', '10110', '100011', '001010', '011111', '0001010', '0101']",1,7,17,20,3,37,12.908103008103009,62,55
"['1100', '10', '000', '1111']",1,4,6,7,2,13,2.4714285714285715,15,14
"['11', '10110', '010010', '00', '111101']",1,5,9,12,4,21,4.498917748917749,33,19
"['1000', '1', '01011']",1,3,5,5,0,10,1.1777777777777778,10,6
"['000110', '0010', '100001', '1001000', '00010']",1,5,20,8,2,28,7.062781662781663,24,37
"['1100011', '111', '0']",1,3,4,7,0,11,0.85,13,8
"['0010101', '10', '000', '00001']",1,4,12,5,0,17,2.9801587301587302,19,20
"['0101110', '101', '10001', '0011111', '0100001', '011010']",1,6,17,18,3,35,8.481535131535132,53,37
"['110011', '110010', '01110', '00011']",1,4,10,12,4,22,3.796969696969697,16,21
"['0', '111101', '1110']",1,3,3,8,0,11,1.4857142857142858,10,6
"['00', '001', '01111', '111001']",1,4,7,9,0,16,3.47965367965368,18,16
"['0100010', '0011001', '1000', '0010010', '110101']",1,5,19,12,3,31,7.0285714285714285,30,26
"['001', '101', '0001011', '1110110', '011000']",1,5,13,13,4,26,5.403907203907204,37,24
"['11110', '011100', '001000', '1001', '101110']",1,5,13,14,3,27,6.2444444444444445,27,24
"['01', '0111001', '1001010', '00110', '1010']",1,5,13,12,2,25,6.137806637806637,34,28
"['100110', '11101', '0001001', '000010']",1,4,14,10,2,24,3.6421911421911424,19,14
"['010001', '00001', '100', '1001000', '10', '0111100']",1,6,19,11,2,30,8.396880896880896,53,46
"['010', '011', '111', '10110', '1011000', '1100']",1,6,11,14,3,25,9.208225108225108,36,40
"['0', '111010', '0100']",1,3,6,5,0,11,1.2857142857142856,11,8
"['01', '01100', '0100']",1,3,7,4,0,11,2.126984126984127,6,13
"['01', '101011', '10100', '0010111']",1,4,9,11,0,20,3.5123765123765125,20,17
"['00111', '100', '0110', '01111', '0000', '1011', '01100']",1,7,15,15,6,30,12.047619047619047,50,64
"['111', '0000100', '101', '1100', '01011']",1,5,11,11,2,22,5.1494227994227995,31,26
"['01111', '110100', '1111', '11101', '01011']",1,5,7,18,3,25,6.458585858585859,22,44
"['010001', '001', '000']",1,3,9,3,2,12,2.0,7,10
"['11', '10001', '1100101', '0100']",1,4,9,9,0,18,3.3946608946608947,20,15
"['1100010', '01', '1001', '0100']",1,4,10,7,2,17,3.80050505050505,18,12
"['1101000', '0000000', '11101', '10', '0101']",1,5,15,10,2,25,4.742424242424242,39,25
"['0', '1011', '01', '01111']",1,4,4,8,0,12,3.3047619047619046,15,12
"['111000', '001111', '011100']",1,3,8,10,3,18,2.0,10,11
"['101000', '01', '1101011', '1101']",1,4,8,11,0,19,3.5537684537684537,20,19
"['10001', '1011011', '10010']",1,3,8,9,2,17,2.1333333333333333,8,12
"['0001011', '0011', '1100', '11100']",1,4,10,10,2,20,3.2575757575757573,22,27
"['10', '0110001', '0100']",1,3,8,5,0,13,1.8383838383838382,10,7
"['010', '1110000', '11000', '10000', '01010', '01000', '110101']",1,7,22,14,4,36,13.96083916083916,52,69
"['111100', '0011', '1000', '10010', '000', '110', '111001']",1,7,16,15,6,31,12.738600288600288,56,61
"['0010', '1000', '111010', '111011']",1,4,9,11,4,20,3.5833333333333335,17,18
"['1111', '101', '1011000']",1,3,5,9,0,14,1.535064935064935,10,10
"['011011', '1010110', '1']",1,3,5,9,0,14,1.151098901098901,14,6
"['010', '011011', '100000', '0111', '0101', '110']",1,6,13,13,6,26,8.743650793650794,41,42
"['1001001', '01', '1100', '01100']",1,4,10,8,0,18,3.2835497835497836,18,15
"['0', '101011', '0111001', '11']",1,4,6,10,0,16,1.9416971916971917,25,12
"['01', '0010', '100', '1111110', '000010', '1011', '010011', '101111']",1,8,17,21,5,38,14.478676878676879,92,75
"['1', '00000', '10111', '0001', '1010']",1,5,11,8,4,19,4.055555555555555,32,24
"['1000001', '1110010', '00000', '10111', '100110', '10100']",1,6,20,15,5,35,8.474225774225774,45,41
"['0111000', '111110', '100']",1,3,7,9,0,16,1.6598290598290597,11,7
"['0111010', '01111', '1001000', '00', '011111', '1101', '11100']",1,7,15,21,4,36,11.316100566100566,69,65
"['0111000', '11010', '0011', '0001', '1001', '100']",1,6,15,12,3,27,9.458585858585858,39,40
"['00010', '00', '10', '111']",1,4,7,5,2,12,2.2928571428571427,16,13
"['000110', '011', '00011', '101', '10010']",1,5,12,10,4,22,6.514141414141414,24,26
"['0011001', '0011011', '1']",1,3,7,8,2,15,1.3571428571428572,13,10
"['000110', '1', '010010', '1100110', '1100011']",1,5,14,13,4,27,5.684981684981685,36,26
"['01101', '1001010', '0000000', '10000', '10100', '001110', '1011']",1,7,24,15,5,39,11.461793761793762,66,62
"['0001001', '10001', '0101', '0100']",1,4,13,7,2,20,4.204545454545454,15,17
"['00', '0100011', '1']",1,3,6,4,0,10,0.6944444444444444,13,4
"['01', '0010', '11000', '110001', '01110']",1,5,12,10,2,22,6.011688311688311,30,26
"['100', '111', '111001', '0000']",1,4,8,8,2,16,2.638095238095238,18,16
"['11', '011011', '10101', '100', '1110100', '0110010']",1,6,13,17,2,30,8.914269064269064,51,39
"['0011', '10110', '10', '1000111']",1,4,8,10,0,18,3.40981240981241,19,17
"['110000', '110010', '001', '1001010', '00011', '1111', '000']",1,7,19,15,4,34,12.216095016095016,63,67
"['0', '1001110', '100010']",1,3,8,6,0,14,1.304945054945055,13,9
"['1001110', '01', '00', '100000', '110']",1,5,12,8,2,20,4.598717948717948,35,26
"['01', '111010', '00000', '00011', '001000', '1111', '1010', '100011']",1,8,21,17,7,38,13.963203463203463,86,83
"['1101000', '1001', '001111']",1,3,8,9,0,17,1.606993006993007,13,8
"['101011', '1111001', '11']",1,3,4,11,0,15,1.5598290598290598,12,17
"['1111000', '1010111', '100000', '000', '11111', '0100']",1,6,16,16,2,32,7.005205905205905,55,53
"['1110101', '1100', '1101110']",1,3,6,12,2,18,2.025974025974026,9,10
"['01', '00101', '100111', '01000', '1110']",1,5,11,11,2,22,5.337806637806637,31,23
"['0010001', '0000110', '10110']",1,3,12,7,2,19,1.880952380952381,10,10
"['110000', '11110', '0011010', '00', '10']",1,5,12,10,2,22,4.906870906870907,36,31
"['000110', '1010', '010001', '0111']",1,4,11,9,4,20,3.5666666666666664,18,14
"['010101', '0110', '10', '000']",1,4,9,6,0,15,3.604761904761905,15,16
"['011', '11', '00011', '10001', '100000', '0000', '01001', '1010010', '01000']",1,9,27,15,4,42,21.653119103119103,95,106
"['011', '0110', '11101', '101111', '0100']",1,5,8,14,2,22,6.183621933621933,24,24
"['001100', '0001010', '1100', '1110']",1,4,12,9,2,21,3.6465034965034966,16,23
"['11010', '011010', '001011']",1,3,8,9,2,17,1.9545454545454546,6,11
"['11101', '1', '1011100', '1100110']",1,4,7,13,2,20,2.738095238095238,25,15
"['0011011', '1011011', '110', '01100', '011000']",1,5,13,15,2,28,6.947002997002997,27,32
"['0101', '10011', '1111']",1,3,4,9,2,13,1.6111111111111112,7,10
"['11110', '10001', '1000']",1,3,7,7,2,14,1.7333333333333334,8,9
"['1001110', '01', '010000', '00001', '00111', '10110']",1,6,17,13,3,30,8.677145077145077,47,40
"['101', '01001', '00001']",1,3,8,5,2,13,2.05,6,10
"['0', '0011', '001']",1,3,5,3,0,8,1.7571428571428571,6,8
"['010100', '0000000', '0100101']",1,3,15,5,2,20,1.3516483516483517,8,12
"['101010', '00', '0001']",1,3,8,4,0,12,1.5666666666666667,9,8
"['1101001', '01', '001000', '1111110', '1000', '001010']",1,6,17,15,4,32,7.417149517149517,56,40
"['11', '1010100', '10000', '0111', '1011', '1001011']",1,6,13,16,4,29,8.3510101010101,48,56
"['1011110', '101', '1001', '00', '10']",1,5,8,10,2,18,5.924819624819625,27,27
"['0111001', '0110', '1111001', '1010', '000000', '01001']",1,6,18,15,4,33,8.583133533133534,48,44
"['01', '00', '011', '001011']",1,4,7,6,2,13,3.3666666666666667,15,17
"['110000', '1000', '1001', '0100']",1,4,12,6,3,18,4.25,13,16
"['011', '110100', '111']",1,3,4,8,2,12,1.7777777777777777,8,11
"['0', '1001100', '1011', '11100', '111101']",1,5,9,14,0,23,5.216755466755467,34,26
"['110', '000101', '0000']",1,3,9,4,0,13,1.53015873015873,9,10
"['1001011', '1101', '1', '011100']",1,4,7,11,0,18,2.7245254745254748,25,13
"['100001', '000101', '111110', '01010', '110']",1,5,13,13,3,26,5.025252525252525,34,24
"['001111', '101', '1001', '00110', '1100110', '110', '01110']",1,7,14,19,4,33,13.325774225774225,59,61
"['010', '011000', '0001111', '00010', '0101', '111101', '0111100']",1,7,19,19,4,38,12.414590964590964,69,71
"['01011', '10111', '000100', '10']",1,4,9,9,2,18,3.351948051948052,19,12
"['1011110', '10000', '011000']",1,3,10,8,0,18,1.8426573426573427,9,9
"['110110', '110010', '1110010', '001', '1011110', '1101000', '1010010', '1100']",1,8,22,25,6,47,19.282706182706182,75,100
"['01', '110010', '0010000', '0010011', '10']",1,5,15,9,4,24,5.222832722832723,38,27
"['001101', '11', '101000', '100110', '010110', '011111', '001100', '01001']",1,8,21,22,6,43,17.38961038961039,80,73
"['01', '001', '000010']",1,3,8,3,0,11,1.9666666666666668,8,8
"['11010', '11', '100', '1000', '1100111']",1,5,9,12,0,21,5.8351370851370845,29,34
"['01101', '000001', '0111']",1,3,8,7,0,15,1.6525252525252525,8,9
"['01', '100', '110111']",1,3,4,7,0,11,1.3444444444444446,10,6
"['0111000', '001', '00100', '010111', '110']",1,5,13,11,2,24,5.299728049728049,34,30
"['00111', '101', '11110']",1,3,4,9,2,13,1.6,9,8
"['11001', '11110', '0011110', '100101', '01010', '01001']",1,6,15,18,4,33,9.260839160839161,44,40
"['01101', '1110010', '000', '00111']",1,4,10,10,2,20,3.5666666666666664,20,16
"['101100', '01', '100']",1,3,6,5,0,11,1.5666666666666667,9,9
"['101', '0001', '1110']",1,3,5,6,2,11,1.3928571428571428,8,7
"['0', '11010', '100101', '01110', '01000']",1,5,12,10,3,22,4.903896103896104,32,22
"['000101', '0111', '11']",1,3,5,7,0,12,1.7666666666666666,9,8
"['1010', '1001', '0000']",1,3,8,4,3,12,1.75,6,5
"['01', '0110', '00101', '111100']",1,4,8,9,0,17,3.118398268398268,19,15
"['00111', '11010', '0000110', '11111']",1,4,9,13,3,22,3.1,20,19
"['100101', '011', '0100']",1,3,7,6,0,13,1.838095238095238,8,5
"['111', '00001', '1000010', '100111', '000', '0111101', '1110']",1,7,17,18,4,35,10.53856143856144,73,58
"['101100', '10011', '110100']",1,3,8,9,2,17,2.106060606060606,8,10
"['1110010', '11', '10000', '1101', '001011']",1,5,11,13,0,24,5.314230214230214,35,32
"['111', '101101', '1101000', '10011', '000']",1,5,11,13,2,24,5.153768453768453,32,30
"['11010', '111', '0001111', '01001', '00010', '1100', '0100']",1,7,17,16,5,33,12.28997113997114,59,66
"['11001', '0001', '1']",1,3,5,5,0,10,1.4,9,10
"['010100', '001', '010001', '11', '101010', '00011', '100', '001011']",1,8,21,16,6,37,16.666883116883117,79,77
"['00100', '0010', '1011011', '11']",1,4,9,9,0,18,2.9978354978354975,21,14
"['1000100', '00', '001110', '000001', '001001', '0111100']",1,6,22,12,5,34,8.176434676434676,54,60
"['1', '1001', '1101011', '000010', '01010', '1110']",1,6,13,14,2,27,7.226545676545676,51,32
"['1', '011', '001101', '001010']",1,4,8,8,2,16,3.238095238095238,20,12
"['0101010', '00', '00101']",1,3,9,5,0,14,1.6825396825396823,10,10
"['100100', '0010011', '1010111', '1000', '1100']",1,5,15,13,4,28,6.430719280719281,29,34
"['11001', '0011', '1010', '1000', '000100']",1,5,14,9,3,23,6.095454545454546,27,26
"['110111', '110', '10000']",1,3,6,8,0,14,1.5303030303030303,10,9
"['00100', '000', '1001100', '001001', '101111']",1,5,16,11,2,27,6.075718725718726,30,36
"['01001', '0101', '100000', '1']",1,4,10,6,0,16,2.853391053391053,20,15
"['11110', '1111', '00', '0011111', '1110110']",1,5,7,18,2,25,5.27994227994228,34,45
"['110010', '1', '100011']",1,3,6,7,2,13,1.2380952380952381,12,9
"['010100', '1000100', '0', '11111', '1100']",1,5,12,11,0,23,4.191813741813742,38,27
"['0101101', '100110', '00110', '111010']",1,4,11,13,2,24,4.493006993006993,15,18
"['0', '0010110', '11001', '101011', '100', '11111']",1,6,11,16,2,27,6.365551115551115,51,33
"['110010', '11101', '11']",1,3,4,9,0,13,1.7987012987012987,9,13
"['11001', '000111', '1111000']",1,3,8,10,0,18,1.6736596736596736,13,12
"['100001', '1', '011']",1,3,5,5,0,10,1.2301587301587302,11,8
"['0', '000011', '1001', '01111', '1000', '10100']",1,6,14,11,4,25,7.011471861471861,47,37
"['000110', '01', '001', '011']",1,4,8,6,2,14,4.1,13,15
"['001', '0101111', '11100', '01110']",1,4,8,12,2,20,3.3666666666666667,20,16
"['11', '1001', '00', '01011', '101111']",1,5,7,12,2,19,5.22012987012987,28,26
"['0', '1110100', '01110', '0011000']",1,4,11,9,2,20,2.880952380952381,25,20
"['00000', '10001', '110100', '0001100', '10']",1,5,17,8,2,25,5.426062826062826,33,30
"['11', '1001', '10000', '1110101', '1010', '0111110']",1,6,12,17,4,29,8.177849927849927,51,38
"['010001', '001', '101101', '11000', '0001', '10', '0111', '11100']",1,8,18,17,6,35,16.083549783549785,78,79
"['1', '10110', '100101', '010111', '000', '001100']",1,6,14,13,3,27,7.301587301587301,50,31
"['1010110', '1', '101010', '0011', '10000', '10100', '1010001']",1,7,19,16,4,35,12.256954156954157,63,72
"['110000', '11010', '0110111', '001111', '0011', '1000', '1011']",1,7,16,20,5,36,12.067637917637917,65,70
"['001110', '011', '000011']",1,3,8,7,2,15,2.0,9,9
"['0011', '00', '0110', '111101']",1,4,7,9,2,16,3.333333333333333,18,13
"['11000', '110', '100001']",1,3,8,6,0,14,1.9217171717171717,8,8
"['00', '0111', '1011111']",1,3,4,9,0,13,1.2828282828282829,12,6
"['01100', '11100', '1', '100110']",1,4,8,9,2,17,3.206926406926407,20,13
"['11001', '1011', '10100', '1']",1,4,6,9,2,15,2.977777777777778,17,21
"['011', '0010000', '0011000', '00101', '0011', '111110', '10', '1011000']",1,8,23,18,3,41,15.906909756909757,93,97
"['0111000', '11', '10011', '0000', '01110']",1,5,12,11,2,23,4.954978354978355,34,26
"['0', '10100', '001001', '01111']",1,4,9,8,2,17,2.625108225108225,22,13
"['001', '1100101', '001011', '11']",1,4,8,10,0,18,3.3803418803418803,21,22
"['1011', '110', '0000']",1,3,6,5,2,11,1.1071428571428572,8,5
"['001', '11', '00', '111110', '01010']",1,5,8,10,2,18,4.178715728715729,30,23
"['0', '0011', '0100001']",1,3,8,4,0,12,1.1954545454545453,13,6
"['1011', '0111001', '1']",1,3,4,8,0,12,1.1954545454545453,13,8
"['011', '101000', '0000001', '1010', '000', '11111', '110']",1,7,17,14,3,31,9.403096903096904,70,59
"['001', '111', '00000', '10111', '1101011', '110011', '01000']",1,7,16,18,5,34,10.426107226107225,66,69
"['110000', '01', '101011', '0110', '0111111', '100111', '01001', '1100', '111001']",1,9,19,27,6,46,20.852236652236652,115,106
"['1010', '110', '000101', '1']",1,4,7,7,0,14,2.8015873015873014,18,13
"['01', '0111010', '0101110', '00000', '1110001', '1100011', '101111']",1,7,19,22,4,41,11.37168387168387,81,47
"['1011001', '01111', '00001']",1,3,8,9,2,17,1.7333333333333334,9,8
"['01', '1111101', '111', '0010000', '0111011', '0011010']",1,6,14,19,4,33,7.606349206349206,60,38
"['10001', '000101', '10010', '0111', '1110']",1,5,12,12,4,24,5.7823232323232325,26,26
"['1', '111010', '100010', '000001', '0011100']",1,5,15,11,3,26,4.466117216117216,42,22
"['0', '10111', '000111']",1,3,5,7,0,12,1.3463203463203464,11,7
"['1001100', '0001001', '111000', '100010']",1,4,16,10,4,26,4.007326007326007,18,18
"['010', '000', '01010']",1,3,8,3,2,11,2.1666666666666665,5,16
"['01111', '100010', '00', '0000111', '110101']",1,5,13,13,2,26,5.049506049506049,37,24
"['001', '100', '000101', '1111', '1101']",1,5,9,11,4,20,5.242063492063492,27,31
"['00', '0111001', '110']",1,3,6,6,0,12,1.4444444444444444,11,6
"['1110111', '01', '11000', '1110110', '01100']",1,5,10,16,4,26,5.7365079365079366,34,30
"['00', '010', '11111']",1,3,4,6,0,10,1.05,10,4
"['110', '10', '111101', '1110']",1,4,4,11,0,15,4.29047619047619,13,20
"['1100111', '1101011', '0010101']",1,3,8,13,3,21,2.2857142857142856,9,13
"['100101', '10101', '1', '010100']",1,4,9,9,2,18,3.207792207792208,20,16
"['0101010', '000100', '001111', '00000']",1,4,16,8,2,24,3.6701631701631703,16,28
"['01', '011', '111', '100', '1001111']",1,5,6,12,3,18,5.177777777777778,28,32
"['11110', '0000010', '01010']",1,3,10,7,2,17,1.2333333333333334,10,12
"['11110', '0001', '000010', '110101']",1,4,11,10,2,21,2.8313131313131312,19,15
"['0', '1010001', '010', '1101111']",1,4,8,10,2,18,2.571428571428571,27,8
"['0011', '0001', '00']",1,3,7,3,2,10,2.083333333333333,5,11
"['0', '11110', '1110']",1,3,3,7,0,10,1.6222222222222222,8,11
"['0110000', '1000000', '00', '1100101', '10100', '110']",1,6,20,11,3,31,8.238095238095237,53,42
"['0101010', '10', '111']",1,3,5,7,0,12,1.4444444444444444,11,5
"['011011', '00', '1']",1,3,4,5,0,9,0.7857142857142857,11,4
"['1110101', '00', '111110']",1,3,5,10,0,15,1.3098290598290598,12,6
"['01', '0111110', '0100']",1,3,6,7,0,13,1.6565656565656566,11,11
"['0', '010000', '11100', '101101']",1,4,10,8,2,18,2.6774891774891776,23,11
"['0', '10111', '1001']",1,3,4,6,0,10,1.4,9,5
"['0100011', '0010', '001', '011110']",1,4,11,9,0,20,3.5085803085803082,20,18
"['110', '1', '0000']",1,3,5,3,0,8,0.7857142857142857,9,4
"['11', '101010', '1001', '1000', '11100']",1,5,10,11,2,21,6.30021645021645,24,29
"['1', '01111', '0010101', '010111', '0000111']",1,5,11,15,2,26,5.432400932400933,34,29
"['0000111', '0011', '0100']",1,3,9,6,2,15,1.5909090909090908,10,10
"['1', '0011010', '001000']",1,3,9,5,0,14,1.304945054945055,13,7
"['100000', '111', '00000']",1,3,10,4,0,14,1.1313131313131313,11,12
"['01', '111', '110011', '00', '0100100', '1010000']",1,6,15,12,4,27,7.232356532356532,55,36
"['00', '110', '0010', '11']",1,4,6,5,2,11,2.7714285714285714,12,15
"['010101', '1111101', '0110111']",1,3,6,14,2,20,1.8021978021978022,8,11
"['1100010', '101', '000100']",1,3,10,6,0,16,1.8136752136752137,11,4
"['001111', '1', '0101011', '11101', '000001']",1,5,11,14,2,25,4.168747918747918,38,28
"['01', '00101', '000']",1,3,7,3,0,10,1.7214285714285715,7,9
"['101', '1010100', '001']",1,3,7,6,2,13,1.6666666666666665,9,10
"['11000', '10', '110100']",1,3,7,6,0,13,1.9805194805194803,8,9
"['10111', '0111111', '0111011', '0000']",1,4,8,15,2,23,2.958152958152958,22,17
"['01', '00', '011110', '110', '101001']",1,5,9,10,4,19,4.911111111111111,31,22
"['00010', '0000010', '000000']",1,3,16,2,0,18,2.483682983682984,5,30
"['1001110', '001', '11', '1100000', '100111', '011010']",1,6,15,16,4,31,8.407326007326008,55,40
"['001', '10', '1100110', '11111', '1001011']",1,5,9,15,2,24,4.738888888888889,37,29
"['001', '011', '0111011', '010111', '1101', '1100', '1001011']",1,7,13,21,6,34,12.657847707847708,63,70
"['01', '10001', '10', '0000010']",1,4,11,5,2,16,3.198412698412698,21,13
"['0', '101000', '110', '111']",1,4,6,7,2,13,2.341269841269841,18,12
"['101100', '111', '0110', '00', '10011']",1,5,9,11,0,20,5.447907647907648,27,21
"['11010', '00001', '11', '100', '011000']",1,5,12,9,2,21,5.346536796536796,30,24
"['1000010', '011101', '0011010', '0001111']",1,4,14,13,3,27,3.857142857142857,20,15
"['01', '101', '00', '1001']",1,4,6,5,2,11,3.8904761904761904,9,14
"['00100', '01000', '11']",1,3,8,4,2,12,1.3714285714285714,10,6
"['100110', '0011010', '00000']",1,3,12,6,0,18,1.9813519813519813,9,11
"['110010', '11011', '11', '00011', '10011', '0000', '00010', '0101', '101110', '01000']",1,10,25,22,9,47,26.12005772005772,117,135
"['01', '111100', '10101', '10001', '10100', '1110']",1,6,12,15,3,27,8.4491341991342,39,44
"['1000101', '100101', '011', '0110111']",1,4,10,13,2,23,3.9765567765567766,19,23
"['00111', '1110111', '1111']",1,3,3,13,0,16,2.0606060606060606,8,25
"['00100', '0101', '110100']",1,3,9,6,0,15,1.993939393939394,7,10
"['011', '111', '100', '1110100', '1101', '0101001']",1,6,11,16,5,27,8.72034632034632,45,47
"['1111100', '001', '100001', '111', '010', '011', '011101']",1,7,13,18,6,31,11.154700854700854,68,56
"['11001', '01', '100', '10010', '0111100']",1,5,11,11,2,22,6.053968253968254,31,24
"['010100', '1011', '000011']",1,3,9,7,2,16,1.7,10,7
"['001', '110', '00101']",1,3,6,5,2,11,1.5833333333333333,8,9
"['100100', '1011011', '0110100']",1,3,10,10,2,20,2.098901098901099,8,8
"['010001', '11', '101', '0001100', '1010', '1011']",1,6,13,13,2,26,9.292801642801642,43,39
"['0010', '011', '000011', '0100']",1,4,11,6,2,17,3.5595238095238093,15,20
"['110010', '11000', '101', '1110011', '100110', '1000']",1,6,15,16,2,31,10.532112332112332,38,47
"['1', '1100010', '011101', '0011011', '011010', '01000', '011000']",1,7,20,18,5,38,12.06959706959707,71,60
"['11010', '1', '101', '110011', '100000', '00010']",1,6,14,12,4,26,7.744660894660894,47,38
"['01', '0110010', '010']",1,3,7,5,0,12,1.8444444444444446,10,13
"['0110101', '1010110', '11', '0011', '010101', '0111', '1011000']",1,7,16,21,5,37,13.403579753579754,66,58
"['010', '0001110', '00000', '11', '10000', '00110', '1000', '0111']",1,8,22,13,5,35,15.017171717171717,82,95
"['0011', '100', '00101', '11']",1,4,7,7,0,14,3.598412698412698,14,18
"['11110', '1011101', '1001']",1,3,5,11,0,16,2.005050505050505,8,10
"['1101010', '000000', '11']",1,3,9,6,0,15,0.905982905982906,15,6
"['0', '0011101', '011011', '011001', '1100011', '000100']",1,6,17,16,5,33,7.620879120879121,58,37
"['1011', '101', '000']",1,3,5,5,2,10,1.476190476190476,6,6
"['110110', '01101', '100001', '011', '00100', '101001']",1,6,16,15,5,31,8.915656565656565,41,36
"['10001', '0101110', '10']",1,3,7,7,0,14,1.5158730158730158,12,6
"['11000', '1', '10011', '00000']",1,4,10,6,3,16,2.2666666666666666,21,15
"['011101', '00', '00101', '10']",1,4,8,7,2,15,3.37012987012987,17,16
"['00100', '100101', '11111', '000111', '110', '01000']",1,6,15,15,5,30,7.891919191919191,46,39
"['011111', '1100010', '1110010', '0100111']",1,4,11,16,3,27,3.5384615384615383,19,25
"['0', '00010', '011000']",1,3,9,3,0,12,1.1645021645021645,12,14
"['101', '01101', '1001010']",1,3,7,8,0,15,2.0166666666666666,9,9
"['1000', '111', '11010']",1,3,5,7,0,12,1.7023809523809523,7,8
"['111100', '1', '101000', '0000', '1010011']",1,5,13,11,2,24,4.2363469863469865,38,30
"['001', '011100', '00111', '0010011', '0001101', '11101', '111001']",1,7,18,21,6,39,13.271667221667222,63,72
"['0110010', '1', '110101']",1,3,6,8,0,14,1.304945054945055,14,4
"['10100', '100', '11100', '0111']",1,4,8,9,2,17,3.696825396825397,14,21
"['0', '11010', '1001111']",1,3,5,8,0,13,1.0833333333333333,14,5
"['01', '1011001', '00011', '010010', '10010', '0000']",1,6,18,11,2,29,8.88986568986569,43,39
"['00111', '1010', '000']",1,3,7,5,0,12,1.5158730158730158,8,8
"['010', '101110', '0111']",1,3,5,8,0,13,2.038095238095238,7,8
"['010011', '1100', '000', '1']",1,4,8,6,0,14,2.3015873015873014,19,13
"['00111', '0000010', '001101', '0011100']",1,4,15,10,2,25,4.198468198468198,16,30
"['0', '0010001', '111010', '01011', '0110110']",1,5,13,13,2,26,4.9666999666999665,39,25
"['101', '11010', '10001', '010111']",1,4,8,11,2,19,3.8575757575757574,16,17
"['101000', '1001000', '1000', '1011011', '110']",1,5,15,12,2,27,6.1984903984903985,29,39
"['0010', '0111010', '00101', '00011', '110011', '00110']",1,6,17,15,3,32,10.648407148407149,37,48
"['011', '00011', '101', '0011', '1110101']",1,5,9,13,2,22,6.479581529581529,27,35
"['101011', '0011', '100', '1111111']",1,4,6,14,0,20,2.9094239094239094,22,22
"['101001', '00', '111101']",1,3,6,8,2,14,1.25,11,5
"['11000', '11110', '100111', '01000']",1,4,10,11,3,21,3.4363636363636365,17,17
"['000100', '1', '1101110']",1,3,7,7,0,14,0.9972527472527473,15,4
"['010', '00101', '101011', '0011', '1101101', '10110', '01111', '110111', '000001']",1,9,20,27,6,47,22.067388167388167,97,103
"['01', '101010', '0110', '00', '01110']",1,5,10,9,2,19,5.628715728715728,24,34
"['101', '1001000', '100011', '10', '0100']",1,5,13,9,0,22,6.191863691863691,31,26
"['1010000', '01', '011001']",1,3,9,6,0,15,1.5598290598290598,12,8
"['0111000', '000011', '11', '0011', '0100']",1,5,13,10,2,23,5.378710178710179,34,33
"['11', '1100101', '10', '1000011', '00010', '0101']",1,6,14,13,4,27,8.455266955266955,50,40
"['00101', '10', '0110110']",1,3,7,7,0,14,1.6825396825396823,11,7
"['10001', '1110011', '01100', '11']",1,4,8,11,2,19,3.5206349206349206,20,16
"['0', '0110', '1101010']",1,3,6,6,0,12,1.1954545454545453,12,9
"['101', '10', '011100']",1,3,5,6,0,11,1.7444444444444445,9,5
"['0010101', '1', '1110', '011000']",1,4,9,9,0,18,2.360889110889111,24,11
"['1001', '0111011', '111001']",1,3,6,11,0,17,2.114685314685315,8,12
"['0110000', '101100', '01']",1,3,9,6,0,15,1.7136752136752138,12,8
"['01', '001', '1111101', '00011', '1000', '01110', '0110110']",1,7,15,18,4,33,11.311471861471862,70,54
"['001', '10', '111', '0111011']",1,4,5,10,2,15,2.577777777777778,19,14
"['1010', '0101', '000101', '1010110']",1,4,11,10,2,21,4.21993006993007,17,19
"['11110', '110010', '000011', '0000']",1,4,12,9,2,21,3.0313131313131314,19,22
"['10', '000001', '111011']",1,3,7,7,2,14,1.0833333333333333,13,6
"['1100010', '0111111', '00101', '1011111']",1,4,9,17,3,26,3.380952380952381,24,18
"['0100111', '1100', '000', '1111']",1,4,8,10,2,18,2.5623376623376624,19,19
"['10001', '0010', '010000', '010011']",1,4,14,7,2,21,3.987878787878788,15,14
"['111010', '10', '0011010', '000']",1,4,10,8,0,18,3.158119658119658,21,22
"['011100', '00000', '101010', '110001', '0110', '01011']",1,6,18,14,5,32,8.402020202020202,42,38
"['0000111', '010111', '10', '111']",1,4,7,11,0,18,3.158119658119658,21,23
"['00', '0100100', '001010', '01000']",1,4,15,5,0,20,3.8457098457098455,19,36
"['110011', '01001', '011']",1,3,6,8,0,14,2.143939393939394,7,10
"['01111', '100011', '0000011']",1,3,9,9,0,18,1.8146853146853146,9,12
"['11', '1100000', '1010', '00010', '111001']",1,5,13,11,0,24,5.536452436452437,34,27
"['0001101', '1000110', '100', '110']",1,4,11,9,4,20,3.723809523809524,20,17
"['100101', '01101', '1', '11001']",1,4,7,10,2,17,3.206926406926407,19,22
"['11110', '10', '111001']",1,3,4,9,0,13,1.7987012987012987,9,9
"['0011', '1000', '100']",1,3,7,4,2,11,1.9285714285714284,7,11
"['0101101', '10', '11']",1,3,4,7,2,11,1.3888888888888888,11,6
"['11011', '111', '1001', '1101011', '00', '10']",1,6,8,15,2,23,8.128066378066379,42,51
"['101001', '101', '000000']",1,3,10,5,2,15,1.222222222222222,11,7
"['101', '110', '011', '1111']",1,4,3,10,3,13,3.714285714285714,12,19
"['0001', '000011', '10', '0111']",1,4,9,7,2,16,2.8166666666666664,18,15
"['0010110', '110010', '0000001']",1,3,13,7,2,20,1.5054945054945055,11,8
"['0001', '100011', '01111', '1110']",1,4,8,11,2,19,3.1065656565656568,18,16
"['1011', '01', '11']",1,3,2,6,2,8,1.8333333333333333,5,10
"['01101', '11', '100', '00000']",1,4,9,6,2,15,2.3714285714285714,19,12
"['010', '1', '10000']",1,3,6,3,0,9,1.3333333333333333,9,4
"['0', '11001', '00101', '10001', '1101110', '111000']",1,6,14,15,3,29,7.8177655677655675,52,37
"['11', '100', '001010', '0100']",1,4,9,6,0,15,3.557142857142857,15,14
"['0010101', '0110010', '0011', '01010']",1,4,13,10,2,23,3.844155844155844,16,19
"['110000', '1111100', '001', '11', '110']",1,5,9,12,2,21,5.204273504273504,35,33
"['1110011', '010010', '000000', '0100101', '0100']",1,5,19,11,4,30,5.994705294705295,29,33
"['100001', '00101', '1111001', '00', '01100', '1110']",1,6,15,14,2,29,7.931979131979132,48,37
"['01', '0111111', '0110', '1001011']",1,4,7,13,2,20,3.075036075036075,24,15
"['111', '000011', '101', '110100', '0000101', '0111', '110', '111001']",1,8,17,21,6,38,16.424941724941725,88,98
"['0010010', '11101', '1100101', '00']",1,4,11,10,2,21,2.888888888888889,23,13
"['0110010', '01', '100', '011000']",1,4,11,7,0,18,3.534188034188034,19,21
"['1000100', '11011', '11', '101010', '10000', '100110', '00', '000100']",1,8,23,16,7,39,15.017743367743368,86,85
"['1100', '110', '1010011']",1,3,6,8,0,14,1.9844155844155844,8,10
"['0101', '01001', '0111010', '0111']",1,4,9,11,2,20,4.078282828282828,13,22
"['001001', '10010', '000', '0111']",1,4,11,7,0,18,3.474098124098124,17,14
"['110001', '000', '11']",1,3,6,5,0,11,1.1666666666666665,10,6
"['0', '01', '11101']",1,3,3,5,0,8,1.5714285714285714,8,5
"['0', '00001', '111101', '11']",1,4,6,8,0,14,1.7683982683982684,23,13
"['0010', '1', '110111']",1,3,4,7,0,11,1.0857142857142859,12,4
"['001', '11', '1110100', '110', '01000']",1,5,10,10,2,20,4.93015873015873,33,26
"['1001100', '101', '010', '011']",1,4,8,8,3,16,3.5999999999999996,17,12
"['111100', '10001', '100', '0010101', '10']",1,5,12,11,0,23,5.83953268953269,33,29
"['1111011', '000001', '101101']",1,3,8,11,2,19,1.4102564102564104,10,9
"['101001', '111101', '0111011']",1,3,6,13,2,19,1.8846153846153846,7,10
"['1111011', '111', '000', '0100']",1,4,7,10,2,17,2.020779220779221,22,16
"['01', '101110', '111']",1,3,3,8,0,11,1.5666666666666667,9,6
"['10100', '110', '011', '11010']",1,4,7,9,4,16,3.716666666666667,14,17
"['0111000', '11001', '00000', '111110', '0111', '0101', '0011100']",1,7,19,19,6,38,12.01063936063936,66,62
"['0001010', '00', '101', '111']",1,4,8,7,2,15,2.511111111111111,20,10
"['0', '110010', '000101']",1,3,8,5,2,13,1.2380952380952381,13,6
"['011010', '100001', '110100', '0100']",1,4,13,9,3,22,3.6666666666666665,16,14
"['00110', '111000', '01000']",1,3,10,6,2,16,1.8727272727272726,9,13
"['11001', '00', '001']",1,3,6,4,0,10,2.1214285714285714,6,8
"['01111', '10010', '0101100', '0000111', '01011']",1,5,14,15,5,29,5.838095238095238,30,31
"['1110010', '1', '1001', '010111', '0100011']",1,5,11,14,2,25,5.042457542457543,38,28
"['11110', '110', '10110', '0111110']",1,4,6,14,2,20,4.4,14,27
"['11110', '010', '101', '10001', '110011']",1,5,9,13,4,22,5.7005050505050505,29,25
"['0', '0001', '1001', '1111']",1,4,6,7,3,13,2.3,16,12
"['10100', '10', '111']",1,3,4,6,0,10,1.4714285714285715,8,7
"['1011010', '011011', '00100', '10', '0111', '0101']",1,6,13,15,2,28,9.23106338106338,41,37
"['1100', '10110', '1111']",1,3,4,9,2,13,1.6111111111111112,6,8
"['00', '010', '001', '000011']",1,4,10,4,2,14,3.8777777777777778,15,19
"['10100', '010011', '1110']",1,3,7,8,0,15,1.5717171717171716,9,7
"['0', '00100', '001001', '1010101']",1,4,12,7,0,19,3.214035964035964,21,16
"['110', '0101011', '0000101', '1010', '1000011', '0101', '1100', '01000', '0100']",1,9,26,19,7,45,22.477417027417026,103,105
"['011', '100', '110100', '00', '0111111', '1100', '001011']",1,7,14,17,4,31,10.85972915972916,72,73
"['0100011', '1', '1001101']",1,3,7,8,2,15,1.2142857142857144,15,8
"['01101', '0111001', '00101', '101', '11100']",1,5,11,14,3,25,6.366666666666667,24,32
"['11', '10000', '000', '0010010', '11100']",1,5,14,8,2,22,4.918253968253968,33,31
"['01001', '1100', '1', '1110']",1,4,6,8,2,14,2.9944444444444445,16,13
"['0011', '0001', '1100']",1,3,7,5,3,12,1.75,8,10
"['01', '00', '111001']",1,3,5,5,2,10,1.5,9,5
"['100001', '111100', '111', '10110', '010010', '1100100', '00110', '1100011', '01011', '1110']",1,10,25,29,8,54,27.692951492951494,130,137
"['0', '1101', '10', '0111100']",1,4,6,8,0,14,2.973232323232323,21,10
"['101011', '01101', '1011']",1,3,5,10,0,15,2.012121212121212,8,13
"['1110110', '001110', '1011000']",1,3,9,11,2,20,1.9450549450549453,9,9
"['10100', '01011', '10011', '1101010']",1,4,10,12,3,22,4.166666666666667,16,17
"['01', '100010', '0100']",1,3,8,4,0,12,1.7666666666666666,9,7
"['1101', '001', '10', '1000']",1,4,7,6,2,13,3.376190476190476,12,15
"['0', '0110000', '0111001', '1001101']",1,4,12,10,3,22,2.607142857142857,28,13
"['11', '001', '0001100', '00001']",1,4,11,6,0,17,3.1468253968253967,20,18
"['100', '01111', '1101101', '10100', '100000', '0111', '01110']",1,7,16,19,3,35,11.187656787656788,64,61
"['00110', '1', '001110', '0000']",1,4,10,6,0,16,2.794805194805195,19,21
"['0010110', '011', '11101', '10', '11100']",1,5,9,13,2,22,5.553968253968254,32,25
"['10111', '0101', '11']",1,3,3,8,0,11,1.9047619047619047,7,10
"['10', '0111', '0000', '00010', '110', '01100']",1,6,14,9,4,23,7.811111111111111,37,49
"['01', '11011', '10000', '0001011', '01110']",1,5,12,12,3,24,5.106349206349206,36,25
"['1', '10011', '0000']",1,3,6,4,0,10,0.7777777777777777,11,4
"['10001', '100', '0100', '101001', '1110']",1,5,12,10,2,22,6.383621933621933,22,26
"['00001', '101000', '10101', '11']",1,4,10,8,2,18,3.0298701298701296,18,20
"['1000000', '000110', '01', '1111001']",1,4,13,9,2,22,2.672161172161172,27,13
"['11110', '111', '00001']",1,3,5,8,2,13,1.2,11,10
"['01', '1000110', '0001']",1,3,8,5,0,13,1.8383838383838382,10,7
"['0011', '1', '00011']",1,3,5,5,0,10,1.6222222222222222,8,10
"['0010111', '110001', '1010', '000', '101111', '0101', '110', '111101']",1,8,16,23,7,39,15.656304806304806,86,80
"['0010110', '11', '00011', '10101', '100100', '110', '01100']",1,7,17,16,3,33,12.64058719058719,62,53
"['0010', '00100', '1011101', '10', '001100', '110']",1,6,15,12,0,27,9.57945387945388,42,47
"['0100110', '101', '100011', '10', '10011']",1,5,11,12,0,23,6.644194694194694,28,31
"['01111', '0001', '1100', '0001000']",1,4,12,8,2,20,2.994949494949495,21,21
"['010100', '00', '01001', '110']",1,4,10,6,0,16,3.1431457431457432,17,18
"['01', '001', '0101110', '10000']",1,4,10,7,0,17,2.9301587301587304,21,15
"['011100', '11', '10100', '00', '0111100']",1,5,11,11,2,22,5.348762348762349,32,37
"['000110', '0010000', '00110', '11101', '10']",1,5,15,10,2,25,5.757231657231657,34,33
"['0', '101100', '0010']",1,3,7,4,0,11,1.0857142857142859,11,9
"['0110101', '1101', '00']",1,3,6,7,0,13,1.505050505050505,11,6
"['001', '1011', '110', '111101', '111001']",1,5,7,15,4,22,5.953968253968254,27,37
"['1', '10110', '1101100', '1000010', '010111', '1000011']",1,6,16,17,3,33,7.812437562437562,58,43
"['101100', '0100000', '100100', '1110100', '1101']",1,5,17,13,4,30,6.131568431568431,27,30
"['101', '0110', '0000001']",1,3,9,5,0,14,1.335064935064935,13,5
"['1011', '010111', '111010']",1,3,5,11,2,16,1.9,9,10
"['1001110', '0010111', '0101101', '1000010', '1000', '00']",1,6,19,15,4,34,8.98989898989899,56,43
"['0011001', '11011', '101110']",1,3,7,11,0,18,1.8426573426573427,9,6
"['101', '1010', '0111']",1,3,4,7,2,11,1.9285714285714284,6,8
"['110000', '01', '0']",1,3,6,3,0,9,1.2023809523809523,11,6
"['10001', '10110', '0100']",1,3,8,6,2,14,1.9333333333333331,8,5
"['110011', '0100000', '10101', '01']",1,4,11,9,0,20,3.2046842046842046,23,12
"['010', '000', '11']",1,3,5,3,2,8,1.0666666666666667,6,4
"['00111', '010000', '110', '10']",1,4,9,7,0,16,2.893795093795094,20,15
"['010', '011', '10111', '0001', '110111', '10', '0011100']",1,7,13,17,2,30,12.00088245088245,62,51
"['1000001', '101100', '0101', '00000', '01001', '011010']",1,6,21,12,4,33,8.917016317016317,41,39
"['11', '00', '0010011']",1,3,6,5,2,11,0.8888888888888888,12,8
"['001', '1', '11000', '0000', '1101']",1,5,10,7,2,17,4.45952380952381,27,28
"['0001', '1010101', '1001000', '0100', '110101']",1,5,16,12,4,28,5.962537462537463,28,29
"['000001', '100011', '0010100', '01110']",1,4,15,9,2,24,3.1655011655011656,20,12
"['01001', '100', '1']",1,3,5,4,0,9,1.5833333333333333,8,6
"['00111', '100', '1111110', '111']",1,4,5,13,2,18,3.0833333333333335,21,23
"['01', '11011', '111100', '1100001', '00', '111000']",1,6,13,15,4,28,7.721556221556222,51,45
"['110110', '0101', '1', '0100']",1,4,7,8,2,15,3.0357142857142856,18,12
"['11110', '10001', '001011', '11']",1,4,7,11,2,18,2.951948051948052,21,19
"['010', '101', '110001', '100', '0100001', '110', '0111110']",1,7,16,16,6,32,12.303785103785103,69,54
"['0010110', '101011', '00', '111']",1,4,8,10,0,18,2.558119658119658,21,12
"['1100011', '00', '010001', '0101100']",1,4,13,9,2,22,3.498778998778999,24,14
"['01', '010000', '00001']",1,3,10,3,0,13,1.7987012987012987,9,11
"['0', '110010', '10001', '0100100', '11111', '0101', '001011']",1,7,17,17,4,34,10.426245976245976,73,47
"['001011', '111101', '00000']",1,3,9,8,2,17,1.2272727272727273,12,7
"['1001001', '0001', '111011']",1,3,8,9,0,17,1.5608391608391607,10,10
"['0', '1011', '010000', '0110']",1,4,9,6,2,15,2.835714285714286,20,13
"['11010', '1', '000']",1,3,5,4,0,9,0.8333333333333333,10,4
"['001001', '100011', '0111']",1,3,8,8,2,16,1.8666666666666667,9,7
"['0011101', '1', '000000', '110']",1,4,10,7,0,17,2.0337606837606836,27,12
"['11', '00001', '1101101', '01010', '110']",1,5,10,12,2,22,4.851587301587301,33,26
"['11001', '0010', '10']",1,3,6,5,0,11,1.9047619047619047,8,5
"['0011011', '110001', '101', '11111']",1,4,7,14,0,21,3.44032634032634,20,24
"['1', '111010', '00100', '110011', '10100']",1,5,11,12,4,23,5.25021645021645,33,24
"['01', '10', '1001101']",1,3,5,6,2,11,1.3888888888888888,12,8
"['1', '0011000', '101', '10011', '011010']",1,5,11,11,0,22,5.167066267066267,36,17
"['0101010', '0001', '1011100']",1,3,10,8,2,18,1.4415584415584415,11,7
"['1011001', '001001', '11', '011010', '1001', '0011111', '0000010', '111000', '01110']",1,9,25,25,6,50,21.024053724053722,120,96
"['0', '101100', '011110']",1,3,6,7,2,13,1.2380952380952381,13,8
"['0010', '0010111', '101', '111011', '11101', '000']",1,6,12,16,2,28,8.446986346986346,45,45
"['10001', '10', '000']",1,3,7,3,0,10,1.7214285714285715,7,5
"['11001', '1000', '110', '0001']",1,4,9,7,2,16,3.6904761904761902,13,18
"['001', '011', '1001000', '000101', '110111', '1100111', '1110', '0100']",1,8,19,21,8,40,15.67974247974248,89,81
"['0', '10001', '010100', '0010000']",1,4,14,5,0,19,2.8503996003996,23,14
"['0011', '1000110', '0001101', '000', '011001']",1,5,16,11,2,27,6.5121767121767125,31,28
"['0101', '100', '001010']",1,3,8,5,0,13,2.038095238095238,7,7
"['1000100', '11', '100100', '10', '1100', '01110']",1,6,14,12,2,26,8.297247197247197,44,43
"['110000', '11010', '0100111', '00011', '101010', '000000', '1001011']",1,7,24,18,7,42,12.442457542457543,63,68
"['00111', '01001', '1101111']",1,3,6,11,2,17,1.7666666666666666,10,9
"['01', '111', '00000', '1001', '100010']",1,5,12,8,0,20,4.83997113997114,30,21
"['010', '010000', '1011', '1101', '101001']",1,5,12,11,4,23,6.0928571428571425,27,22
"['0', '101', '011010', '100']",1,4,7,6,2,13,3.2857142857142856,16,11
"['11011', '010', '10101', '1011100', '0111', '1100011', '001011']",1,7,15,22,4,37,13.584232434232433,62,64
"['0010110', '110010', '0111001', '00011', '110011', '110111']",1,6,16,21,5,37,9.746753246753247,42,50
"['11001', '01101', '111100', '11', '10', '0000111']",1,6,11,16,4,27,8.153313353313353,54,44
"['101011', '11100', '11']",1,3,4,9,0,13,1.6168831168831168,10,13
"['010100', '100', '111101']",1,3,7,8,2,15,1.6111111111111112,10,6
"['101', '00', '0001', '0111']",1,4,7,6,2,13,3.0428571428571427,13,13
"['011100', '00', '011', '01010']",1,4,9,7,0,16,3.615367965367965,16,24
"['00111', '10101', '1111', '11101', '00010', '0101', '0100']",1,7,14,18,7,32,12.455555555555556,47,60
"['0010', '10111', '1110101', '100000', '10']",1,5,12,12,0,24,5.264280164280164,35,25
"['010100', '01001', '1']",1,3,7,5,0,12,1.3463203463203464,11,6
"['0011001', '001', '111101']",1,3,7,9,0,16,1.6598290598290597,11,12
"['0', '00101', '1110']",1,3,5,5,0,10,1.1777777777777778,10,6
"['0011001', '1', '10']",1,3,5,5,0,10,1.3611111111111112,12,6
"['110000', '010011', '1', '10']",1,4,8,7,2,15,2.738095238095238,22,13
"['01', '100001', '111011']",1,3,6,8,2,14,1.5,11,9
"['0', '0100110', '11']",1,3,5,5,0,10,0.6944444444444444,13,4
"['01000', '0110111', '111010', '0101001']",1,4,12,13,2,25,3.657176157176157,19,18
"['11001', '00', '0011111']",1,3,6,8,0,14,1.5158730158730158,12,7
"['10111', '0001', '101', '01000']",1,4,9,8,2,17,3.3325396825396822,16,15
"['0111010', '111', '101010', '0001100', '00', '00110']",1,6,16,14,2,30,7.781829281829282,51,47
"['100110', '10111', '1110', '11']",1,4,5,12,0,17,3.932034632034632,15,23
"['010', '010001', '1110010', '010111', '0101100', '1011011', '110']",1,7,18,21,7,39,13.144566544566544,69,65
"['011111', '10111', '1000', '000']",1,4,8,10,0,18,2.701082251082251,20,17
"['01', '111100', '001101', '10110', '01111', '110100', '0000000', '111000']",1,8,22,21,6,43,14.776268176268177,98,85
"['11100', '1000111', '111001']",1,3,7,11,0,18,2.0244755244755246,10,16
"['00', '01111', '011']",1,3,4,6,0,10,1.4357142857142857,8,9
"['1101001', '11011', '1', '1010100', '00010', '0110001']",1,6,16,16,5,32,8.07857142857143,56,37
"['00101', '11', '00110', '0101001', '01110']",1,5,12,12,3,24,6.192063492063492,28,24
"['011010', '0111110', '0111']",1,3,6,11,0,17,2.2965034965034965,7,16
"['00100', '01101', '1', '0111']",1,4,7,8,2,15,3.0,17,12
"['110', '1011001', '10', '000']",1,4,8,7,2,15,2.977777777777778,18,12
"['001', '0001110', '1']",1,3,6,5,0,11,1.35,12,5
"['001', '1000110', '01111', '0010100', '000', '00010']",1,6,19,11,6,30,8.645238095238096,46,53
"['000110', '00', '11']",1,3,6,4,2,10,1.0,10,6
"['11', '1001', '0110000', '00', '0111', '0100']",1,6,13,10,5,23,7.79040404040404,44,37
"['11', '11000', '1010000', '1010001', '001011']",1,5,15,12,2,27,5.924686424686425,33,36
"['1', '100111', '000']",1,3,5,5,0,10,0.7301587301587301,12,4
"['0', '0101100', '0101001']",1,3,9,6,2,15,1.3571428571428572,14,11
"['110001', '110', '00101', '010110']",1,4,10,10,2,20,3.606060606060606,19,15
"['0000010', '01010', '0101', '1100', '0100']",1,5,16,8,3,24,6.398989898989899,24,39
"['100', '100011', '111011']",1,3,6,9,2,15,1.7777777777777777,9,13
"['00', '11011', '0001']",1,3,6,5,0,11,1.3968253968253967,9,6
"['101100', '1', '101011', '0000', '111000']",1,5,12,11,3,23,4.257142857142857,37,28
"['1000001', '0100111', '1011001', '0101101', '101011', '10010', '001011', '0110110']",1,8,25,27,7,52,18.94905094905095,79,79
"['11011', '00011', '0110', '000001', '000', '000111', '0100101']",1,7,21,15,4,36,13.262104562104561,57,68
"['1101001', '111', '0100', '0']",1,4,7,8,0,15,2.262987012987013,22,10
"['1', '10000', '1110']",1,3,5,5,0,10,1.1777777777777778,10,6
"['0', '101', '0110010', '01101']",1,4,8,8,0,16,3.2666666666666666,20,15
"['110011', '1010000', '101', '000011']",1,4,12,10,2,22,3.6085470085470086,20,23
"['010', '111100', '010000', '00', '0110010', '1110']",1,6,16,12,2,28,8.182695082695083,47,57
"['0', '100001', '0111']",1,3,6,5,0,11,1.0857142857142859,12,4
"['111', '10101', '1100100', '100010', '10', '010011']",1,6,14,15,2,29,8.827256077256077,47,41
"['00', '0111', '001000']",1,3,8,4,0,12,1.2333333333333334,11,12
"['101101', '101010', '101000', '11000', '10110', '011010']",1,6,17,17,6,34,11.281818181818181,30,51
"['1000', '000111', '10']",1,3,7,5,0,12,1.5166666666666666,11,9
"['111', '1011110', '1101', '0110001', '0111100']",1,5,10,18,3,28,6.618181818181818,33,23
"['011', '11', '110001', '001110', '100011', '1101']",1,6,11,16,3,27,9.315873015873017,46,51
"['1111', '100', '0100']",1,3,5,6,2,11,1.3928571428571428,7,6
"['01', '1', '10010', '000', '1001111']",1,5,9,9,0,18,4.482539682539683,34,21
"['0100001', '01', '011']",1,3,7,5,0,12,1.8444444444444446,10,10
"['10101', '11010', '000010']",1,3,9,7,2,16,1.8909090909090909,8,6
"['01101', '001', '000', '1010011']",1,4,10,8,2,18,3.1666666666666665,17,13
"['11100', '1111000', '1110']",1,3,6,10,0,16,2.4494949494949494,6,14
"['01', '011', '111', '1011101', '1001', '000100']",1,6,11,14,2,25,8.276112776112775,46,37
"['01101', '1', '010010']",1,3,6,6,0,12,1.3463203463203464,11,5
"['1010100', '010101', '110', '001001']",1,4,12,10,2,22,3.660683760683761,18,14
"['000110', '00101', '00100', '10', '000', '010110']",1,6,18,9,4,27,9.91861471861472,38,64
"['11', '1101110', '10100', '01001', '111000']",1,5,11,14,2,25,5.942080142080142,32,26
"['0011', '0010010', '100']",1,3,9,5,0,14,1.8987012987012988,10,10
"['000110', '1011001', '1', '0100110', '00001', '1110011', '111011']",1,7,18,21,5,39,11.672410922410922,76,55
"['010011', '1100', '10010', '0111']",1,4,9,10,2,19,3.5383838383838384,15,16
"['0010', '01', '011', '111', '100']",1,5,7,8,3,15,5.0285714285714285,20,22
"['001', '0101110', '11000', '001110', '1011000']",1,5,15,13,2,28,6.098201798201798,32,36
"['101100', '00', '10101', '011000']",1,4,11,8,2,19,3.6774891774891776,19,17
"['001', '011', '101', '111110', '010101']",1,5,8,13,5,21,5.222222222222222,30,26
"['001', '1000101', '100', '100101', '0001000']",1,5,17,9,4,26,6.652747252747252,31,35
"['0', '11000', '10011']",1,3,6,5,2,11,1.2666666666666666,11,5
"['00', '011100', '11']",1,3,5,5,2,10,1.0,10,6
"['0', '110100', '010101', '111110', '1100', '01011']",1,6,12,16,3,28,7.353102453102453,48,42
"['01', '1', '0101100', '00000']",1,4,10,5,0,15,1.98015873015873,24,13
"['00011', '010', '11100', '11']",1,4,7,8,2,15,2.942857142857143,19,16
"['11101', '10', '01000', '00011']",1,4,9,8,3,17,2.8285714285714283,20,13
"['1010110', '011', '111']",1,3,4,9,2,13,1.6666666666666665,9,8
"['1111100', '110110', '1001', '10']",1,4,7,12,0,19,3.371950271950272,21,15
"['1001', '11100', '000']",1,3,7,5,0,12,1.7380952380952381,8,6
"['0010111', '111', '01111', '1010001', '1110110', '1001011', '1101010']",1,7,16,27,5,43,12.788095238095238,67,79
"['100110', '01', '000', '1101010']",1,4,10,8,0,18,3.0726495726495724,20,13
"['11001', '1101', '0000']",1,3,7,6,2,13,1.5833333333333333,7,7
"['0011', '101111', '11']",1,3,3,9,0,12,1.7666666666666666,9,13
"['101', '10101', '100100']",1,3,7,7,0,14,2.143939393939394,7,14
"['100', '000101', '110011', '1000', '01110']",1,5,13,11,2,24,5.87027417027417,30,24
"['010', '0110111', '100', '10110', '0110', '1010', '110']",1,7,13,16,5,29,14.888600288600289,44,69
"['010000', '1111000', '1111010', '001010', '100111', '011111']",1,6,17,21,6,38,8.652014652014651,51,52
"['01', '10100', '001']",1,3,6,4,0,10,1.8714285714285714,7,8
"['1011', '1010100', '11101']",1,3,6,10,0,16,1.893939393939394,8,11
"['1111000', '10101', '10', '11111']",1,4,6,13,2,19,3.068253968253968,21,21
"['1000101', '1001111', '000']",1,3,9,8,2,17,1.7142857142857144,11,6
"['01', '010', '11000', '100', '0101011']",1,5,11,9,2,20,5.38015873015873,31,26
"['00011', '01001', '110', '0001111']",1,4,10,10,2,20,3.7,20,19
"['01', '11010', '1111101', '0']",1,4,5,10,0,15,2.9325396825396823,22,12
"['0001101', '110111', '1', '001101']",1,4,8,12,2,20,3.0265567765567765,23,20
"['1101000', '1001000', '0010', '111111']",1,4,12,12,2,24,3.099100899100899,22,18
"['0011', '111011', '0001100', '1000', '10']",1,5,12,11,2,23,5.178710178710179,36,28
"['101', '01001', '001001', '11']",1,4,8,8,0,16,4.197186147186147,14,20
"['1010', '100', '111']",1,3,4,6,2,10,1.7619047619047619,5,7
"['1010110', '1000', '111100', '1110']",1,4,9,12,2,21,4.123776223776224,16,18
"['0101000', '1', '001000', '00001', '101', '1000', '010101']",1,7,21,11,2,32,11.39930624930625,64,66
"['100', '10000', '1100011', '0101', '1110']",1,5,12,11,2,23,5.639321789321789,30,25
"['00111', '0011', '11000', '01101']",1,4,9,10,3,19,3.8,17,20
"['00', '1', '0001000']",1,3,8,2,0,10,0.6944444444444444,13,8
"['0', '11011', '0010111', '00101', '010000']",1,5,13,11,2,24,4.673010323010323,38,26
"['111000', '01011', '1111111', '00011']",1,4,8,15,2,23,2.837296037296037,23,26
"['11001', '01', '1000']",1,3,6,5,0,11,1.5714285714285714,8,7
"['00101', '10011', '000011', '11']",1,4,9,9,2,18,3.897402597402597,16,22
"['0001001', '0010', '0011', '101000', '100100', '11111', '1101']",1,7,19,17,5,36,11.78006993006993,64,59
"['1110001', '01', '11']",1,3,4,7,2,11,1.3888888888888888,11,11
"['1010', '100', '1100', '111']",1,4,6,8,4,14,3.9404761904761902,10,17
"['110110', '010', '001', '0101111', '00011', '10', '1100110', '0001010']",1,8,20,20,5,40,16.247713397713397,91,85
"['101', '0111001', '100', '1101000']",1,4,10,10,4,20,3.638095238095238,20,15
"['010', '1111101', '011', '00001', '11', '100', '100101']",1,7,13,16,3,29,10.690997890997892,67,55
"['11011', '1001', '0010100', '1111', '001100']",1,5,12,14,2,26,5.933177933177933,31,26
"['11010', '0110111', '001101', '00011', '00']",1,5,12,13,2,25,5.877744477744478,32,28
"['001', '111', '011110']",1,3,4,8,2,12,1.4444444444444444,9,4
"['1110111', '01', '0101111', '001110']",1,4,7,15,2,22,3.487789987789988,23,15
"['110000', '010010', '100111', '01001', '0101']",1,5,15,12,3,27,6.704040404040404,26,28
"['1010', '0111001', '11111']",1,3,5,11,0,16,1.6565656565656566,10,6
"['01', '101', '1100100', '00010', '1100', '1110']",1,6,13,12,2,25,8.303679653679653,42,39
"['101', '11110', '100001']",1,3,6,8,0,14,1.5303030303030303,10,10
"['111', '010010', '10100', '0111', '1010001']",1,5,12,13,0,25,6.321323121323121,30,27
"['0', '1010100', '110001', '01011']",1,4,10,9,0,19,2.5147352647352648,24,11
"['1101', '11100', '000']",1,3,6,6,0,12,1.4523809523809523,8,7
"['100', '1111000', '1001101', '10', '1001100', '1010000']",1,6,18,15,4,33,9.12063492063492,54,54
"['110000', '11110', '001101', '1000110', '0010100', '0100011', '0111101', '1011111']",1,8,24,28,7,52,16.58907758907759,93,75
"['0', '11000', '011010', '0000010']",1,4,13,6,0,19,2.7117049617049616,24,22
"['1101', '0010100', '01110']",1,3,8,8,0,16,1.8787878787878787,10,4
"['101011', '10101', '10000']",1,3,8,8,2,16,2.0545454545454547,6,14
"['1110111', '0011001', '00110', '11101', '0001000']",1,5,15,16,5,31,6.004761904761905,34,31
"['101110', '100110', '001011', '10011']",1,4,10,13,3,23,4.53030303030303,12,22
"['00', '011', '111101']",1,3,4,7,0,11,1.0944444444444446,11,5
"['0', '0110', '000101']",1,3,7,4,0,11,1.2857142857142856,11,8
"['11010', '111110', '10']",1,3,4,9,0,13,1.6168831168831168,9,10
"['101', '1010', '0100011', '01111']",1,4,8,11,0,19,3.447041847041847,18,16
"['00001', '1000', '110001', '11']",1,4,10,7,0,17,3.312987012987013,17,21
"['001', '100', '01110', '00010', '1001011']",1,5,13,10,4,23,5.883333333333333,30,24
"['1', '0010000', '0011', '0111111', '00010']",1,5,13,11,2,24,4.276623376623377,42,26
"['100', '001110', '101001', '00000']",1,4,13,7,2,20,3.02020202020202,20,16
"['01', '0011101', '111100', '1110011', '1111', '1101']",1,6,9,21,4,30,9.154023754023754,48,62
"['01', '001111', '00100', '101', '1100']",1,5,10,10,0,20,5.332756132756133,29,27
"['0', '0010110', '01101', '11000', '010111', '101111', '101001']",1,7,16,20,5,36,11.007842157842157,70,47
"['1110111', '01101', '11', '00111', '01111', '1000', '1011000']",1,7,13,22,5,35,11.776623376623377,69,71
"['1101001', '01', '00000', '101', '0100']",1,5,13,8,0,21,5.123304473304473,31,22
"['0100111', '00100', '10110', '0010011', '1101']",1,5,14,14,4,28,6.128860028860029,31,26
"['101', '1010100', '1111']",1,3,5,9,0,14,1.7168831168831167,10,10
"['1101011', '1111010', '11101', '01001', '1101']",1,5,9,19,4,28,6.768831168831169,24,43
"['101010', '101', '110100', '1000010', '11101']",1,5,13,14,2,27,6.52016317016317,27,31
"['01', '1011', '0010', '00001']",1,4,9,6,2,15,3.515873015873016,14,12
"['0010', '1001010', '0000101', '110', '0001000']",1,5,19,9,3,28,6.096103896103896,33,33
"['1011', '00', '111', '111001']",1,4,5,10,0,15,2.6714285714285713,17,19
"['11011', '01101', '0110', '0111']",1,4,6,12,4,18,4.661111111111111,10,19
"['1010100', '0000010', '011100', '101101']",1,4,15,11,4,26,3.402930402930403,19,16
"['0001011', '00', '1001110']",1,3,9,7,2,16,1.6031746031746033,13,8
"['11', '1001', '10100', '10', '00010', '0100011']",1,6,14,11,4,25,8.716161616161616,45,35
"['100', '10', '10011']",1,3,5,5,0,10,2.1214285714285714,6,10
"['1000101', '101', '100', '00', '001110', '110']",1,6,13,11,3,24,8.315384615384616,45,39
"['1100001', '0110111', '01110', '11']",1,4,8,13,2,21,3.198412698412698,25,17
"['0101', '00', '01101', '10']",1,4,7,6,2,13,3.8650793650793647,12,15
"['011', '101000', '1000110', '0001', '00', '0101']",1,6,16,10,2,26,8.738905538905538,43,39
"['01', '11011', '110', '111010']",1,4,5,11,0,16,3.615367965367965,16,19
"['0', '101100', '1011001', '111']",1,4,7,10,0,17,2.5032356532356532,22,15
"['101100', '1', '101', '000']",1,4,7,6,2,13,2.2301587301587302,18,14
"['1011', '01', '1111001']",1,3,4,9,0,13,1.6565656565656566,11,10
"['010001', '111', '1100000', '0110', '010010', '0000', '011111']",1,7,20,16,5,36,11.071506271506271,69,65
"['11', '1101110', '00', '100101', '000001']",1,5,12,11,4,23,4.061965811965812,39,23
"['011', '01111', '0110', '00001']",1,4,8,9,2,17,3.6182539682539683,14,19
"['011101', '101100', '001']",1,3,7,8,2,15,1.5555555555555554,10,8
"['100', '1', '1110000', '00000']",1,4,11,5,0,16,2.5166666666666666,23,19
"['00001', '01111', '1111000', '11101', '10010', '0111', '1011']",1,7,14,21,6,35,12.247979797979797,62,68
"['101010', '0000', '110101', '01001', '0101', '1111011']",1,6,15,17,4,32,9.333100233100232,42,37
"['01', '100', '0000']",1,3,7,2,0,9,1.3047619047619048,7,8
"['01', '0100111', '011', '100', '0101010']",1,5,11,11,4,22,5.536507936507936,35,28
"['0010', '1101', '10100', '10', '1110110']",1,5,10,12,2,22,6.121933621933621,29,24
"['10001', '01010', '1', '1111101']",1,4,7,11,2,18,2.5166666666666666,25,13
"['1001010', '10001', '10', '000001', '000111']",1,5,16,10,2,26,5.5473415473415475,33,30
"['11001', '0', '0100111', '001110', '10']",1,5,10,11,0,21,5.0329392829392825,38,20
"['1010', '0100000', '01101', '101001']",1,4,13,9,0,22,3.672960372960373,18,15
"['1000', '00', '011', '10011']",1,4,8,6,0,14,3.34047619047619,14,16
"['110110', '11110', '1110101', '10010', '0111']",1,5,9,18,2,27,6.031857031857031,25,33
"['1001110', '1011010', '11110', '1', '1110001']",1,5,10,17,3,27,5.392857142857142,39,30
"['00111', '1', '0110']",1,3,4,6,0,10,1.4,9,4
"['010100', '1', '101', '100', '010101', '1100011']",1,6,13,13,4,26,8.265018315018315,49,39
"['01', '1111001', '1110101', '0110000', '00']",1,5,12,13,5,25,5.166666666666666,39,24
"['01100', '01', '0101011', '011110']",1,4,9,11,0,20,3.2046842046842046,20,21
"['100', '000101', '111', '0110011']",1,4,9,10,2,19,3.191452991452991,21,15
"['110010', '111101', '0000']",1,3,8,8,2,16,1.4666666666666666,11,5
"['000110', '110', '001010']",1,3,9,6,2,15,1.9444444444444444,8,13
"['1001', '1', '0111']",1,3,3,6,2,9,1.3,9,8
"['0101', '100011', '1', '0100']",1,4,8,7,2,15,3.0357142857142856,19,12
"['10111', '1', '0000001', '010110']",1,4,10,9,0,19,2.2373459873459876,26,10
"['0000101', '101', '0011101']",1,3,9,8,2,17,1.9142857142857141,10,13
"['01', '00110', '000001', '00001']",1,4,13,5,2,18,3.697402597402597,17,23
"['0', '1100010', '010']",1,3,7,4,0,11,1.35,12,10
"['0010', '0011101', '1']",1,3,6,6,0,12,1.3772727272727274,12,6
"['00', '1', '0100100', '0101001']",1,4,11,6,2,17,2.1031746031746033,26,14
"['101', '0011', '1101111', '01011']",1,4,6,13,0,19,4.022438672438672,16,20
"['0001101', '1000', '100', '110']",1,4,10,7,2,17,3.6406926406926408,17,18
"['10010', '1', '0000100']",1,3,9,4,0,13,1.25,13,4
"['0', '1010', '001', '110']",1,4,6,5,2,11,2.876190476190476,13,13
"['101100', '00', '1111']",1,3,5,7,0,12,0.9,11,6
"['101100', '100011', '000', '01100']",1,4,12,8,2,20,3.7323232323232323,17,19
"['10101', '00010', '110', '1110000']",1,4,11,9,2,20,3.3666666666666667,20,14
"['01', '0010111', '11']",1,3,4,7,2,11,1.3888888888888888,11,8
"['1001000', '00110', '00', '1010', '11111', '0101', '111101']",1,7,15,18,4,33,11.36023976023976,67,53
"['010101', '000001', '000010']",1,3,13,5,3,18,1.6666666666666667,7,10
"['0000011', '110001', '0010010', '00101']",1,4,16,9,2,25,3.847652347652348,17,17
"['0000', '11', '0101', '0100']",1,4,9,5,3,14,2.75,13,14
"['1111100', '1110010', '00011', '00111', '10', '011111', '111101']",1,7,13,25,6,38,11.496164946164946,74,75
"['0001010', '01', '1001000']",1,3,11,5,2,16,1.6031746031746033,12,8
"['011100', '1100001', '100', '0110', '1001', '10100', '1110']",1,7,17,16,3,33,13.571950271950271,56,55
"['101', '100', '01100']",1,3,6,5,2,11,1.9166666666666665,6,7
"['00', '110001', '010111']",1,3,7,7,2,14,1.5,11,5
"['00', '1', '00101']",1,3,5,3,0,8,0.9047619047619047,9,6
"['10000', '01', '011']",1,3,6,4,0,10,1.3357142857142859,9,7
"['11001', '00', '001', '10']",1,4,7,5,2,12,3.592857142857143,12,14
"['0111000', '1', '011011', '10100', '0101', '0110001']",1,6,15,15,2,30,8.378987678987679,53,40
"['1', '1001', '1010111', '0001011', '110']",1,5,9,13,2,22,4.758441558441558,38,30
"['0', '101010', '10010', '110', '111001']",1,5,10,11,2,21,5.137085137085137,31,24
"['1', '010010', '01100', '111100']",1,4,9,9,2,18,2.8593073593073592,22,14
"['0011', '0101', '111000', '01011']",1,4,9,10,2,19,3.6914141414141413,17,20
"['00111', '1110011', '10011']",1,3,6,11,2,17,2.3,8,17
"['1000', '0110', '0010']",1,3,8,4,3,12,1.75,6,10
"['0010010', '1100', '1', '1101']",1,4,8,8,2,16,2.709090909090909,21,13
"['0', '101', '011100']",1,3,5,5,0,10,1.2301587301587302,11,4
"['01', '111010', '11', '1000', '1110']",1,5,7,11,4,18,5.066666666666666,27,28
"['0', '01', '11011', '1111001', '1110100']",1,5,8,14,2,22,5.007936507936508,38,25
"['10101', '0110010', '0100011', '101110', '111101', '1110']",1,6,14,21,4,35,9.12919302919303,43,42
"['110110', '000110', '001111', '011', '100', '10010', '0101100', '011001']",1,8,21,21,6,42,17.48923853923854,85,79
"['0', '011100', '1100111', '01']",1,4,7,9,0,16,2.762210012210012,26,11
"['1110010', '0001', '100', '010011', '1111', '010110', '0111', '1011', '1101', '0101']",1,10,19,27,8,46,26.70912420912421,108,133
"['0111000', '1000', '1']",1,3,7,5,0,12,1.3772727272727274,12,7
"['01', '010', '011', '0000', '0100']",1,5,11,5,4,16,6.052380952380952,17,35
"['00100', '11010', '00010', '001111']",1,4,12,9,3,21,3.6363636363636362,17,23
"['00010', '1', '010111']",1,3,6,6,0,12,1.1645021645021645,12,4
"['10111', '1110011', '00101']",1,3,6,11,2,17,1.9333333333333331,9,11
"['1000001', '001', '1001', '1010', '10100', '100111', '000010']",1,7,21,14,4,35,13.515712065712066,57,69
"['0', '00110', '1000', '1100110', '1110']",1,5,11,10,2,21,5.322727272727272,31,32
"['100001', '1011101', '100', '1111110', '10']",1,5,10,15,2,25,5.492918192918193,38,31
"['11001', '11', '10111', '1000111', '001001', '0110011']",1,6,13,19,4,32,9.503374403374403,47,62
"['01', '010', '0010111', '1101011', '000010']",1,5,13,12,2,25,5.846764346764346,36,24
"['11110', '110', '0010101']",1,3,6,9,0,15,1.4833333333333334,10,9
"['01', '00110', '00', '100010']",1,4,10,5,2,15,3.37012987012987,17,17
"['11001', '11', '1001', '100000', '0000010', '10', '000001']",1,7,21,11,4,32,11.643750693750693,67,69
"['11001', '0011', '110010', '000000']",1,4,13,8,2,21,3.4393939393939394,18,18
"['1101001', '0100000', '110010', '0110011']",1,4,15,12,3,27,3.857142857142857,17,15
"['11001', '1000100', '0100110', '100100', '10110', '010101', '0111', '011111', '00010']",1,9,26,25,8,51,22.02030192030192,101,99
"['0010', '11010', '00111', '100', '110111']",1,5,10,13,2,23,6.053751803751804,28,33
"['00100', '11101', '111', '011100']",1,4,8,11,2,19,3.5212121212121215,16,15
"['1000111', '0110', '100001', '01100']",1,4,12,10,0,22,3.6490287490287487,20,14
"['010', '10', '000', '11']",1,4,6,4,4,10,2.7666666666666666,10,11
"['0', '11000', '100', '1111', '01110']",1,5,8,10,2,18,4.413492063492063,30,21
"['0', '1000', '11100']",1,3,6,4,0,10,1.4,9,7
"['1001', '0100100', '00000']",1,3,12,4,0,16,1.8383838383838382,8,6
"['001110', '10', '00101']",1,3,7,6,0,13,1.7987012987012987,9,9
"['0', '111', '1111000', '1101', '00010']",1,5,9,11,0,20,4.18037518037518,37,25
"['00111', '010', '111', '000']",1,4,7,7,3,14,2.75,14,16
"['0000101', '1101', '1001', '001010']",1,4,12,9,2,21,3.81013986013986,17,15
"['0011001', '00', '0101100']",1,3,10,6,2,16,1.746031746031746,12,13
"['0010', '0111111', '01010', '000', '01011', '1111111', '111001']",1,7,14,23,4,37,10.512226662226663,72,67
"['110010', '000011', '0110', '011101', '10011', '0011011', '1101']",1,7,17,21,5,38,13.871212121212121,59,62
"['0010', '1', '1110000', '10111', '10001', '1010001']",1,6,15,14,4,29,7.74963924963925,54,45
"['0010101', '1', '101111']",1,3,5,9,0,14,1.151098901098901,14,8
"['101', '010', '001', '0111']",1,4,6,7,3,13,3.714285714285714,11,12
"['01101', '111100', '010010', '00110', '1010', '0000']",1,6,17,13,6,30,8.98989898989899,39,46
"['11011', '101101', '01111', '00', '0111']",1,5,7,15,2,22,5.814862914862915,27,27
"['011011', '1010110', '1000', '1']",1,4,8,10,0,18,2.6783716283716283,24,13
"['101', '1010', '110', '1110']",1,4,5,9,4,14,4.023809523809524,8,19
"['10100', '11101', '000101']",1,3,8,8,2,16,1.690909090909091,8,9
"['1011', '0010', '101011']",1,3,6,8,2,14,1.9,7,9
"['00111', '001001', '0']",1,3,7,5,0,12,1.3463203463203464,11,8
"['110010', '11101', '110', '01100']",1,4,8,11,2,19,4.221212121212121,14,15
"['1000111', '001001', '10010', '1']",1,4,10,9,0,19,2.8783716283716285,25,16
"['1', '0101101', '1101110', '10011', '000', '01010']",1,6,13,15,4,28,7.564285714285714,54,31
"['100', '1001', '100101', '010111']",1,4,9,10,2,19,4.034920634920635,16,22
"['0101111', '00101', '001000', '11', '00', '0111100']",1,6,15,14,4,29,7.189116439116439,56,48
"['0101110', '111', '110100', '1011', '01110']",1,5,9,16,0,25,6.576207126207126,27,26
"['00011', '11', '10000', '1110101', '01011']",1,5,11,13,3,24,5.339682539682539,34,34
"['110000', '100', '1111', '110011', '010111', '10', '1101']",1,7,12,19,5,31,12.151587301587302,58,75
"['01', '00', '0001010', '01110', '001100']",1,5,14,8,2,22,5.694916194916194,32,42
"['0001110', '11100', '1100110']",1,3,9,10,2,19,2.0476190476190474,10,10
"['11001', '001', '011', '0110011']",1,4,8,10,2,18,3.95,16,20
"['010011', '00', '1']",1,3,5,4,0,9,0.7857142857142857,11,4
"['101011', '10001', '1111111', '1101011', '000', '1010010', '111101']",1,7,15,26,5,41,11.416500166500166,67,79
"['0', '010', '1110101', '0111110', '101001']",1,5,10,14,2,24,4.954578754578755,40,19
"['110000', '0011001', '10111', '00', '1110']",1,5,12,12,0,24,5.021300921300921,36,27
"['011', '1001010', '001010', '100111', '001110', '1100111', '1011011']",1,7,18,24,6,42,14.902564102564103,56,66
"['1111100', '110010', '10110', '1101011', '0101']",1,5,11,18,2,29,6.1924075924075925,31,27
"['0011', '010011', '1001', '1100001']",1,4,11,10,2,21,4.238111888111888,16,21
"['0011', '0010', '011', '0000001']",1,4,12,6,2,18,3.669480519480519,17,18
"['1000010', '1110011', '0010001', '1011111']",1,4,13,15,4,28,3.4285714285714284,20,18
"['110', '101010', '10001', '00', '1100']",1,5,11,9,0,20,5.933621933621933,24,24
"['0110010', '100001', '101101']",1,3,10,9,2,19,2.051282051282051,9,6
"['001', '0101111', '0110', '1111', '100110', '011111', '11100', '01011']",1,8,14,26,6,40,16.167010767010765,78,96
"['0', '1001010', '101101']",1,3,7,7,0,14,1.151098901098901,13,5
"['0101101', '001100', '00110', '111111']",1,4,10,14,2,24,3.6701631701631703,16,15
"['1000101', '01011', '011', '10']",1,4,8,9,0,17,3.4325396825396823,19,16
"['0', '111', '0100']",1,3,4,4,0,8,0.6857142857142857,9,4
"['0011011', '101', '01011', '0']",1,4,7,9,0,16,3.2666666666666666,20,13
"['01', '0010', '10101', '0000101', '0011111', '11100']",1,6,15,15,4,30,7.967965367965368,52,42
"['010100', '1110101', '11000']",1,3,9,9,0,18,2.0093240093240095,8,6
"['110', '10', '1111111']",1,3,2,10,0,12,1.4222222222222223,12,9
"['000011', '0111111', '11111', '001100', '01000']",1,5,13,16,4,29,4.956410256410257,36,36
"['010', '1', '110100']",1,3,5,5,0,10,1.4523809523809523,10,4
"['010100', '101001', '0100']",1,3,10,6,2,16,2.4333333333333336,6,9
"['0', '00011', '00100', '1001000', '1011']",1,5,14,8,2,22,4.906565656565657,35,27
"['1101', '10001', '111100', '1']",1,4,6,10,0,16,2.831168831168831,21,20
"['01101', '10001', '10101', '1110110', '100', '1110100', '0000', '01001']",1,8,21,20,6,41,17.139177489177488,78,77
"['011010', '0010101', '1101110']",1,3,9,11,2,20,2.10989010989011,9,7
"['1001110', '010001', '1101100']",1,3,10,10,2,20,1.6593406593406594,10,6
"['00111', '0010100', '100010']",1,3,11,7,0,18,1.8275058275058274,9,9
"['011', '111', '00111', '101', '01000']",1,5,8,11,5,19,5.65,25,27
"['00111', '01', '110100']",1,3,6,7,0,13,1.435064935064935,11,8
"['1101', '001011', '111010', '0110001']",1,4,10,13,2,23,3.7041958041958045,17,16
"['010100', '1001', '1110']",1,3,7,7,2,14,1.5,9,4
"['101', '010001', '0000010']",1,3,11,5,0,16,1.835897435897436,10,5
"['111111', '100000', '0100001', '1110', '0100']",1,5,14,13,4,27,4.634498834498834,37,26
"['11', '10001', '010101', '10', '0111']",1,5,8,11,2,19,5.614574314574314,27,27
"['11110', '011100', '1110101', '010101', '10']",1,5,10,16,2,26,5.978576978576979,30,26
"['10101', '001', '1']",1,3,4,5,0,9,1.3333333333333333,8,9
"['0101111', '00001', '101', '0001', '01010', '011000']",1,6,17,13,2,30,8.297108447108448,44,44
"['0010111', '111', '1101101', '0100001', '1100', '0011100']",1,6,16,19,4,35,8.706493506493507,55,49
"['0', '001', '0100110', '0111']",1,4,8,7,0,15,2.866883116883117,20,15
"['0', '000110', '010']",1,3,7,3,0,10,1.4523809523809523,10,13
"['0101', '110', '1001']",1,3,5,6,2,11,1.6428571428571428,6,7
"['10100', '1101000', '1', '0000']",1,4,11,6,0,17,2.4065656565656566,21,17
"['001', '11', '100000', '1001111', '110101']",1,5,11,13,2,24,4.660256410256411,37,35
"['010', '011', '0000100', '11', '0000', '0010010']",1,6,18,8,4,26,7.75930735930736,49,51
"['101010', '0000011', '011']",1,3,9,7,0,16,1.7282051282051283,11,8
"['010100', '001', '00101']",1,3,9,5,0,14,1.9217171717171717,7,11
"['0010', '1001', '00']",1,3,7,3,2,10,2.083333333333333,6,6
"['001', '0010100', '0011010']",1,3,11,6,2,17,2.057142857142857,10,16
"['00', '0110', '10']",1,3,5,3,2,8,1.8333333333333333,5,9
"['0101', '001010', '0010100', '1110']",1,4,12,9,2,21,3.7139860139860144,16,21
"['000111', '10', '0111', '1001']",1,4,7,9,2,16,3.15,18,16
"['0000101', '1010001', '10101']",1,3,11,8,2,19,2.2142857142857144,8,16
"['1001', '01111', '1']",1,3,3,7,0,10,1.1777777777777778,10,8
"['110', '111', '0001111']",1,3,4,9,2,13,1.6666666666666665,10,13
"['0000111', '1', '10011']",1,3,6,7,0,13,1.25,13,9
"['011', '001000', '00111', '10111', '1010', '00010']",1,6,15,13,3,28,8.83001443001443,38,44
"['0', '111111', '1111011']",1,3,2,12,0,14,1.1730769230769231,13,12
"['101', '01001', '1011']",1,3,5,7,0,12,2.2738095238095237,5,11
"['0', '101', '00011']",1,3,5,4,0,9,1.3333333333333333,9,4
"['010', '0101110', '111']",1,3,5,8,2,13,1.5333333333333332,10,7
"['110011', '01', '001111', '0000']",1,4,9,9,2,18,2.8,23,14
"['01101', '110001', '01010']",1,3,8,8,2,16,2.0727272727272728,8,6
"['110000', '110110', '010', '101', '01111', '101001']",1,6,13,16,5,29,8.454545454545453,47,37
"['0', '10100', '1010111', '11']",1,4,6,9,0,15,2.265873015873016,23,15
"['11001', '010', '1001010', '0110', '0111']",1,5,11,12,2,23,6.187662337662338,27,27
"['00001', '11', '1000110', '0001100', '10100', '10011']",1,6,18,13,5,31,8.774603174603174,47,41
"['01111', '1', '010110']",1,3,4,8,0,12,1.1645021645021645,11,5
"['0011', '101', '100', '110001', '010111', '000']",1,6,13,12,5,25,8.836507936507935,39,38
"['0101110', '10000', '10100', '111111', '110101']",1,5,12,17,4,29,5.328438228438229,30,22
"['1110101', '10001', '0100100']",1,3,10,9,2,19,1.9047619047619047,9,5
"['110110', '001111', '00100', '111110', '10', '0100011']",1,6,14,18,3,32,7.592213342213342,55,45
"['111010', '00000', '11', '10000', '0110010']",1,5,15,10,2,25,4.875147075147075,34,28
"['001', '1100', '000111', '1101100']",1,4,10,10,0,20,3.226906426906427,23,24
"['10101', '1', '001011']",1,3,5,7,0,12,1.3463203463203464,11,8
"['0100010', '001100', '0110']",1,3,11,6,0,17,2.1426573426573428,9,14
"['1101001', '101', '1100', '11']",1,4,6,10,0,16,3.8098124098124098,17,25
"['0100001', '001', '111010', '1110']",1,4,10,10,0,20,2.9553335553335556,22,18
"['11010', '111', '011100', '10100', '011111']",1,5,9,16,4,25,6.413636363636364,27,30
"['00011', '101', '00100', '110100', '101001']",1,5,14,11,4,25,6.3121212121212125,28,29
"['0100001', '0110000', '1']",1,3,10,5,2,15,1.3571428571428572,14,5
"['00101', '011100', '100', '110011', '000', '01011', '0111100']",1,7,18,17,6,35,12.340986790986792,63,69
"['001', '001111', '10110', '0001111', '111111', '10', '1100111', '0011100']",1,8,16,27,5,43,15.323376623376623,97,99
"['1000000', '0110010', '10']",1,3,11,5,2,16,1.4603174603174602,14,8
"['001100', '1', '0110110']",1,3,7,7,0,14,1.304945054945055,14,4
"['001', '00000', '01100', '1111001', '01110', '011000']",1,6,18,13,3,31,8.608313908313908,42,55
"['1101', '100111', '1101011']",1,3,5,12,0,17,2.0965034965034963,8,19
"['0101000', '0001', '100', '0000000', '000010', '0101001']",1,6,26,8,3,34,8.805483405483406,46,68
"['1000', '1101100', '11']",1,3,6,7,0,13,1.323232323232323,11,9
"['010100', '010', '011110']",1,3,8,7,2,15,2.0,8,17
"['110011', '010011', '1001111']",1,3,7,12,2,19,2.371794871794872,7,16
"['1101001', '0010', '011', '0111']",1,4,8,10,2,18,3.419480519480519,17,15
"['111', '100', '1101', '1010', '010011']",1,5,8,12,4,20,6.051587301587301,22,28
"['101', '1', '10011', '000010']",1,4,8,7,0,15,2.8589466089466087,20,13
"['001', '1010010', '10110', '0110100']",1,4,12,10,2,22,3.7142857142857144,19,16
"['01', '110', '111', '0000001', '010111', '001100', '1011']",1,7,15,16,4,31,10.542390942390941,69,55
"['01', '0001', '111', '000']",1,4,7,5,2,12,2.6095238095238096,13,15
"['0111', '01', '001001', '1110']",1,4,7,9,2,16,3.25,18,16
"['101100', '01', '010', '001111', '1011000']",1,5,12,12,2,24,5.6179487179487175,33,29
"['01010', '00101', '01000']",1,3,10,5,3,15,2.2,6,11
"['01', '001111', '101', '10001', '000']",1,5,10,9,2,19,5.539105339105339,28,24
"['011', '0010000', '100', '0101', '01000']",1,5,15,7,2,22,6.057359307359307,28,32
"['101', '000000', '001000']",1,3,12,3,2,15,1.1666666666666665,10,10
"['101010', '11100', '011', '0111100']",1,4,9,12,0,21,3.606993006993007,18,19
"['011010', '010', '11']",1,3,5,6,0,11,1.5666666666666667,9,7
"['00111', '0110', '100111', '10', '001100', '110']",1,6,12,14,2,26,9.59033189033189,39,43
"['0101110', '011', '00111', '101', '01111']",1,5,8,15,4,23,6.666666666666667,25,26
"['1011010', '1', '11000', '0111', '01011']",1,5,9,13,2,22,4.888383838383838,34,24
"['1010111', '01111', '1111110']",1,3,4,15,2,19,1.7619047619047619,8,13
"['1111', '010', '00000']",1,3,7,5,0,12,0.7857142857142857,11,4
"['010110', '1111110', '1011000']",1,3,8,12,2,20,1.9560439560439562,9,8
"['11', '010101', '1100', '001000']",1,4,10,8,2,18,3.283333333333333,20,14
"['01', '011', '000011']",1,3,6,5,0,11,1.9666666666666668,8,9
"['011011', '101011', '10001', '1011', '110']",1,5,9,15,2,24,6.373448773448773,24,42
"['101', '11011', '010', '10011']",1,4,6,10,4,16,3.966666666666667,13,16
"['0', '0111111', '010']",1,3,4,7,0,11,1.15,13,9
"['0101', '101101', '1001101']",1,3,7,10,0,17,2.2503496503496505,6,17
"['001100', '0010', '10000', '0111']",1,4,12,7,2,19,3.334343434343434,16,20
"['0001', '1100', '100000']",1,3,10,4,2,14,1.7,9,10
"['0010', '1010', '00', '1011011', '1111111']",1,5,9,15,4,24,4.917388167388167,37,24
"['0011', '11010', '000']",1,3,7,5,0,12,1.5158730158730158,8,9
"['01', '0000001', '111', '000']",1,4,10,5,2,15,2.0444444444444443,22,15
"['0', '00111', '101011', '10000', '1001101', '0001100']",1,6,17,14,4,31,7.5829836829836825,54,37
"['1001100', '000100', '011']",1,3,10,6,0,16,1.505982905982906,10,9
"['111111', '100011', '001011', '1011000']",1,4,10,15,3,25,2.871794871794872,20,22
"['0101', '1', '111001']",1,3,4,7,0,11,1.0857142857142859,11,9
"['00101', '0000', '010011', '011010', '110', '01110']",1,6,16,13,4,29,8.767027417027418,40,47
"['11011', '110', '100', '0111', '0000110']",1,5,10,12,2,22,5.485930735930736,30,27
"['11001', '010', '001111', '1100100', '0100101']",1,5,14,14,2,28,5.981107781107781,34,28
"['01', '0010111', '101000', '1111', '1110101', '1000', '0110110']",1,7,16,21,5,37,11.27867132867133,75,58
"['11010', '1', '00101', '0110', '000010']",1,5,12,9,2,21,5.158441558441559,31,23
"['0', '1101', '1100']",1,3,4,5,2,9,1.55,7,6
"['011101', '1010', '1', '0100']",1,4,7,8,2,15,3.0357142857142856,19,11
"['101111', '101000', '0101', '0101100']",1,4,11,12,2,23,3.811888111888112,17,16
"['11110', '10110', '000']",1,3,6,7,2,13,1.55,8,8
"['1001', '1', '10000']",1,3,6,4,0,10,1.4,9,10
"['101100', '11', '0011', '10000', '1000', '10100', '000000', '0110010']",1,8,25,14,6,39,15.261649461649462,82,93
"['1101001', '011', '1100001', '0001', '1010101', '0001101', '001011']",1,7,21,20,4,41,12.856077256077256,64,76
"['0', '110001', '10']",1,3,5,4,0,9,1.4523809523809523,10,4
"['111111', '010011', '010101']",1,3,6,12,3,18,1.6666666666666667,8,10
"['0110010', '00101', '11']",1,3,7,7,0,14,1.6825396825396823,11,4
"['0010', '001111', '111', '0111111', '0100']",1,5,9,15,2,24,5.0845987345987345,34,34
"['001001', '110', '00000']",1,3,10,4,0,14,1.4217171717171717,10,8
"['01', '10111', '0010', '011']",1,4,6,8,0,14,3.8039682539682538,13,12
"['0010', '11', '0100010', '101', '1110011', '10000']",1,6,15,13,2,28,8.223520923520923,49,35
"['1', '0011100', '000']",1,3,7,4,0,11,0.85,13,8
"['100', '011010', '1']",1,3,5,5,0,10,1.4523809523809523,10,4
"['01', '11', '0001', '1001', '10000']",1,5,10,7,4,17,5.488095238095238,23,30
"['01', '00', '010', '1100']",1,4,7,4,2,11,3.6714285714285713,10,17
"['001', '0101110', '001101', '11', '0111']",1,5,9,13,0,22,5.791863691863692,30,24
"['1100', '1010', '1001', '0110']",1,4,8,8,4,16,4.0,13,12
"['110110', '010001', '100001', '1101100', '001011', '1111011']",1,6,17,21,6,38,9.304029304029305,49,51
"['01', '0001', '0101100']",1,3,8,5,0,13,1.4747474747474747,11,9
"['011', '10001', '000101', '001110', '010110', '000111']",1,6,17,15,4,32,10.212121212121211,41,38
"['0', '101', '1110010', '0110111']",1,4,7,11,2,18,2.6285714285714286,25,12
"['010', '10', '000']",1,3,6,2,2,8,1.8666666666666667,4,9
"['110', '111011', '0011111', '01010', '000', '1100']",1,6,12,16,2,28,8.145781995781995,47,45
"['1100', '10', '1111']",1,3,3,7,2,10,1.5,7,8
"['11110', '011', '1100010', '100', '00', '1010', '01011', '101110']",1,8,16,19,4,35,16.149777999778,79,79
"['0011', '100000', '1011100', '0000']",1,4,14,7,2,21,3.0706293706293706,19,26
"['00111', '110110', '0001']",1,3,7,8,0,15,1.612121212121212,9,8
"['0011', '00', '000111', '01111']",1,4,8,9,0,17,3.6463203463203464,16,21
"['101', '0001', '1100101', '10010', '1100110']",1,5,13,13,2,26,6.802813852813853,27,32
"['11001', '01', '10101', '10001', '10000', '1000111', '1011', '001001']",1,8,20,19,4,39,17.95881895881896,71,112
"['0', '011000', '100010']",1,3,9,4,2,13,1.2380952380952381,13,8
"['110110', '1100001', '1100']",1,3,8,9,0,17,2.1426573426573428,8,13
"['1000000', '0010', '11000', '000000']",1,4,18,4,0,22,3.765501165501165,17,34
"['01111', '1111000', '111001', '10', '000010', '0111100']",1,6,15,18,4,33,8.43034743034743,55,44
"['0010', '1100001', '110011', '00', '0000110']",1,5,16,10,2,26,6.027183927183927,35,26
"['11', '1001', '0010011']",1,3,6,7,0,13,1.8383838383838382,10,10
"['00011', '101', '010101', '110', '111101']",1,5,9,14,4,23,5.52020202020202,29,31
"['1011', '010', '1', '0000']",1,4,7,5,2,12,2.2928571428571427,16,8
"['011', '001000', '0011010', '011110', '111101']",1,5,13,15,3,28,5.976068376068376,31,27
"['11000', '00', '111000', '1110100']",1,4,11,9,0,20,4.181374181374181,16,29
"['100', '1', '0110', '01010']",1,4,7,6,0,13,3.4436507936507934,14,12
"['11001', '001', '001111', '100', '01111', '1010']",1,6,11,15,4,26,9.022005772005771,42,43
"['011', '000', '001001', '01100', '111001']",1,5,13,10,4,23,5.9267676767676765,26,29
"['01', '101010', '10111', '000', '110', '111101']",1,6,10,15,4,25,7.227489177489177,45,36
"['00111', '00100', '1', '110111']",1,4,7,10,2,17,2.643290043290043,21,17
"['101100', '11', '10111', '10001', '001010']",1,5,11,13,4,24,5.773160173160173,30,28
"['1010', '10011', '0100100']",1,3,9,7,0,16,1.8787878787878787,8,5
"['110010', '011', '11', '101', '0010010', '111001']",1,6,12,15,4,27,9.351282051282052,46,44
"['01', '110', '111100']",1,3,4,7,0,11,1.3166666666666667,10,7
"['0', '0101011', '1100101', '1100', '1111011']",1,5,10,16,3,26,4.968181818181818,40,31
"['011011', '0111001', '1111000', '0']",1,4,9,12,2,21,2.730769230769231,25,15
"['0011', '101', '011', '111011']",1,4,5,11,2,16,4.0285714285714285,14,22
"['101', '101100', '10110']",1,3,6,8,0,14,2.3257575757575757,6,14
"['101', '1000', '101110', '11']",1,4,6,9,0,15,3.4714285714285715,16,18
"['1', '000011', '1100', '1110', '0100']",1,5,10,9,3,19,4.685714285714286,30,25
"['010011', '0100111', '0010111']",1,3,9,11,2,20,2.5494505494505493,5,16
"['0', '11110', '101111', '0100']",1,4,6,10,0,16,2.5907647907647906,21,13
"['0', '0010', '110100', '100101', '011110']",1,5,12,11,3,23,4.757142857142857,35,22
"['001', '100010', '0000011', '0001000', '0110011']",1,5,20,10,3,30,6.3238095238095235,33,30
"['1000', '010', '111000', '0100']",1,4,11,6,2,17,4.023015873015873,14,21
"['0010', '011', '00', '010111', '0101']",1,5,10,9,2,19,6.478571428571429,23,30
"['1010110', '001111', '11', '100', '01111']",1,5,8,15,0,23,5.234792984792985,34,30
"['0011', '0001', '100010']",1,3,9,5,2,14,2.15,6,7
"['1', '1001', '010111', '01000']",1,4,8,8,0,16,2.831168831168831,20,12
"['000001', '1011111', '11']",1,3,6,9,0,15,1.0021367521367521,15,10
"['11', '0001', '0110', '10010', '10', '100011', '0111110']",1,7,14,16,4,30,11.378132978132978,67,53
"['1010101', '1110100', '10011', '101110', '0100']",1,5,13,16,2,29,6.880719280719281,27,26
"['1101111', '001111', '0011', '10010', '0111', '011111', '0110110']",1,7,13,26,6,39,14.106865356865358,56,75
"['0011', '1010', '100101']",1,3,7,7,2,14,1.9,6,7
"['011011', '100', '001101', '1101010']",1,4,10,12,2,22,3.706837606837607,21,14
"['01', '10', '001101']",1,3,5,5,2,10,1.5,10,7
"['011', '01111', '10', '0100101']",1,4,7,10,0,17,3.1468253968253967,20,17
"['011110', '10101', '0111011']",1,3,6,12,0,18,1.9813519813519813,9,7
"['01001', '1001', '0011010']",1,3,9,7,0,16,1.9343434343434343,8,7
"['010101', '111001', '111011']",1,3,6,12,3,18,1.8333333333333333,7,13
"['1011', '101110', '0000']",1,3,7,7,2,14,1.4500000000000002,9,7
"['00010', '110', '1101000']",1,3,9,6,0,15,1.6,11,11
"['0010110', '11', '101011', '1000', '100101', '1100']",1,6,14,15,4,29,9.257148407148406,45,42
"['01', '0011', '10110', '0000', '110101']",1,5,11,10,2,21,5.409812409812409,29,22
"['011', '00011', '1010100', '0111', '101001']",1,5,12,13,0,25,6.5157675657675656,28,30
"['011101', '000101', '0']",1,3,7,6,2,13,1.2380952380952381,12,8
"['0', '0101010', '011110']",1,3,7,7,0,14,1.151098901098901,13,14
"['1100011', '01', '0000']",1,3,8,5,0,13,1.323232323232323,12,4
"['11001', '1100', '110111', '11']",1,4,5,12,0,17,3.954256854256854,15,35
"['10101', '001', '1101', '00011']",1,4,8,9,2,17,3.5325396825396824,13,20
"['000110', '001', '100001', '111010', '0110100', '101101', '1000', '0111111', '1100111']",1,9,24,28,7,52,20.690920190920192,119,95
"['1000', '1', '01100']",1,3,6,4,0,10,1.4,9,5
"['11', '10101', '0010100', '11101', '000010']",1,5,13,12,2,25,5.128443778443779,33,22
"['0111000', '01', '111', '1000', '00', '0011111']",1,6,12,13,4,25,6.825829725829726,55,44
"['00', '1000', '0001', '111']",1,4,8,5,2,13,2.6547619047619047,15,16
"['0010110', '1100', '01100']",1,3,9,7,0,16,2.1010101010101008,8,13
"['011101', '010100', '1100110', '110011']",1,4,11,14,3,25,3.9871794871794872,17,17
"['01', '1110010', '001', '10']",1,4,7,7,2,14,3.188888888888889,19,14
"['00010', '1', '00011']",1,3,7,4,2,11,1.4666666666666668,9,7
"['0000', '110110', '111', '0100']",1,4,9,8,2,17,2.4523809523809526,18,14
"['0000', '1000', '11100', '1111']",1,4,9,8,3,17,2.7777777777777777,15,21
"['1011010', '01', '10110', '1111', '1011']",1,5,7,15,2,22,5.955266955266955,25,35
"['0', '11110', '010', '1100']",1,4,6,7,0,13,2.9714285714285715,16,16
"['11001', '0110111', '00111', '0001', '10', '0110001']",1,6,14,16,4,30,8.651226551226552,48,46
"['1', '0010100', '0001000']",1,3,11,4,2,15,1.3571428571428572,14,8
"['01', '11000', '11110', '000']",1,4,8,7,2,15,2.571428571428571,18,17
"['11', '10011', '001100', '00010', '101001']",1,5,13,11,4,24,5.8662337662337665,30,21
"['010', '0001100', '100110', '10011', '1110']",1,5,13,12,0,25,6.4729825729825725,27,27
"['010', '110', '111']",1,3,3,6,3,9,1.6666666666666665,4,7
"['0', '001001', '0101110', '01010']",1,4,11,8,0,19,3.045038295038295,24,22
"['100100', '0001', '110', '1']",1,4,8,6,0,14,2.515873015873016,19,13
"['11110', '010', '111000', '0111010']",1,4,9,12,0,21,3.7076146076146075,17,21
"['0', '1110000', '1101011', '1101', '0110011']",1,5,11,15,3,26,5.15,40,30
"['0', '1101001', '0010', '110010', '11110', '101000', '1100110', '01110']",1,8,20,21,6,41,15.318503718503719,88,84
"['10110', '010101', '000', '001001', '110101']",1,5,14,12,3,26,6.611111111111111,28,26
"['1', '10111', '1001', '10110', '1010', '10010', '000100']",1,7,15,15,5,30,12.538744588744589,53,62
"['011011', '1111111', '100101', '011110', '001011', '0001000']",1,6,16,22,6,38,8.296703296703297,49,37
"['100', '111', '0100']",1,3,5,5,2,10,1.476190476190476,6,6
"['1011', '0111111', '0100101']",1,3,6,12,2,18,1.6623376623376622,10,8
"['101010', '001', '1', '100001']",1,4,9,7,2,16,2.849206349206349,21,17
"['0111', '1110110', '0000011', '0110001']",1,4,12,13,3,25,3.5324675324675323,23,18
"['0101', '111', '1110']",1,3,3,8,2,11,1.9285714285714284,6,10
"['01101', '011', '0011', '1001', '0010101', '1000']",1,6,14,13,3,27,9.104689754689755,37,44
"['011111', '0011101', '1']",1,3,4,10,0,14,1.304945054945055,13,6
"['10111', '00', '10011']",1,3,5,7,2,12,1.657142857142857,8,6
"['111', '1001', '1000', '000', '1100']",1,5,10,8,5,18,5.678571428571429,19,29
"['0', '1010', '0111', '0010000']",1,4,10,6,2,16,2.459090909090909,24,14
"['010100', '0010', '00111', '1111110', '1011']",1,5,11,15,2,26,5.113752913752913,31,27
"['11110', '0010', '001000', '0000', '1001100', '0101']",1,6,19,11,3,30,8.91064491064491,41,54
"['0011001', '1000100', '1011001']",1,3,12,9,3,21,2.142857142857143,7,13
"['00100', '00', '11']",1,3,6,3,2,9,0.8571428571428571,9,8
"['101', '00', '0001', '11']",1,4,6,5,2,11,2.7714285714285714,12,13
"['001111', '1001', '0101011', '0111', '000111']",1,5,11,16,4,27,6.790675990675991,25,32
"['1010', '100111', '00101', '0111011']",1,4,9,13,0,22,3.8214452214452215,18,14
"['010', '110', '1100100', '11']",1,4,7,8,2,15,3.511111111111111,17,17
"['01', '00110', '010', '00000']",1,4,11,4,2,15,3.507142857142857,15,22
"['001111', '1101000', '1111', '10', '1101010']",1,5,10,16,2,26,5.171323121323121,37,38
"['1011', '10', '110101']",1,3,4,8,0,12,1.9666666666666668,8,10
"['0101111', '11100', '11']",1,3,4,10,0,14,1.5158730158730158,12,12
"['0010', '001', '10', '111']",1,4,6,6,2,12,2.9428571428571426,12,13
"['1001', '1010', '00', '00110', '0100']",1,5,12,7,3,19,6.3769841269841265,22,27
"['01', '001', '11', '101', '0001', '1010000', '0110010']",1,7,16,12,6,28,12.217171717171716,62,54
"['1111100', '1000100', '0000100', '00011', '10000', '111011', '0110000', '001010']",1,8,30,20,8,50,16.314785214785214,89,109
"['0111000', '001101', '011', '1001', '100100', '0000001', '100010', '011101', '110111', '0101']",1,10,29,26,9,55,27.013980463980463,142,130
"['1110110', '0110100', '101111']",1,3,7,13,2,20,1.9450549450549453,9,6
"['110', '100000', '0000010']",1,3,12,4,0,16,1.6136752136752137,11,11
"['0', '110101', '1001111', '100010']",1,4,9,11,2,20,2.718864468864469,25,13
"['0011', '0000001', '0000', '1000011', '01000']",1,5,20,7,4,27,6.21933621933622,28,37
"['001', '1011011', '01111']",1,3,5,10,0,15,1.7333333333333334,9,7
"['1110010', '111100', '000']",1,3,8,8,0,16,1.8136752136752137,10,10
"['01', '1000', '0001', '1111']",1,4,7,7,3,14,2.583333333333333,16,15
"['110000', '11011', '001101', '10100', '1000', '010111', '1110']",1,7,17,19,7,36,12.407070707070707,59,61
"['11001', '010', '111', '100', '0101', '101111']",1,6,9,15,3,24,8.7010101010101,37,41
"['010000', '111', '11000', '1101', '10', '01001']",1,6,13,12,2,25,8.576767676767677,40,40
"['0', '010011', '110000', '101110']",1,4,10,9,3,19,2.5238095238095237,25,13
"['1000', '010', '11100', '0100']",1,4,10,6,2,16,4.011904761904762,12,20
"['1011', '10101', '011010', '100010']",1,4,10,11,2,21,4.21010101010101,15,16
"['110011', '0001', '001']",1,3,7,6,0,13,2.123809523809524,7,9
"['01', '001', '0101110', '10110', '1010001']",1,5,12,12,2,24,5.8317460317460315,34,27
"['0010110', '101', '11', '00001']",1,4,9,8,0,17,3.13015873015873,20,12
"['01', '11011', '0110100', '011000', '100010', '1110', '0100']",1,7,18,16,4,34,12.262415362415362,62,58
"['0', '100110', '11010', '01100']",1,4,9,8,2,17,3.025108225108225,20,15
"['011111', '101', '0010101']",1,3,6,10,0,16,1.6598290598290597,11,8
"['01', '11011', '111', '1001000', '000010', '0011011']",1,6,15,15,2,30,7.8317071817071815,55,43
"['110110', '001', '101101', '10111', '10001', '0011110']",1,6,13,19,4,32,9.324902874902875,42,44
"['01', '11', '1010100', '100', '100101']",1,5,10,10,2,20,5.224786324786325,32,29
"['0', '0111101', '10010']",1,3,6,7,0,13,1.0833333333333333,14,6
"['01', '010011', '0000100', '10011']",1,4,12,8,0,20,3.5403485403485404,20,15
"['110000', '01001', '0111', '1101']",1,4,9,10,2,19,3.1565656565656566,17,18
"['1101000', '100', '1111000', '110100', '01001', '0111110']",1,6,17,18,3,35,9.564452214452215,46,47
"['1011', '00', '10001']",1,3,6,5,0,11,1.5714285714285714,8,5
"['0101010', '1', '100110']",1,3,7,7,0,14,1.151098901098901,14,5
"['0111000', '0110', '011', '10']",1,4,8,8,0,16,3.6955266955266954,17,21
"['0', '1010100', '1001000']",1,3,10,5,2,15,1.3571428571428572,14,8
"['11110', '00100', '0001', '0010100', '1001001', '001100', '110101']",1,7,23,17,6,40,12.408769008769008,58,69
"['0011001', '10100', '0101100', '0100101', '101001']",1,5,18,14,3,32,7.372460872460873,24,33
"['100100', '1111111', '1000', '1110', '0100']",1,5,11,14,3,25,4.966783216783217,34,29
"['010100', '100001', '11', '1000', '01010']",1,5,14,9,2,23,5.925974025974026,28,24
"['1010110', '11010', '011', '101010', '100110', '0101001']",1,6,16,18,4,34,10.251115551115552,39,48
"['01111', '0011', '100001', '1001']",1,4,9,10,2,19,3.624747474747475,16,19
"['1100010', '0001', '0111', '101101']",1,4,10,11,2,21,3.588111888111888,19,14
"['11011', '010', '001']",1,3,5,6,2,11,1.6666666666666665,8,4
"['0', '001', '001011']",1,3,6,4,0,10,1.4523809523809523,10,8
"['111', '101', '100011', '000010', '0001010', '01011']",1,6,16,14,4,30,8.838966588966588,43,37
"['1111000', '11101', '010001', '10']",1,4,9,11,0,20,3.343378843378843,22,15
"['100001', '1001010', '100111', '000001', '1100011', '0111101', '111001']",1,7,22,23,7,45,13.382783882783883,60,78
"['00', '111110', '10011', '1001101']",1,4,8,12,0,20,3.078227328227328,21,15
"['0', '000110', '0000010', '1010001', '001011']",1,5,18,9,4,27,5.0677655677655675,39,25
"['11010', '1110011', '0011010']",1,3,8,11,2,19,2.071428571428571,9,10
"['10001', '1', '01110']",1,3,5,6,2,11,1.0666666666666667,12,4
"['101100', '0010', '00']",1,3,8,4,0,12,1.5666666666666667,9,13
"['111011', '001', '1001']",1,3,5,8,0,13,1.9015873015873015,8,10
"['011011', '00', '010']",1,3,6,5,0,11,1.9666666666666668,8,9
"['1011101', '1100', '110', '10']",1,4,6,10,0,16,3.9137085137085137,17,16
"['01001', '001', '0100']",1,3,8,4,0,12,2.2103174603174605,5,12
"['1011011', '0011101', '0011010', '000']",1,4,12,12,3,24,3.8857142857142857,20,17
"['0110100', '0011110', '0110', '1111', '10', '0110010', '01011']",1,7,16,20,5,36,12.325396825396824,66,68
"['0110', '111', '1110', '00001']",1,4,7,9,2,16,3.095238095238095,15,16
"['0001101', '1011001', '011', '10']",1,4,9,10,2,19,3.2031746031746033,23,14
"['01', '001101', '00011', '00100', '10101', '1111010', '11101']",1,7,16,19,4,35,12.106149406149406,62,60
"['0110010', '100111', '1', '01110']",1,4,8,11,0,19,3.045038295038295,24,11
"['1100010', '100010', '011101', '0101', '110']",1,5,13,13,2,26,6.266455766455766,30,32
"['100101', '0000101', '000101', '11']",1,4,12,9,2,21,3.97008547008547,17,29
"['1010', '1111101', '0111']",1,3,4,11,2,15,1.5909090909090908,11,8
"['1101001', '01', '0']",1,3,5,5,0,10,1.3611111111111112,12,5
"['1', '00000', '10111', '11000', '0101', '1001111']",1,6,13,14,3,27,6.284343434343434,56,39
"['0010', '111', '00011', '1010', '00', '111110', '000100']",1,7,16,14,4,30,10.386147186147186,63,68
"['0101101', '00', '011011', '010110']",1,4,10,11,2,21,3.8034188034188032,19,21
"['1101001', '1000', '10', '1011', '1101']",1,5,9,12,3,21,6.194444444444445,26,35
"['11010', '0100', '1101110']",1,3,7,9,0,16,2.0454545454545454,8,10
"['1001110', '1100', '1']",1,3,5,7,0,12,1.1954545454545453,13,6
"['1001001', '0111010', '0001111']",1,3,10,11,3,21,1.8571428571428572,11,4
"['0010', '01', '0011000', '0011', '101', '010111', '111001']",1,7,16,16,4,32,12.989282939282939,64,55
"['001', '001111', '011', '1101101', '1010100', '0000000', '0011010', '010101']",1,8,25,21,8,46,15.48986568986569,96,80
"['0', '100000', '1001100', '1111000']",1,4,13,8,2,21,2.8846153846153846,25,18
"['0001011', '011010', '10']",1,3,8,7,0,15,1.5598290598290598,12,7
"['010100', '00', '0111', '11']",1,4,7,7,2,14,2.6,18,15
"['1001011', '00010', '00', '11010']",1,4,11,8,2,19,3.5206349206349206,19,15
"['01', '111', '0000']",1,3,5,4,0,9,0.7333333333333334,9,4
"['0010001', '100110', '1011', '1100110']",1,4,12,12,2,24,4.182617382617383,18,19
"['0110100', '10001', '0000101', '110', '01100']",1,5,16,11,4,27,5.754761904761905,33,26
"['010100', '1001001', '1000', '1']",1,4,11,7,0,18,3.0322177822177823,22,13
"['01', '1101111', '1010101', '1101100', '000']",1,5,11,15,3,26,5.076190476190476,39,26
"['0', '110110', '10001', '0001011']",1,4,10,9,0,19,2.6965534465534464,25,11
"['01', '1100', '1111000']",1,3,6,7,0,13,1.2828282828282829,12,8
"['111010', '111100', '111', '1111110']",1,4,5,17,2,22,4.151282051282052,16,32
"['0', '01', '10011', '1110']",1,4,5,7,0,12,2.749206349206349,17,11
"['11001', '010000', '111', '0001', '10110']",1,5,12,11,2,23,5.15995670995671,29,24
"['1001110', '01', '11101', '11100', '01011']",1,5,9,15,3,24,5.673015873015872,34,27
"['0111010', '110', '1111001', '000011']",1,4,10,13,2,23,3.2818070818070817,25,14
"['010', '10', '101101']",1,3,5,6,0,11,1.9666666666666668,8,6
"['00', '0101011', '01011']",1,3,7,7,0,14,1.8492063492063493,10,13
"['110110', '00', '1', '01011']",1,4,6,8,0,14,2.4177489177489178,20,11
"['0001', '1100001', '01111']",1,3,8,8,0,16,1.6717171717171717,11,10
"['0010001', '1110000', '10101', '0110', '01001']",1,5,16,12,4,28,6.073448773448773,31,24
"['00', '100111', '100001']",1,3,8,6,2,14,1.6666666666666665,10,6
"['010', '00100', '0110', '10110', '0111']",1,5,11,10,4,21,6.9452380952380945,18,35
"['10111', '01', '0101111']",1,3,4,10,0,14,1.8492063492063493,10,9
"['0011', '1010', '110']",1,3,5,6,2,11,1.6428571428571428,6,8
"['10000', '1000111', '011000']",1,3,11,7,0,18,2.0093240093240095,10,9
"['1000111', '00110', '0010', '0101001']",1,4,13,10,2,23,3.717893217893218,18,13
"['0011101', '010', '0110', '10', '000']",1,5,11,8,2,19,6.3336219336219335,25,32
"['0110100', '1111001', '1011', '001001', '111101']",1,5,12,18,4,30,5.936929736929737,30,32
"['1', '1000', '00110', '10010', '1011', '001001']",1,6,14,11,4,25,8.373593073593074,42,37
"['101', '00110', '110']",1,3,5,6,2,11,1.9166666666666665,7,6
"['0', '1000001', '10111', '0010101', '11101', '11111', '1011']",1,7,13,21,5,34,10.267965367965367,70,75
"['011100', '0011', '0010100', '1111', '100110', '0111111', '001011']",1,7,17,23,7,40,12.571694971694972,64,72
"['011011', '00010', '0101', '10']",1,4,9,8,0,17,3.75021645021645,16,14
"['0', '1011110', '001000']",1,3,8,6,0,14,0.9972527472527473,15,8
"['111', '1001', '1000', '01001', '0101']",1,5,10,10,3,20,6.373015873015873,20,31
"['001001', '10', '11111']",1,3,5,8,0,13,1.1493506493506493,12,6
"['0', '010', '0110', '111']",1,4,5,6,2,11,2.6619047619047618,13,14
"['1000001', '0011', '0011100']",1,3,11,7,2,18,1.7012987012987013,12,8
"['01', '0010', '101', '00110', '000', '0110001']",1,6,15,9,2,24,9.195454545454545,40,41
"['0', '100', '110001', '0000101', '11101']",1,5,12,10,0,22,4.778371628371628,37,24
"['0', '11', '1011010', '00001']",1,4,8,7,0,15,1.6468253968253967,25,10
"['01', '0011101', '1']",1,3,4,6,0,10,1.3611111111111112,12,7
"['0001', '1010110', '1100', '1001101']",1,4,11,11,4,22,3.3571428571428568,19,15
"['010', '10011', '01110']",1,3,6,7,2,13,1.85,8,6
"['1001010', '1100010', '101', '001001', '110', '01100']",1,6,17,14,4,31,9.066772116772118,48,37
"['0', '1010100', '110', '111']",1,4,6,8,2,14,2.4166666666666665,20,12
"['0010', '101', '00010', '010011', '0101']",1,5,13,9,2,22,7.028066378066378,21,26
"['000001', '0101', '1', '110111']",1,4,8,9,2,17,2.3047619047619046,23,15
"['111100', '0000101', '01001', '1101', '0101001']",1,5,15,14,2,29,5.6753135753135755,32,34
"['00110', '10001', '1011100']",1,3,9,8,2,17,1.7666666666666666,10,6
"['1', '101010', '10110', '10000', '11101']",1,5,10,12,3,22,5.067532467532468,29,27
"['1101', '10', '0100101']",1,3,6,7,0,13,1.8383838383838382,10,8
"['001', '10011', '011001', '1011', '110101']",1,5,10,14,2,24,7.00930735930736,23,35
"['10111', '10', '11111']",1,3,2,10,2,12,1.457142857142857,8,13
"['010000', '001111', '101', '0011010', '0000011', '1010011', '1110', '0111100']",1,8,24,23,6,47,15.442002442002442,101,79
"['0111', '010', '001111', '000']",1,4,8,8,2,16,3.212698412698413,16,19
"['1000001', '1001110', '00101', '000', '0011011']",1,5,17,12,3,29,6.264285714285714,33,27
"['11001', '101', '00010', '11111']",1,4,7,11,3,18,3.15,17,15
"['100101', '10010', '011', '01100']",1,4,10,9,2,19,3.971212121212121,15,16
"['1100111', '101100', '110']",1,3,6,10,0,16,1.882051282051282,11,9
"['110000', '1001', '001010', '01010', '000', '1110']",1,6,17,11,4,28,8.706132756132757,41,44
"['11001', '0001', '000000']",1,3,11,4,0,15,1.6303030303030304,9,10
"['000110', '1', '101110', '0000']",1,4,10,7,2,17,2.4380952380952383,22,16
"['00', '00101', '10', '0100']",1,4,9,4,2,13,3.642857142857143,13,19
"['01', '0010010', '0111']",1,3,7,6,0,13,1.6565656565656566,11,7
"['111110', '11100', '1', '1101011']",1,4,5,14,0,19,2.7245254745254743,23,20
"['010', '001111', '0000100', '000100', '111101']",1,5,16,12,3,28,5.3478632478632475,35,36
"['0100111', '110', '0011110', '1001', '000001', '1100', '0011100']",1,7,20,18,5,38,12.461333111333111,73,62
"['101', '0001', '0110', '1111']",1,4,6,9,3,15,2.9642857142857144,15,11
"['011111', '101011', '00', '00101']",1,4,8,11,2,19,3.094155844155844,20,13
"['11000', '1110110', '0000000', '001110', '1101']",1,5,16,13,2,29,5.250516150516151,38,31
"['010100', '001', '10111', '1111010', '001110', '01001']",1,6,15,17,4,32,8.804001554001553,46,39
"['1001110', '1', '00001', '0101', '1100']",1,5,11,10,2,21,4.363131313131313,35,22
"['0010000', '11010', '0111']",1,3,9,7,0,16,1.5303030303030303,12,7
"['1010', '010', '0011000']",1,3,9,5,0,14,2.0025974025974023,9,10
"['010', '011', '011111', '1010000', '1101', '011000']",1,6,14,15,4,29,8.376345876345876,47,42
"['1000100', '110010', '1', '0110', '111011', '1110101', '1110100']",1,7,16,22,5,38,11.647036297036298,70,65
"['010100', '100', '011', '1010011']",1,4,10,9,2,19,3.635897435897436,20,16
"['111000', '10100', '00110', '00', '011001', '0101']",1,6,16,12,4,28,9.136796536796536,43,43
"['1011010', '0101000', '10111', '1000000', '110']",1,5,16,13,3,29,5.423809523809524,36,27
"['0', '010', '11111']",1,3,3,6,0,9,0.75,11,4
"['100110', '00', '0101', '101100']",1,4,10,8,2,18,3.7,19,15
"['00001', '100101', '10', '000', '110']",1,5,12,7,2,19,4.975613275613275,27,25
"['110011', '0001', '00101']",1,3,8,7,0,15,1.993939393939394,7,8
"['0100', '10100', '00', '0011111', '0110010', '1011111']",1,6,15,17,3,32,7.867965367965367,57,49
"['1011110', '0010', '0110', '1111']",1,4,7,12,3,19,3.3181818181818183,16,14
"['001', '00011', '1111', '000', '1101']",1,5,9,10,4,19,4.948412698412699,24,31
"['01', '100000', '0000100', '1100110']",1,4,15,7,2,22,3.094932844932845,23,16
"['0000', '0110', '10', '11']",1,4,7,5,4,12,2.6666666666666665,14,11
"['0011001', '011010', '0011100']",1,3,11,9,2,20,2.3956043956043955,8,12
"['001100', '0101', '111100']",1,3,8,8,2,16,1.6666666666666665,9,10
"['0111000', '101101', '101000', '0110000', '00', '110111', '001100', '1111011']",1,8,23,24,7,47,16.243894993894994,96,82
"['1111010', '0101', '0100']",1,3,7,8,2,15,1.8409090909090908,9,8
"['00', '010', '1100']",1,3,6,3,0,9,2.038095238095238,5,10
"['00000', '101000', '01001', '110', '0100']",1,5,16,7,2,23,5.5719336219336215,23,32
"['00101', '000011', '001000', '0110', '100110']",1,5,17,10,3,27,6.681818181818182,27,33
"['111', '0110', '1111000', '0111', '000', '1101']",1,6,10,15,5,25,8.264935064935065,40,46
"['1100010', '1', '01010']",1,3,7,6,0,13,1.0833333333333333,13,6
"['0001', '0101', '0111001']",1,3,8,7,2,15,1.9545454545454546,7,11
"['11001', '011', '11', '001100', '0100011', '101001']",1,6,14,15,2,29,9.436852036852036,47,44
"['0001001', '011', '00001', '1010111', '111111']",1,5,12,16,2,28,4.666921966921967,37,33
"['0001', '1001', '100010']",1,3,9,5,2,14,2.35,5,10
"['00', '1', '0111', '011001']",1,4,6,7,0,13,2.3190476190476192,19,12
"['000110', '100001', '011', '01111', '010010', '00']",1,6,16,12,3,28,8.334704184704185,48,38
"['10', '010110', '1111']",1,3,4,8,0,12,1.2333333333333334,10,5
"['101', '001', '011', '110111']",1,4,5,10,3,15,3.7777777777777777,14,17
"['10001', '0010010', '111', '01110']",1,4,10,10,2,20,3.3833333333333333,20,9
"['0', '00100', '0101']",1,3,7,3,0,10,1.4,9,8
"['1000010', '0001000', '1', '01010']",1,4,14,6,2,20,2.7142857142857144,25,12
"['110000', '00', '10', '101110', '110101']",1,5,11,11,5,22,5.333333333333333,34,24
"['0', '100001', '1110']",1,3,6,5,0,11,1.0857142857142859,12,4
"['00', '1011011', '01111', '010010']",1,4,9,11,0,20,3.224331224331224,21,12
"['1000110', '100', '00101', '1110']",1,4,10,9,0,19,3.50981240981241,19,17
"['101000', '00110', '010', '0010']",1,4,12,6,0,18,4.126334776334776,13,26
"['0', '00001', '01010', '1101', '1001011']",1,5,12,10,2,22,4.721717171717172,34,18
"['01', '1000', '11011', '1110']",1,4,6,9,2,15,2.849206349206349,16,14
"['010001', '00001', '110111', '01001', '001011', '1111111']",1,6,15,20,5,35,8.21025641025641,45,53
"['00111', '1', '000', '01000']",1,4,9,5,2,14,2.3166666666666664,20,17
"['0111000', '0010001', '01', '100001', '111', '1110100', '1011']",1,7,18,18,3,36,11.741247641247641,76,59
"['01', '11101', '000111', '0100']",1,4,8,9,0,17,3.127994227994228,20,15
"['11', '000111', '010010', '100010']",1,4,11,9,3,20,3.6666666666666665,20,15
"['0', '01', '0110', '1001101', '01110']",1,5,9,10,0,19,5.615367965367965,31,27
"['010', '0011110', '1110']",1,3,6,8,0,14,1.8987012987012988,9,13
"['0001101', '01', '1001', '0111100']",1,4,10,10,2,20,3.217893217893218,24,15
"['1011010', '11010', '1110', '0000']",1,4,10,10,2,20,3.467171717171717,16,19
"['1010111', '1000000', '100110', '11101', '10', '10011', '0101']",1,7,17,19,4,36,12.238872238872238,69,70
"['00010', '11101', '10']",1,3,6,6,2,12,1.5428571428571427,10,5
"['110011', '000110', '010110']",1,3,9,9,3,18,2.0,7,7
"['0', '0010001', '0001110', '1101', '0110010']",1,5,15,11,3,26,4.643506493506494,44,23
"['00010', '10', '00001']",1,3,9,3,2,12,1.657142857142857,9,9
"['001101', '10100', '00', '1000', '11111']",1,5,11,11,2,22,4.717893217893217,32,28
"['0', '11', '01000', '1110', '110101']",1,5,8,10,0,18,4.061327561327561,32,21
"['110011', '0111001', '0010111', '000001']",1,4,13,13,4,26,3.532967032967033,19,17
"['010100', '0100110', '00000', '00001', '0001010']",1,5,22,8,4,30,6.292840492840493,22,51
"['11001', '0', '11110', '1011001', '1001', '01000']",1,6,13,14,3,27,8.143939393939394,46,38
"['1011', '10100', '01001', '011']",1,4,8,9,2,17,4.2404761904761905,12,17
"['0000110', '1111101', '10', '011001']",1,4,10,12,2,22,3.048229548229548,26,12
"['11110', '0001110', '11', '101010', '1010101', '1100011']",1,6,14,20,3,34,8.422244422244422,52,48
"['00111', '001', '00001']",1,3,8,5,2,13,2.1,6,12
"['101', '0101110', '10']",1,3,5,7,0,12,1.8444444444444446,10,6
"['01', '111100', '00000', '101', '0001011', '00010']",1,6,17,11,2,28,7.480996780996781,52,46
"['011011', '100', '111011', '1000010', '00', '100011', '1100011']",1,7,18,19,5,37,12.254884004884005,67,75
"['0', '001100', '100', '111100']",1,4,9,7,2,16,3.071428571428571,20,23
"['011101', '001100', '00', '001']",1,4,10,7,2,17,3.5777777777777775,17,24
"['01', '00110', '00', '011110', '0001011', '0001000']",1,6,18,11,4,29,8.118603618603618,53,62
"['01', '0010000', '11', '11000', '100011', '0000110']",1,6,18,11,4,29,7.762681762681763,56,40
"['0', '0011001', '1010', '10010', '1100110']",1,5,13,11,2,24,5.60923520923521,37,25
"['1010101', '11100', '10']",1,3,6,8,0,14,1.5158730158730158,11,7
"['01010', '001010', '010010', '1111111']",1,4,11,13,2,24,3.4335664335664333,19,22
"['0011', '000001', '1011111']",1,3,8,9,0,17,1.453146853146853,12,8
"['0', '10111', '1111111']",1,3,2,11,0,13,0.8333333333333333,14,8
"['100010', '0110', '10', '1111']",1,4,7,9,2,16,2.8,18,14
"['0011101', '0111010', '10000', '1100101', '10', '0000', '0100101']",1,7,22,17,4,39,12.658008658008658,73,61
"['1010000', '10110', '10', '11']",1,4,8,8,2,16,3.198412698412698,20,17
"['110011', '00', '011', '01010']",1,4,8,8,0,16,3.4335497835497835,17,14
"['00100', '1001', '11100', '10']",1,4,9,7,2,16,3.742857142857143,16,14
"['11', '00110', '110001', '0100']",1,4,9,8,0,17,2.9946608946608944,19,11
"['010', '1001', '01100']",1,3,7,5,0,12,1.9880952380952381,8,5
"['101', '00', '1', '000001']",1,4,8,4,0,12,2.13015873015873,19,13
"['1011', '10', '01000', '00000']",1,4,11,5,2,16,2.7904761904761903,17,15
"['01', '111', '00000', '0011', '100', '1111110', '10010', '011010']",1,8,17,18,4,35,13.514568764568764,91,73
"['1111100', '0100110', '1']",1,3,6,9,2,15,1.0714285714285714,16,4
"['110000', '01011', '0']",1,3,7,5,0,12,0.9826839826839826,13,7
"['00111', '100', '001101', '110101']",1,4,9,11,2,20,3.7323232323232323,18,20
"['1010111', '0001001', '1001100', '0']",1,4,12,10,3,22,2.607142857142857,28,12
"['0010', '0111010', '0001110', '010001', '001000', '110001', '001100']",1,7,26,16,6,42,14.391908091908093,60,79
"['00110', '0101111', '010000']",1,3,10,8,0,18,1.6736596736596736,10,11
"['10', '001101', '000101']",1,3,8,6,2,14,1.8333333333333335,9,9
"['0100001', '01', '0110']",1,3,8,5,0,13,1.6565656565656566,11,10
"['100011', '0101011', '1110100', '10011']",1,4,11,14,2,25,4.044622044622045,17,26
"['010', '011100', '11', '0111', '000']",1,5,9,9,2,18,5.001587301587302,25,29
"['0001', '1001', '10010', '11111']",1,4,8,10,4,18,3.3722222222222222,14,19
"['1000010', '10010', '111']",1,3,8,7,0,15,1.7333333333333334,10,11
"['01', '1000', '101110']",1,3,6,6,0,12,1.4333333333333333,10,7
"['0101000', '011', '100100', '10110', '00', '1011111']",1,6,15,15,2,30,8.252486402486403,54,40
"['0', '1111010', '010101', '011000']",1,4,10,10,2,20,2.718864468864469,25,15
"['11', '00100', '001110', '011111', '0101', '110']",1,6,11,15,2,26,8.559163059163058,43,39
"['0000111', '101110', '10011', '100010']",1,4,12,12,2,24,4.018648018648019,16,18
"['0', '010000', '1101111', '11000', '10111']",1,5,11,13,2,24,4.334315684315684,40,25
"['01101', '1011001', '10010', '0100100', '1010000', '1100']",1,6,20,15,5,35,10.385714285714286,40,38
"['101010', '00', '1110110']",1,3,7,8,0,15,1.7136752136752138,11,7
"['11011', '00001', '0011', '1001', '100']",1,5,11,10,4,21,6.245238095238095,23,32
"['1011010', '0011110', '111000', '11']",1,4,9,13,2,22,3.487789987789988,22,14
"['010100', '01', '1101']",1,3,6,6,0,12,1.7666666666666666,9,6
"['1011', '0001', '1101111', '011']",1,4,6,12,2,18,3.6194805194805193,17,20
"['11011', '001', '010', '1100']",1,4,7,8,2,15,3.4761904761904763,15,14
"['0', '001', '0111110', '1110']",1,4,6,9,0,15,2.562987012987013,22,17
"['1011', '011010', '0110', '10011']",1,4,8,11,2,19,4.251010101010101,14,15
"['0010001', '000111', '11100']",1,3,10,8,0,18,1.6608391608391608,12,11
"['101100', '100', '111011']",1,3,6,9,2,15,1.7777777777777777,10,9
"['0110000', '001100', '101101']",1,3,11,8,2,19,2.051282051282051,9,6
"['001', '11', '10000', '1000', '0000111', '1101']",1,6,14,11,2,25,7.782106782106782,46,51
"['1011101', '111000', '10', '111']",1,4,6,12,0,18,3.2264957264957266,21,19
"['010', '0011000', '001000', '10001', '0110', '1101100', '1110101', '011110', '111101', '0100']",1,10,28,27,8,55,28.12799977799978,137,127
"['0', '001001', '0110', '10110']",1,4,9,7,0,16,3.0533910533910533,19,17
"['0000', '110', '0110', '111011']",1,4,8,9,2,17,3.1095238095238096,17,14
"['1', '0010000', '100', '0010100', '110101']",1,5,15,9,2,24,5.086446886446886,38,27
"['0', '101', '010010']",1,3,6,4,0,10,1.4523809523809523,10,4
"['00100', '00', '100111', '000100', '1100']",1,5,15,8,2,23,6.059307359307359,29,44
"['10110', '1111010', '1000', '10', '011000']",1,5,12,12,0,24,6.203984903984904,31,29
"['1001111', '01011', '1111']",1,3,4,12,0,16,1.8383838383838382,8,17
"['01', '1010101', '0000', '000100', '1100']",1,5,15,8,2,23,5.217404817404818,32,30
"['001', '110', '111110']",1,3,4,8,2,12,1.222222222222222,11,9
"['0100010', '10101', '111110', '111']",1,4,8,13,0,21,3.1546620046620046,20,15
"['000110', '00101', '101', '1101000', '000000', '01001']",1,6,21,11,4,32,8.486713286713286,47,46
"['1110101', '00', '01101']",1,3,6,8,0,14,1.6825396825396823,11,6
"['0010', '010', '110', '101', '001110', '11100', '01110']",1,7,14,15,5,29,13.875252525252526,48,68
"['001111', '1111000', '0001000']",1,3,11,9,2,20,1.6483516483516483,12,17
"['1111011', '0001110', '1001', '110011', '10', '0011100', '1011111']",1,7,15,25,4,40,12.398790098790098,78,57
"['00011', '11', '1111110', '01100', '0100']",1,5,10,13,2,23,5.050937950937951,36,28
"['0010', '1101011', '1111', '1000', '110', '1110']",1,6,10,16,4,26,8.535064935064934,38,49
"['001', '0100110', '00101', '10010', '1111011']",1,5,13,14,4,27,6.371428571428572,33,22
"['0', '10011', '111001']",1,3,5,7,0,12,1.3463203463203464,12,5
"['001', '000011', '11', '0001', '10', '110101']",1,6,12,11,4,23,7.384920634920634,44,45
"['0011', '011110', '000', '0001011', '001001']",1,5,15,11,2,26,6.14058164058164,31,36
"['1010000', '1', '00011']",1,3,8,5,0,13,1.0833333333333333,14,8
"['1110000', '0111011', '1101000', '0011110', '100', '10', '000']",1,7,19,17,6,36,11.558730158730159,82,68
"['01101', '0001110', '1000', '10100', '110']",1,5,13,11,2,24,5.677994227994228,29,27
"['0110101', '01', '00111', '100', '01111', '0000', '1101', '1011000']",1,8,18,19,6,37,14.708080808080808,89,78
"['10001', '100', '111111', '10100', '11101', '1110']",1,6,10,18,3,28,8.425974025974027,39,54
"['011', '111', '00', '11101', '110101']",1,5,6,13,2,19,5.162987012987013,26,33
"['1101001', '001101', '0111011', '100', '1000', '000', '11100']",1,7,18,17,4,35,12.695510045510046,63,63
"['1111', '110011', '1010', '00', '0111']",1,5,7,13,3,20,5.25,27,28
"['0111001', '111010', '0110', '0000111', '111000']",1,5,14,16,4,30,6.339027639027639,35,32
"['0', '1011010', '11110', '110010', '011']",1,5,9,13,0,22,4.894844044844045,34,27
"['000101', '000', '11']",1,3,7,4,0,11,1.1666666666666665,10,8
"['0010', '100', '1111', '000001', '0000010', '01100']",1,6,19,10,2,29,6.91961371961372,49,48
"['100110', '10011', '0111', '1011111']",1,4,7,15,0,22,4.185081585081585,15,24
"['10111', '1001', '10110', '0111']",1,4,6,12,4,18,4.188888888888889,11,22
"['01', '0001', '1011', '000111', '110']",1,5,9,10,2,19,5.434920634920635,26,27
"['01', '100100', '1', '0011100']",1,4,9,7,0,16,2.6083638583638584,24,13
"['001', '11', '1010101', '11100', '0111100']",1,5,10,14,2,24,4.9222222222222225,37,27
"['11011', '10000', '010010', '10', '0110011']",1,5,13,12,2,25,5.862592962592963,31,24
"['110010', '011001', '111010', '11', '0000', '0111110']",1,6,14,17,3,31,7.733721833721834,50,39
"['1101', '110', '111100']",1,3,4,9,0,13,2.123809523809524,7,10
"['101', '010', '0011']",1,3,5,5,2,10,1.8095238095238093,6,4
"['101', '0010', '00101']",1,3,7,5,0,12,2.2103174603174605,5,9
"['101010', '11110', '111110', '0110']",1,4,7,14,2,21,3.2727272727272725,12,26
"['001', '10110', '0010101']",1,3,8,7,0,15,1.7666666666666666,10,9
"['001', '0011', '0110', '011110', '0101', '0100']",1,6,13,12,4,25,9.865873015873015,32,51
"['1011', '1101', '0001', '111001']",1,4,7,11,3,18,3.75,14,25
"['0', '01101', '100']",1,3,5,4,0,9,1.3333333333333333,9,6
"['000110', '1101111', '0100010', '00111', '0111', '1001111']",1,6,15,21,3,36,9.91945831945832,43,47
"['0011', '1', '1101110']",1,3,4,8,0,12,1.1954545454545453,13,7
"['011', '11', '00', '00010', '1001011']",1,5,10,9,2,19,4.712698412698413,32,24
"['0', '01', '1111011']",1,3,3,7,0,10,1.3611111111111112,12,4
"['11110', '010', '111', '00100', '0110', '100010', '100111']",1,7,15,17,6,32,12.015945165945165,57,59
"['0', '1100010', '1111']",1,3,5,7,0,12,0.7954545454545454,14,6
"['1', '10111', '1111001', '0000', '110101']",1,5,9,14,0,23,3.8514097014097013,39,29
"['101011', '0011', '11']",1,3,4,8,0,12,1.9666666666666668,8,14
"['001', '00101', '1110011', '100', '10']",1,5,10,10,2,20,5.999206349206349,30,26
"['0', '00101', '1011110', '1100000', '11101', '001110']",1,6,15,16,4,31,7.332933732933733,59,38
"['1100', '10110', '111']",1,3,4,8,0,12,1.7380952380952381,6,8
"['00111', '0111', '1111']",1,3,3,10,2,13,2.3055555555555554,4,17
"['0010001', '101', '0001', '1111', '00110', '1100']",1,6,14,13,3,27,7.945093795093795,44,42
"['0', '1000011', '00101', '01100']",1,4,11,7,2,18,2.4833333333333334,24,11
"['0001101', '01', '00', '10110']",1,4,9,7,2,16,3.198412698412698,20,15
"['00100', '10001', '011']",1,3,8,5,2,13,1.6,9,4
"['00', '001', '1001011', '11']",1,4,7,7,2,14,2.688888888888889,19,14
"['0', '110001', '00101', '11']",1,4,7,7,0,14,2.2359307359307357,21,13
"['1010001', '010', '010001', '10']",1,4,11,7,0,18,3.9341880341880344,18,19
"['1100111', '00', '01111']",1,3,5,9,0,14,1.3968253968253967,12,7
"['100110', '1101101', '011', '0101']",1,4,8,12,0,20,4.038494838494838,17,16
"['111110', '001', '10']",1,3,4,7,0,11,1.1222222222222222,11,7
"['1000100', '011010', '00001', '100', '11101', '110111', '0101']",1,7,18,18,4,36,11.831179931179932,64,54
"['1111100', '101', '1000', '1001']",1,4,8,10,2,18,3.669480519480519,18,20
"['1001110', '01', '0101111', '0001011', '1110']",1,5,11,16,3,27,5.445887445887446,38,28
"['0010101', '11010', '10011', '0001000']",1,4,14,10,4,24,3.447619047619048,19,13
"['1011', '11100', '1']",1,3,3,7,0,10,1.1777777777777778,10,9
"['00111', '1000', '000', '11111']",1,4,8,9,2,17,2.623809523809524,19,21
"['1011', '010', '1100', '0110']",1,4,7,8,3,15,4.0,12,13
"['11', '1010', '1001', '00000']",1,4,9,6,2,15,2.9722222222222223,17,11
"['100110', '011', '000']",1,3,7,5,2,12,1.6666666666666665,8,6
"['100', '1010', '10011', '1111111', '1111011']",1,5,7,19,2,26,5.64004329004329,33,43
"['01101', '1000', '001', '0100000']",1,4,13,6,0,19,3.1431457431457432,19,18
"['1', '00101', '000', '0111110']",1,4,8,8,0,16,2.2333333333333334,24,12
"['01001', '110100', '11']",1,3,6,7,0,13,1.7987012987012987,10,8
"['0010001', '0011', '1000', '0101100']",1,4,14,8,4,22,3.9415584415584415,18,19
"['0110101', '10100', '10']",1,3,7,7,0,14,1.6825396825396823,11,7
"['100', '101000', '1001', '0110']",1,4,10,7,2,17,3.595238095238095,15,15
"['11110', '101', '1000110', '1111001', '00', '01100']",1,6,13,16,4,29,8.350793650793651,52,36
"['100110', '0010', '0000']",1,3,10,4,2,14,2.15,6,11
"['000110', '11111', '10', '001000']",1,4,10,9,2,19,2.331168831168831,24,14
"['110000', '11110', '001001', '00111', '0101', '01000']",1,6,17,14,5,31,8.332323232323233,45,45
"['11001', '010001', '00000', '00001', '101', '1100001', '100', '01111', '0001111']",1,9,26,20,8,46,20.794427794427794,110,121
"['01', '01010', '1111']",1,3,4,7,0,11,1.349206349206349,9,5
"['1000', '0101100', '1111']",1,3,7,8,2,15,1.1590909090909092,10,5
"['00', '100', '10', '11']",1,4,5,4,3,9,3.0,8,13
"['0010', '10', '1100100']",1,3,8,5,0,13,1.8383838383838382,10,8
"['11001', '111', '1001101', '1000', '10']",1,5,9,12,0,21,5.778860028860029,29,33
"['11001', '00010', '00']",1,3,8,4,2,12,1.7428571428571429,9,6
"['101', '11011', '101111']",1,3,3,11,0,14,2.143939393939394,7,16
"['1111100', '110001', '1']",1,3,5,9,0,14,1.151098901098901,15,9
"['00', '0110', '0100110']",1,3,8,5,0,13,1.8383838383838382,10,16
"['0100010', '01', '11100']",1,3,8,6,0,14,1.2301587301587302,13,7
"['01', '001001', '100011']",1,3,8,6,2,14,1.6666666666666665,11,7
"['1111000', '100', '1100100']",1,3,9,8,2,17,1.9142857142857141,11,11
"['100100', '1000', '1010001', '111000', '01100']",1,5,17,11,2,28,7.138461538461539,24,31
"['00111', '10000', '10101', '111']",1,4,8,10,3,18,3.35,16,20
"['0000', '101000', '1101100']",1,3,11,6,0,17,1.732867132867133,8,13
"['11001', '110011', '10', '1011', '0101', '1001111']",1,6,10,18,2,28,9.728033078033079,42,59
"['11001', '001111', '101101', '0011001', '011001']",1,5,13,17,3,30,7.476689976689977,21,42
"['1', '011100', '00111', '1110110', '01001', '01011']",1,6,12,17,3,29,8.171611721611722,52,37
"['10001', '100', '10']",1,3,6,4,0,10,2.1214285714285714,6,10
"['110000', '0', '0110100', '101', '0111']",1,5,11,10,0,21,4.948090798090798,36,22
"['0', '0010', '01110']",1,3,6,4,0,10,1.4,9,13
"['101', '1000010', '1010111', '10', '01000']",1,5,13,11,2,24,5.698412698412699,35,26
"['1', '0110', '0010010', '0111111', '01001']",1,5,11,13,2,24,4.934632034632035,38,23
"['0011', '1110010', '00101', '11']",1,4,8,10,0,18,3.783549783549783,19,19
"['0', '1010', '110', '1110']",1,4,5,7,2,12,3.2285714285714286,11,17
"['11011', '01', '001', '000010']",1,4,9,7,0,16,3.4017316017316017,18,12
"['1111', '10000', '00011']",1,3,7,7,2,14,1.2666666666666666,10,10
"['1000', '1110000', '11']",1,3,7,6,0,13,1.505050505050505,11,10
"['01', '0111011', '0011110', '1100000', '111011', '00']",1,6,14,17,5,31,7.265873015873016,64,43
"['01', '001001', '110111', '1010011']",1,4,9,12,2,21,3.482905982905983,21,17
"['011100', '1001', '1101011', '0110', '0100']",1,5,12,13,3,25,6.479720279720279,29,22
"['1001100', '1011', '11100', '000011']",1,4,11,11,0,22,3.584071484071484,20,22
"['0000111', '0110101', '011011', '111']",1,4,9,14,2,23,3.9765567765567766,18,23
"['110000', '000011', '1001', '0101100', '000']",1,5,17,9,2,26,5.9476523476523475,33,34
"['1010', '1', '0110']",1,3,4,5,2,9,1.3,8,5
"['111100', '1111101', '11', '1001100', '1011']",1,5,8,18,2,26,5.838172938172939,33,41
"['001', '100000', '01011', '000111']",1,4,12,8,2,20,3.202020202020202,19,17
"['0', '1010000', '1011011']",1,3,8,7,2,15,1.0714285714285714,15,6
"['00', '1110010', '10']",1,3,6,5,2,11,1.3888888888888888,11,7
"['0', '0011', '0001', '101']",1,4,7,5,2,12,3.192857142857143,13,12
"['101100', '11101', '11100', '10']",1,4,7,11,2,18,3.897402597402597,14,19
"['1001100', '1011', '10110', '000000']",1,4,13,9,0,22,3.6285159285159287,18,17
"['0110100', '1100010', '01111', '10', '110']",1,5,11,13,2,24,5.555555555555555,37,29
"['0', '1001', '1010111']",1,3,5,7,0,12,1.3772727272727274,12,5
"['01', '00011', '00100', '10101', '100111']",1,5,12,11,3,23,6.014285714285714,28,23
"['1011010', '100001', '111', '011', '001010', '1011100', '011001', '0001010']",1,8,23,22,8,45,17.363369963369962,90,77
"['11110', '10100', '0111100']",1,3,7,10,2,17,1.9,7,8
"['01', '1101', '10', '100010']",1,4,7,7,2,14,3.433333333333333,17,15
"['11', '10101', '0000001', '00', '1100110', '01000']",1,6,17,11,6,28,6.750793650793651,58,35
"['1', '11000', '1010100', '1111010', '1011000']",1,5,13,14,3,27,5.392857142857142,36,29
"['0101000', '1', '0010000', '101', '10001', '0011011']",1,6,18,12,3,30,7.766666666666667,58,35
"['10100', '100101', '011', '1']",1,4,7,8,0,15,2.831168831168831,19,15
"['00', '010', '0011010', '11111']",1,4,8,9,0,17,2.5944444444444446,23,16
"['001', '100', '0110']",1,3,6,4,2,10,1.8095238095238093,6,7
"['1000110', '01', '001', '001111']",1,4,9,9,0,18,3.6264957264957265,20,15
"['110011', '0010111', '101001', '11']",1,4,8,13,2,21,3.3547008547008548,21,26
"['0010', '001001', '1']",1,3,7,4,0,11,1.4857142857142858,10,7
"['1001110', '1100', '0']",1,3,6,6,0,12,1.1954545454545453,13,6
"['0', '010011', '000100']",1,3,9,4,2,13,1.2380952380952381,13,8
"['1110110', '00', '001110']",1,3,7,8,0,15,1.5598290598290598,12,12
"['0', '100110', '0111010', '11']",1,4,7,9,0,16,2.0955433455433456,26,11
"['001101', '10100', '10', '0001111']",1,4,10,10,0,20,2.9416694416694416,23,16
"['0111001', '010', '001011']",1,3,8,8,0,16,1.7282051282051283,10,7
"['0000', '01', '1101010']",1,3,8,5,0,13,1.323232323232323,12,6
"['0011011', '0001', '11']",1,3,6,7,0,13,1.323232323232323,11,9
"['1111100', '0101110', '00', '111110', '0001000']",1,5,14,15,3,29,5.2976190476190474,38,42
"['101011', '00011', '000111', '111011']",1,4,9,14,3,23,4.181818181818182,14,32
"['1011', '01100', '11']",1,3,4,7,0,11,1.9047619047619047,8,6
"['000', '010', '111', '0100101']",1,4,9,7,3,16,2.8,18,12
"['00', '010', '1000111', '1001101']",1,4,10,9,2,19,3.546031746031746,22,10
"['11011', '001111', '00011', '000', '011111', '1011']",1,6,11,18,4,29,8.504906204906204,40,55
"['1000', '100100', '0110110']",1,3,10,7,0,17,1.9608391608391609,9,9
"['0001001', '100101', '10010', '1011100', '000000', '1000011', '011010']",1,7,27,17,6,44,12.923576423576424,63,59
"['1010110', '00100', '100', '001100', '0101', '1100']",1,6,17,12,2,29,10.296287046287047,36,54
"['101', '1110010', '11']",1,3,4,8,0,12,1.8444444444444446,10,10
"['001', '0111010', '010000', '1001100', '0100001', '111001']",1,6,21,15,5,36,9.222100122100123,49,44
"['0', '101001', '11']",1,3,4,5,0,9,0.7857142857142857,11,4
"['101', '1010110', '11']",1,3,4,8,0,12,1.8444444444444446,10,10
"['101', '00101', '100010']",1,3,8,6,0,14,2.143939393939394,8,9
"['01', '111110', '011', '0000000']",1,4,10,8,0,18,2.0705128205128207,28,14
"['0', '1001000', '1101011']",1,3,8,7,2,15,1.0714285714285714,15,4
"['0', '1101', '0100001', '0110']",1,4,9,7,2,16,2.8909090909090907,22,12
"['01', '1001', '0001']",1,3,6,4,2,10,2.083333333333333,5,10
"['1000', '100', '10000']",1,3,9,3,0,12,2.496031746031746,4,17
"['1001110', '00011', '0110', '011110', '0000', '11100']",1,6,16,15,4,31,9.192463092463093,43,53
"['101', '0010', '100011']",1,3,7,6,0,13,1.838095238095238,8,5
"['11100', '010101', '011', '010110']",1,4,9,11,2,20,3.9393939393939394,17,18
"['101100', '0101111', '100', '0010101', '10100', '011111', '1100', '1110']",1,8,18,24,6,42,16.656221556221556,83,88
"['0001011', '00', '011']",1,3,7,5,0,12,1.4444444444444444,11,10
"['001', '1101011', '0110', '00110', '011001']",1,5,12,13,0,25,6.618942168942169,28,28
"['001', '011', '1110011', '1001000', '000']",1,5,13,10,5,23,5.438095238095238,34,28
"['111010', '101011', '1101101', '00110', '10011', '000010', '11100']",1,7,18,22,6,40,13.14918414918415,59,59
"['1101100', '10', '0000100', '11']",1,4,10,8,4,18,2.626984126984127,25,15
"['010100', '1111100', '0101110', '01111', '01011']",1,5,12,18,4,30,6.471628371628372,25,42
"['00', '10010', '11111', '0101', '1100']",1,5,9,11,4,20,5.026984126984127,28,22
"['1111100', '110110', '000']",1,3,7,9,0,16,1.45982905982906,11,9
"['1010110', '101101', '0111', '00001']",1,4,10,12,0,22,3.2560994560994563,18,15
"['01', '100', '0111111', '1100101', '0011111', '0100']",1,6,12,18,3,30,7.5870129870129865,60,42
"['0', '111111', '010000']",1,3,6,7,2,13,0.45238095238095233,16,4
"['101', '10011', '011', '01100']",1,4,7,9,4,16,4.016666666666667,15,15
"['0', '101000', '110']",1,3,6,4,0,10,1.2301587301587302,10,6
"['11110', '111100', '00101']",1,3,6,10,2,16,1.6727272727272728,9,11
"['01', '1', '101000', '00100', '10011']",1,5,11,8,2,19,5.134632034632034,32,21
"['111100', '111110', '001110', '10', '000100']",1,5,12,14,4,26,5.666666666666667,31,36
"['0010110', '001', '11', '10110', '111110', '100101']",1,6,12,17,2,29,8.22877122877123,49,42
"['000001', '0101100', '00011']",1,3,12,6,0,18,1.7016317016317015,9,10
"['1000000', '1010', '111100']",1,3,10,7,0,17,1.606993006993007,11,8
"['0010', '1', '0011', '1011101', '0001', '000001']",1,6,15,11,3,26,7.747952047952048,48,41
"['11011', '00011', '11', '1001', '00']",1,5,8,10,4,18,5.266666666666667,25,31
"['010100', '0001110', '011100', '11', '11000', '00', '0101001']",1,7,20,15,6,35,12.023532023532024,70,71
"['1111100', '001', '00101', '101101', '0001', '0011010', '00']",1,7,18,16,2,34,12.122494172494171,67,71
"['0000111', '000', '100010']",1,3,11,5,0,16,1.882051282051282,10,10
"['1110010', '101', '10100', '0111', '001011']",1,5,11,14,0,25,6.005500055500056,30,27
"['1010', '00110', '1000', '0001011', '11100']",1,5,14,11,4,25,5.885353535353535,29,30
"['01', '10', '10011']",1,3,4,5,2,9,1.6428571428571428,8,7
"['101000', '001', '111', '101011']",1,4,8,10,4,18,2.7777777777777777,18,20
"['0', '0010011', '0100']",1,3,8,4,0,12,1.3772727272727274,12,9
"['101', '011010', '10011', '0100101']",1,4,10,11,0,21,4.164685314685315,16,14
"['1000100', '101011', '1100001', '01']",1,4,12,10,2,22,3.333943833943834,23,17
"['1000001', '011', '1110']",1,3,7,7,0,14,1.335064935064935,12,7
"['01', '00', '010']",1,3,5,2,2,7,2.1,3,9
"['0001', '0010', '1111110']",1,3,7,8,2,15,1.2954545454545454,13,8
"['0001001', '0001110', '101', '000010', '000']",1,5,18,8,4,26,5.697191697191697,34,41
"['01', '0111', '1111']",1,3,2,8,2,10,1.75,6,11
"['001101', '11', '11000', '101', '0000', '1101010']",1,6,14,13,0,27,8.174547674547675,49,43
"['0011001', '10110', '1110000', '000']",1,4,13,9,2,22,3.6047619047619044,22,19
"['01111', '1', '01110']",1,3,3,8,2,11,1.4666666666666668,9,7
"['1011101', '000101', '10', '110100']",1,4,10,11,2,21,3.0213675213675213,22,16
"['1000100', '111', '00011', '011011', '00', '1101']",1,6,13,14,0,27,7.736574536574536,49,43
"['1010000', '010011', '1101101', '011010']",1,4,13,13,4,26,3.686813186813187,18,12
"['01', '100', '110111', '10', '000']",1,5,8,8,4,16,4.833333333333333,27,21
"['1111100', '0011', '10', '0001111']",1,4,8,12,2,20,2.6623376623376624,27,20
"['011100', '100', '000', '00010', '1110']",1,5,13,8,2,21,5.674819624819625,25,39
"['010000', '0110111', '001000', '100', '110', '01110']",1,6,17,13,4,30,8.652874902874903,48,49
"['011011', '101', '000100', '111']",1,4,8,10,4,18,3.1666666666666665,20,12
"['001', '1', '010000', '0100010', '10110']",1,5,14,8,0,22,5.048690198690198,35,24
"['0101111', '10000', '110001']",1,3,9,9,0,18,1.3682983682983683,11,7
"['10111', '001110', '011', '101001']",1,4,8,12,2,20,4.037878787878788,16,13
"['0', '10101', '110', '1111']",1,4,4,9,0,13,2.571428571428571,16,12
"['0001', '1000', '100101']",1,3,9,5,2,14,2.15,6,11
"['11', '010111', '0100']",1,3,5,7,0,12,1.4333333333333333,10,8
"['011', '00101', '0101011', '010011', '1100']",1,5,12,13,0,25,6.495010545010545,28,34
"['10101', '010', '101111']",1,3,5,9,0,14,1.9217171717171717,8,6
"['1', '0001', '100110', '001001', '101110']",1,5,12,11,3,23,4.857142857142857,35,26
"['1011110', '0011', '0']",1,3,5,7,0,12,1.1954545454545453,13,6
"['01', '11011', '0100010', '1010100', '1111110', '100011', '000', '1100']",1,8,20,21,3,41,13.764074814074814,98,72
"['10111', '10001', '0000011']",1,3,9,8,2,17,1.7666666666666666,9,10
"['010011', '111100', '1111001']",1,3,7,12,2,19,2.0384615384615383,10,13
"['1111100', '010', '0011010', '111110', '000000', '1100011']",1,6,18,18,5,36,7.400610500610501,61,48
"['0', '100001', '1000101', '1111110', '00110']",1,5,13,13,2,26,4.347652347652348,43,22
"['000110', '00010', '001010']",1,3,12,5,2,17,2.4696969696969697,4,21
"['101011', '01011', '0111']",1,3,5,10,0,15,2.175757575757576,4,13
"['1101', '01101', '010111', '100111']",1,4,7,14,2,21,4.376767676767677,14,23
"['010000', '10110', '0011111', '111110']",1,4,10,14,2,24,3.182983682983683,21,19
"['001111', '1010', '00110', '111111', '0000', '1101', '0011100']",1,7,16,20,5,36,11.117637917637918,65,68
"['0010', '1111001', '1110001', '00', '00010']",1,5,14,11,2,25,6.13059163059163,36,28
"['100', '1001', '1011001']",1,3,7,7,0,14,2.1844155844155844,8,15
"['0010', '10101', '000']",1,3,8,4,0,12,2.0238095238095237,6,6
"['10001', '11011', '11100']",1,3,6,9,3,15,1.7999999999999998,8,10
"['101', '1010', '0011100', '11']",1,4,7,9,0,16,3.7137085137085135,18,12
"['1', '0000100', '0011', '1010111', '000']",1,5,13,9,2,22,4.172727272727273,40,27
"['0100001', '0110', '1']",1,3,7,5,0,12,1.1954545454545453,13,5
"['000110', '0010111', '11', '101', '100', '01110']",1,6,12,14,2,26,8.28075258075258,46,34
"['110110', '01', '111', '00000']",1,4,8,8,0,16,2.216017316017316,22,12
"['00', '100', '1100000']",1,3,9,3,0,12,1.8444444444444446,10,11
"['11001', '0011', '11100']",1,3,6,8,2,14,1.911111111111111,9,10
"['0', '010101', '00111']",1,3,6,6,0,12,1.3463203463203464,11,6
"['10001', '1101011', '0001111', '1000000', '0111']",1,5,15,15,3,30,5.327561327561328,37,33
"['1101', '0101', '00011']",1,3,6,7,2,13,1.8611111111111112,6,9
"['1010110', '00100', '100', '0001100', '0100']",1,5,17,9,2,26,7.364862914862915,26,47
"['0011', '11000', '100011', '00000']",1,4,13,7,2,20,3.5616161616161617,17,22
"['01', '1001000', '1']",1,3,6,4,0,10,1.3611111111111112,12,6
"['10', '1111001', '000']",1,3,6,6,0,12,1.2444444444444445,12,4
"['0', '101', '100011']",1,3,5,5,0,10,1.4523809523809523,10,5
"['0', '00100', '11']",1,3,5,3,0,8,0.6190476190476191,10,4
"['01', '0011', '0011110', '0101010', '0100']",1,5,13,11,4,24,5.657287157287157,33,36
"['01', '010', '00011', '011011', '00100']",1,5,12,9,2,21,6.0504329004329005,27,29
"['001100', '1001', '001111', '10']",1,4,9,9,2,18,3.283333333333333,21,15
"['10010', '001011', '1110']",1,3,7,8,0,15,1.5717171717171716,9,8
"['11001', '0111010', '0011001', '0011', '0000', '0001011', '0010010']",1,7,24,17,6,41,13.732323232323232,61,72
"['001', '0110111', '1010101', '01111', '0110000', '00', '000111']",1,7,18,19,3,37,11.54961704961705,74,65
"['1', '101110', '0010000']",1,3,8,6,0,14,0.9972527472527473,15,4
"['110110', '01001', '0011', '011']",1,4,8,10,0,18,4.085930735930736,14,17
"['00001', '0011', '01010', '000010', '1110', '111001']",1,6,17,13,6,30,8.163636363636364,43,45
"['100101', '10', '01100']",1,3,7,6,0,13,1.6168831168831168,10,5
"['1', '101', '11000', '10000', '010101', '001011']",1,6,14,12,4,26,7.522943722943722,49,40
"['0', '101', '111000', '111001']",1,4,7,9,2,16,3.015873015873016,20,15
"['00110', '000', '101101']",1,3,8,6,0,14,1.9217171717171717,8,6
"['0', '110', '00101']",1,3,5,4,0,9,1.3333333333333333,9,6
"['110110', '01', '0110', '10010', '0000110']",1,5,13,11,0,24,6.385803085803086,29,35
"['110010', '00', '10', '011110', '101110', '111001']",1,6,12,16,6,28,8.5,49,38
"['1', '011', '0110001', '110101']",1,4,7,10,0,17,3.0716117216117214,22,18
"['0', '010', '0111']",1,3,4,4,0,8,1.4714285714285715,7,9
"['101', '10111', '0100100', '111011']",1,4,8,13,0,21,3.7054778554778554,19,17
"['0', '100001', '01110']",1,3,7,5,0,12,0.9826839826839826,14,4
"['010100', '001', '1011001', '0010000', '101']",1,5,16,10,4,26,6.087667887667887,32,28
"['0', '0111001', '0010111', '000011', '0101011', '111101']",1,6,15,19,5,34,7.0503663003663,58,39
"['01001', '001010', '000001', '11']",1,4,12,7,2,19,3.275974025974026,20,13
"['0', '0010', '1111001', '1010', '0000111']",1,5,12,11,4,23,4.478571428571429,43,23
"['11', '10', '01000', '00011']",1,4,8,6,4,14,2.814285714285714,18,14
"['1001110', '1011101', '00110', '111111', '0111', '01000']",1,6,13,21,4,34,8.911843711843712,46,35
"['0', '10110', '11']",1,3,3,5,0,8,0.9047619047619047,9,4
"['1010110', '01101', '11', '00110', '100000']",1,5,13,12,2,25,5.661777111777112,34,23
"['01', '101', '0001111', '1011100', '01110']",1,5,10,14,2,24,5.8317460317460315,35,23
"['01', '1', '1001101']",1,3,4,6,0,10,1.3611111111111112,12,9
"['0110100', '00001', '101010', '00011', '110001', '100100', '11111']",1,7,21,19,6,40,12.116783216783217,63,58
"['000110', '000011', '0001', '10100', '01011']",1,5,16,10,4,26,6.104040404040404,25,32
"['00100', '100000', '111']",1,3,9,5,0,14,1.0176767676767677,11,6
"['01101', '111', '00000', '1100001', '10001', '100110', '1000', '1100111', '011010']",1,9,25,23,7,48,21.595376845376844,109,103
"['00', '1101111', '10101', '011']",1,4,6,11,0,17,3.2103174603174605,20,12
"['0', '1000100', '1110111', '100001']",1,4,11,10,2,21,2.4450549450549453,27,13
"['11000', '110', '10', '011000']",1,4,9,7,0,16,4.197186147186147,14,19
"['0', '1110001', '10001', '0100110']",1,4,11,9,2,20,2.9047619047619047,25,12
"['11001', '11', '1010101', '1101101', '1110100', '1101']",1,6,11,21,3,32,9.912698412698413,44,78
"['0010', '1', '000', '111100']",1,4,8,6,0,14,2.3873015873015873,20,15
"['00110', '110010', '01100']",1,3,9,7,2,16,2.254545454545455,8,10
"['00010', '10010', '111', '110010']",1,4,10,9,2,19,3.853030303030303,14,22
"['101011', '1101', '10']",1,3,4,8,0,12,1.7666666666666666,8,10
"['01', '111111', '10']",1,3,2,8,2,10,1.0,12,6
"['0', '001100', '0011101', '110101']",1,4,10,10,2,20,2.8727106227106227,25,16
"['111', '00100', '00', '0111', '0010010']",1,5,12,9,0,21,4.6795815295815295,33,35
"['0001', '1010101', '1']",1,3,6,6,0,12,1.0136363636363637,12,9
"['010100', '010', '0110', '1101100', '1010', '0110001', '1111011']",1,7,18,20,5,38,14.006277056277057,64,59
"['01', '1010100', '1110100', '0111100']",1,4,11,12,3,23,3.619047619047619,21,21
"['0', '10', '011100']",1,3,5,4,0,9,1.4523809523809523,10,8
"['0', '1001', '01011', '1111111']",1,4,5,12,0,17,2.0969696969696967,25,12
"['101000', '101', '11']",1,3,5,6,0,11,1.9666666666666668,8,10
"['1011010', '1', '0111110']",1,3,5,10,2,15,1.2142857142857144,15,5
"['01100', '101011', '10110', '11101', '000', '0101001', '1011111']",1,7,16,22,5,38,11.902003552003553,63,53
"['11001', '01', '00111', '100110', '01010', '1111011']",1,6,12,18,3,30,8.922599622599623,51,37
"['1000110', '010', '001111', '0000000']",1,4,15,8,2,23,2.738949938949939,24,17
"['0', '01000', '110100']",1,3,8,4,0,12,1.3463203463203464,11,9
"['011100', '1010100', '1010', '000001', '01001', '0100']",1,6,20,12,4,32,9.491569541569541,42,52
"['0', '011011', '11100', '0111110']",1,4,7,12,0,19,2.8503996003996,23,17
"['0', '01000', '1110']",1,3,6,4,0,10,1.1777777777777778,10,8
"['0101111', '110', '01000', '11']",1,4,7,10,0,17,2.9301587301587304,22,17
"['00100', '0000010', '0000']",1,3,14,2,0,16,2.282828282828283,7,24
"['0', '111110', '100000']",1,3,7,6,2,13,0.9047619047619047,14,6
"['1001001', '1101', '1110']",1,3,6,9,2,15,1.6590909090909092,9,10
"['011', '0011', '011101', '1110', '0100']",1,5,9,12,3,21,6.166666666666666,24,29
"['11010', '1', '0110', '101001']",1,4,7,9,0,16,3.012987012987013,20,11
"['11', '1000', '10', '1010011', '0100']",1,5,10,9,4,19,5.411616161616162,29,24
"['0', '001', '0110100', '011100', '01010']",1,5,13,9,0,22,5.1971750471750475,32,40
"['010', '1110011', '1100', '000011']",1,4,10,10,0,20,3.1585303585303586,21,18
"['001', '101', '1101011', '10', '000']",1,5,9,9,3,18,5.111111111111111,27,22
"['1011', '01001', '1']",1,3,4,6,0,10,1.4,9,8
"['01', '11', '10001', '1000010', '0100100', '1010011', '110']",1,7,18,15,5,33,11.376190476190477,70,55
"['111010', '000011', '101', '1101000', '11100', '1111111']",1,6,13,21,4,34,7.966255966255966,54,56
"['11000', '0010101', '011101', '10', '1011']",1,5,11,13,0,24,5.6150960150960145,32,25
"['010100', '010', '011', '111', '00011', '0011100', '01001', '1110']",1,8,18,18,5,36,17.01923076923077,75,84
"['0101010', '0011', '11011']",1,3,7,9,0,16,1.8787878787878787,8,7
"['01101', '10011', '11']",1,3,4,8,2,12,1.7428571428571429,9,10
"['0', '1010', '111111', '0111']",1,4,4,11,2,15,2.3,22,14
"['01', '0001', '1110']",1,3,5,5,2,10,1.25,9,7
"['0', '101', '1110']",1,3,3,5,0,8,1.4714285714285715,7,4
"['000110', '010000', '1', '1011']",1,4,10,7,2,17,2.638095238095238,23,10
"['1011', '01', '100011', '111']",1,4,5,10,0,15,3.3825396825396825,14,25
"['0010111', '01110', '001000']",1,3,10,8,0,18,1.8275058275058274,9,12
"['11001', '000110', '1111101', '111100', '000101']",1,5,13,17,3,30,5.843822843822844,33,32
"['11', '100', '1010111', '1100110', '01110']",1,5,9,15,2,24,5.4412698412698415,35,26
"['1100010', '0011111', '110100', '0111110']",1,4,11,16,3,27,3.2527472527472527,22,18
"['010', '0111010', '0100110', '00', '1110', '0100']",1,6,15,12,4,27,9.116161616161616,44,70
"['1010111', '100011', '011']",1,3,6,10,0,16,2.0358974358974358,9,13
"['0', '101', '0011001', '1110000']",1,4,10,8,2,18,2.571428571428571,27,12
"['11', '100', '111011', '00', '1000']",1,5,8,9,2,17,4.651587301587302,28,29
"['01', '101', '11101', '000', '1100']",1,5,8,9,2,17,5.247619047619048,23,25
"['100', '1010', '001110', '000010', '1011']",1,5,13,10,4,23,5.734126984126984,27,29
"['011110', '101100', '10101', '000']",1,4,10,10,2,20,3.3282828282828283,19,14
"['110', '01011', '0000']",1,3,7,5,0,12,1.2301587301587302,9,7
"['01', '10000', '101111']",1,3,6,7,0,13,1.1493506493506493,12,7
"['10001', '1001', '011010']",1,3,8,7,0,15,2.0343434343434343,8,8
"['101100', '001', '0010000', '00011', '11101', '10010', '0111', '0100101']",1,8,23,19,5,42,16.4026085026085,84,75
"['11001', '0010', '0111010', '0111', '011001']",1,5,12,14,2,26,7.032867132867133,25,32
"['0010', '0101111', '010', '10100', '000', '110', '0110011']",1,7,17,15,5,32,12.34090909090909,61,64
"['011101', '0001', '101001']",1,3,8,8,2,16,1.7000000000000002,8,10
"['1010', '1100', '1', '010010']",1,4,8,7,2,15,3.0357142857142856,18,12
"['1100', '0111110', '000']",1,3,7,7,0,14,1.516883116883117,11,10
"['1100', '10', '0110110', '0010011']",1,4,10,10,2,20,3.2568542568542567,22,15
"['11010', '0110110', '0011010', '0010011', '10', '000', '11111', '010011', '111101']",1,9,21,27,7,48,19.0982017982018,117,106
"['010', '111', '1000', '011110', '1011']",1,5,8,12,4,20,5.166666666666666,25,21
"['1110001', '00', '011000']",1,3,9,6,0,15,1.7136752136752138,11,6
"['001', '0110111', '110001', '011001', '1011', '01011', '0110110', '1110']",1,8,17,25,6,42,17.104728604728606,75,89
"['000011', '11', '100', '10000', '100010', '10', '0111100']",1,7,18,13,4,31,11.383250083250083,71,62
"['1101001', '00', '1001', '1001100']",1,4,11,9,2,20,3.5815295815295816,21,18
"['0', '11010', '00101']",1,3,6,5,2,11,1.2666666666666666,11,6
"['0', '00101', '1001010', '11', '1001100']",1,5,12,10,2,22,4.65079365079365,38,22
"['0111000', '001000', '101', '101000', '0000']",1,5,18,8,2,26,5.914074814074814,27,48
"['0001101', '11000', '110', '100000']",1,4,13,8,0,21,3.637101787101787,21,20
"['010', '1001', '0011010', '10100', '1100']",1,5,13,10,2,23,6.737806637806638,26,25
"['0', '11100', '001010']",1,3,7,5,0,12,1.1645021645021645,12,9
"['01101', '001111', '010010', '100011', '1011100']",1,5,14,16,3,30,6.1923076923076925,32,22
"['0', '110', '10000', '0010101']",1,4,10,6,0,16,2.4833333333333334,23,13
"['001111', '110111', '10']",1,3,4,10,2,14,1.4166666666666665,12,9
"['011101', '101011', '0010111', '0111']",1,4,8,15,2,23,4.011888111888112,15,20
"['1011110', '11110', '011', '0011000']",1,4,9,13,2,22,3.604761904761905,20,17
"['01', '0101000', '11101', '1110100', '0100']",1,5,13,12,2,25,6.073593073593074,33,32
"['001000', '11', '110100', '00', '011110']",1,5,12,10,5,22,4.416666666666667,36,30
"['001100', '111000', '11']",1,3,7,7,2,14,1.6666666666666665,11,8
"['0', '010011', '010000']",1,3,9,4,2,13,1.2380952380952381,12,11
"['11001', '0010', '011', '1011101', '100101']",1,5,11,14,0,25,6.205694305694306,28,26
"['11010', '0110100', '10', '110111', '011001', '1011', '000100']",1,7,17,19,3,36,12.848507048507049,64,54
"['101', '11111', '0000']",1,3,5,7,0,12,0.7857142857142857,11,4
"['111', '111110', '10', '000', '1110']",1,5,6,12,2,18,4.798412698412698,27,33
"['011', '000011', '11', '100', '1000010', '1010011', '000111']",1,7,18,16,6,34,12.172283272283272,68,70
"['0111001', '010', '11', '0111', '000', '1011']",1,6,10,13,4,23,7.581457431457431,42,36
"['11', '0001101', '00', '01010', '011010', '1110']",1,6,13,13,2,26,7.966633366633366,46,40
"['100', '001', '00000', '0100']",1,4,12,3,2,15,3.5396825396825395,13,24
"['1101000', '11011', '10', '0000011']",1,4,11,10,2,21,2.833333333333333,26,22
"['0001011', '10111', '1100100', '111']",1,4,9,13,2,22,3.488095238095238,21,26
"['10111', '00110', '100100', '00001']",1,4,12,9,3,21,3.418181818181818,16,14
"['0100111', '00011', '10000', '000001', '01011', '110', '001011', '0110001']",1,8,25,19,7,44,16.614518814518814,82,88
"['11010', '011', '01011', '101001', '1110']",1,5,9,14,2,23,6.053751803751804,24,29
"['100011', '010010', '000']",1,3,10,5,2,15,2.0,9,4
"['11001', '11110', '00101', '1111', '00', '10011']",1,6,10,16,4,26,8.044444444444444,42,46
"['100', '1', '00011']",1,3,5,4,0,9,1.3333333333333333,9,7
"['1111010', '1110001', '11010']",1,3,7,12,2,19,2.2142857142857144,8,14
"['01', '0001', '110001', '1000000', '00110', '100000']",1,6,21,9,2,30,8.451809301809302,48,49
"['101', '0011', '111110', '011100']",1,4,7,12,2,19,3.126984126984127,19,12
"['011', '00000', '10', '00010', '0100']",1,5,14,5,2,19,5.156349206349207,25,35
"['00', '111100', '10', '1101011']",1,4,7,10,2,17,3.0042735042735043,22,14
"['01101', '001', '1']",1,3,4,5,0,9,1.3333333333333333,8,7
"['1100010', '1010110', '011']",1,3,8,9,2,17,1.4285714285714286,12,8
"['0', '1111101', '10111', '1101100', '1010011', '1101', '0110011']",1,7,13,25,4,38,11.65108225108225,76,72
"['11', '101', '1001', '1010', '1100']",1,5,7,10,3,17,7.335714285714285,17,33
"['0010', '100001', '001000', '0101', '110']",1,5,15,8,4,23,6.048412698412698,28,24
"['110000', '11', '0100']",1,3,7,5,0,12,1.4333333333333333,10,7
"['101', '00', '01001', '1111']",1,4,6,8,0,14,2.7373015873015873,16,11
"['0010', '01101', '11']",1,3,5,6,0,11,1.5714285714285714,8,4
"['00', '01011', '11']",1,3,4,5,2,9,1.1428571428571428,8,6
"['11110', '100', '000']",1,3,6,5,2,11,1.4166666666666665,8,8
"['01', '0001', '1110', '1101010']",1,4,8,9,2,17,2.6035353535353534,21,15
"['0001011', '10', '1110']",1,3,6,7,0,13,1.4747474747474747,12,8
"['001', '1', '011100']",1,3,5,5,0,10,1.2301587301587302,11,5
"['0', '01001', '0011101']",1,3,7,6,0,13,1.0833333333333333,13,7
"['101', '0011111', '1100110', '11']",1,4,6,13,2,19,3.2603174603174603,25,19
"['1001110', '01101', '1', '01111', '1010', '000001']",1,6,13,15,2,28,7.162909312909313,54,35
"['00111', '10101', '00101', '01100']",1,4,10,10,4,20,3.8,12,17
"['00111', '0011', '011', '11']",1,4,5,9,0,14,4.534126984126984,10,25
"['000100', '010', '011']",1,3,8,4,2,12,1.7777777777777777,8,9
"['0', '101', '100111']",1,3,4,6,0,10,1.4523809523809523,10,5
"['001111', '000011', '0001', '00', '10', '011001']",1,6,15,11,5,26,8.033333333333333,47,43
"['00111', '0001', '110011']",1,3,7,8,0,15,1.993939393939394,8,9
"['11011', '110100', '110', '01110', '1011111']",1,5,8,18,2,26,6.234265734265734,30,33
"['011', '101', '110111', '10', '011111', '1001001']",1,6,9,18,4,27,8.449145299145298,49,48
"['00100', '11110', '1']",1,3,5,6,2,11,1.0666666666666667,11,4
"['00', '1100000', '00101', '00011']",1,4,13,6,2,19,3.2206349206349207,21,23
"['010011', '10000', '01100']",1,3,10,6,2,16,1.8727272727272726,9,8
"['110110', '011', '00111', '1110100', '110111', '1101', '1101010']",1,7,13,25,4,38,14.193878343878344,57,90
"['0', '101000', '110', '100110']",1,4,9,7,2,16,2.849206349206349,21,15
"['0', '01', '111000']",1,3,5,4,0,9,1.2023809523809523,11,6
"['10100', '001', '0011100', '11']",1,4,9,8,0,17,3.1825396825396823,20,17
"['00', '110001', '00101', '010110']",1,4,11,8,2,19,3.344155844155844,21,13
"['11000', '101', '01111', '110011', '00', '100011']",1,6,12,15,4,27,8.36926406926407,45,46
"['010', '0110110', '1101000', '10010', '101110', '0001000']",1,6,20,15,3,35,9.469580419580419,47,52
"['000110', '001111', '0001', '10100', '11101', '0000']",1,6,17,13,6,30,8.172222222222222,42,51
"['11010', '0001', '1101101', '00', '11101', '10']",1,6,11,14,4,25,7.941414141414141,45,41
"['011', '1101000', '1100100', '011110', '0100001']",1,5,16,14,3,30,5.594139194139194,37,29
"['0', '0100000', '111', '01010', '1100']",1,5,12,8,0,20,4.133549783549784,36,25
"['111111', '000100', '001010', '10']",1,4,10,10,3,20,2.5833333333333335,24,13
"['1101001', '011', '110001', '0010100', '10010', '0001011', '000111', '01100']",1,8,25,21,7,46,18.08092463092463,88,80
"['11001', '0001', '1101']",1,3,6,7,2,13,2.0555555555555554,5,14
"['000111', '011', '000']",1,3,7,5,2,12,1.6666666666666665,8,11
"['11', '11000', '01111', '10010', '1011']",1,5,8,13,3,21,5.758730158730159,28,32
"['00', '1001', '0010']",1,3,7,3,2,10,2.083333333333333,6,6
"['0000111', '01', '001010']",1,3,9,6,0,15,1.5598290598290598,12,7
"['101', '1110001', '011100']",1,3,7,9,0,16,1.8136752136752137,11,5
"['0', '10111', '00001', '1111']",1,4,6,9,2,15,1.9555555555555555,20,14
"['1010', '1101111', '110']",1,3,4,10,0,14,1.7168831168831167,9,10
"['0', '0111000', '010010']",1,3,9,5,0,14,1.304945054945055,14,13
"['11100', '00101', '11']",1,3,5,7,2,12,1.5428571428571427,9,9
"['01100', '11100', '0110', '1']",1,4,7,8,2,15,3.422222222222222,15,16
"['0011110', '0001010', '000111', '1100', '01011']",1,5,15,14,2,29,6.066888666888667,30,34
"['0', '00010', '01001']",1,3,8,3,2,11,1.4666666666666668,10,8
"['100', '110', '111', '000101']",1,4,7,8,3,15,3.0,16,15
"['110000', '0001010', '1']",1,3,9,5,0,14,1.151098901098901,15,6
"['0110101', '0111001', '101', '100', '0010100']",1,5,14,13,5,27,6.20952380952381,32,28
"['001', '111', '101', '01111', '1000111', '1110100', '01110']",1,7,12,21,7,33,12.461904761904762,64,66
"['001', '01100', '1100110', '01110', '01000']",1,5,14,11,3,25,6.133333333333333,27,35
"['101010', '110100', '10010', '000', '01000']",1,5,16,9,4,25,7.153535353535354,21,32
"['01', '10', '0000000']",1,3,9,2,2,11,0.9444444444444444,14,6
"['1110111', '011', '0000']",1,3,6,8,0,14,1.0675324675324676,13,6
"['010', '011100', '00001', '00000', '0101011', '1010', '100111', '1010001', '0110010']",1,9,29,21,7,50,21.035764235764237,112,102
"['11011', '001', '00111', '100010', '00110']",1,5,12,12,3,24,6.484848484848484,25,28
"['1011', '100', '001111', '000']",1,4,8,8,2,16,3.0126984126984127,18,17
"['000011', '0110110', '100', '1011100', '10011', '010110', '001001', '01100', '1110']",1,9,25,24,7,49,23.208635808635808,106,108
"['11011', '111110', '000', '001000']",1,4,10,10,2,20,2.381313131313131,22,18
"['01001', '111000', '1']",1,3,6,6,0,12,1.1645021645021645,12,6
"['1', '1100001', '000000', '1101', '1001011']",1,5,14,11,2,25,4.345754245754246,42,29
"['1011110', '10110', '001011', '1']",1,4,7,12,0,19,3.045038295038295,23,17
"['0110000', '10000', '100110']",1,3,12,6,0,18,2.175990675990676,8,12
"['101', '01', '110001', '1101100']",1,4,8,10,0,18,3.6264957264957265,20,19
"['1000100', '1111000', '1110', '111']",1,4,9,12,2,21,3.5194805194805197,21,23
"['0', '0101010', '010']",1,3,7,4,0,11,1.35,12,16
"['110000', '1001', '100', '10', '1111011']",1,5,10,12,0,22,5.941913641913642,32,29
"['1001', '0111', '11']",1,3,3,7,2,10,1.8333333333333333,7,10
"['10', '0111110', '1111']",1,3,3,10,0,13,1.505050505050505,11,5
"['1', '000', '1101110']",1,3,5,6,0,11,0.65,14,4
"['00', '000111', '011', '1101']",1,4,7,8,0,15,2.8714285714285714,18,15
"['0001', '1111', '01001', '10', '00010', '1100', '01110']",1,7,15,14,6,29,11.43095238095238,53,53
"['1110010', '11100', '0111110', '111001']",1,4,9,16,2,25,4.518981018981019,14,24
"['0', '011', '0100010', '1001', '000010']",1,5,14,7,0,21,5.301936951936952,33,25
"['0', '1011010', '1010101', '01100']",1,4,10,10,2,20,2.738095238095238,23,12
"['010', '011010', '001', '000001']",1,4,12,6,4,18,3.222222222222222,19,20
"['00110', '010', '100', '10011']",1,4,9,7,4,16,3.966666666666667,14,14
"['1010', '001', '1000111']",1,3,7,7,0,14,1.7168831168831167,10,7
"['0001001', '111110', '0000110', '1001']",1,4,13,11,2,24,3.1562437562437564,23,17
"['0', '1011', '000100', '110101']",1,4,9,8,2,17,2.6714285714285717,22,9
"['010', '1001', '110', '0000']",1,4,9,5,4,14,3.1666666666666665,13,11
"['011011', '100101', '011100']",1,3,8,10,3,18,1.8333333333333333,10,6
"['101000', '00101', '10011', '0100']",1,4,12,8,2,20,4.024242424242424,15,14
"['011', '00000', '11', '0001111', '00010']",1,5,13,9,2,22,4.8468253968253965,34,34
"['1000', '010111', '111', '0100101']",1,4,9,11,0,20,3.295038295038295,19,18
"['001', '1011110', '1101000', '10', '010011', '011010']",1,6,15,16,4,31,7.886813186813187,55,37
"['1110101', '101', '001001', '111']",1,4,7,12,2,19,3.593162393162393,19,26
"['11001', '11110', '00', '111110', '0101', '1110', '0100']",1,7,12,18,5,30,11.956132756132757,55,65
"['001111', '1000110', '10011', '10', '0000', '1001001', '1110']",1,7,18,17,4,35,11.733655233655234,68,60
"['1110011', '1', '011']",1,3,3,8,0,11,1.35,12,11
"['101011', '0011110', '001111']",1,3,7,12,2,19,2.2051282051282053,6,10
"['0010001', '1100101', '110111', '11']",1,4,9,13,2,22,3.333943833943834,23,28
"['00110', '01101', '1', '0100']",1,4,8,7,2,15,2.977777777777778,17,12
"['1', '00100', '1100001', '10', '10011']",1,5,11,9,2,20,4.937301587301587,36,22
"['00', '0111001', '1']",1,3,5,5,0,10,0.6944444444444444,13,4
"['01111', '1', '0100']",1,3,4,6,0,10,1.1777777777777778,10,5
"['11', '11000', '100', '1110110', '00010']",1,5,11,11,2,22,5.151587301587301,33,28
"['110000', '100', '011', '00101']",1,4,10,7,2,17,3.058080808080808,20,16
"['010100', '010', '0100']",1,3,9,4,0,13,2.3238095238095235,6,21
"['0', '0010', '1110010', '100101', '10011', '0011100']",1,6,16,14,2,30,8.627738927738928,53,36
"['1110010', '111100', '101101', '01111', '00', '1010000']",1,6,15,18,4,33,8.779331779331779,51,42
"['01101', '101', '1101101', '00110', '0101']",1,5,10,14,2,24,7.108152958152958,24,33
"['0', '1011101', '0000001', '1010', '1100']",1,5,13,10,4,23,4.335714285714285,41,22
"['001', '1100000', '1110']",1,3,8,6,0,14,1.2311688311688311,12,8
"['10111', '100', '11101', '100000', '001010']",1,5,13,12,4,25,5.251515151515151,31,27
"['1110101', '1', '011111']",1,3,3,11,0,14,1.304945054945055,14,10
"['001100', '0001', '001001', '1011001']",1,4,14,9,2,23,4.299067599067599,14,23
"['1001000', '111100', '000']",1,3,10,6,0,16,1.505982905982906,11,13
"['0', '01', '11011', '0011110']",1,4,6,9,0,15,2.765873015873016,23,10
"['011011', '10111', '000']",1,3,6,8,0,14,1.4217171717171717,11,5
"['010', '001010', '101001', '0000']",1,4,13,6,2,19,3.7714285714285714,16,16
"['0001101', '0011', '1111001']",1,3,8,10,2,18,1.7012987012987013,12,9
"['111010', '11', '10001', '111110', '0000111', '01100']",1,6,13,18,4,31,8.125530025530026,53,42
"['010000', '00101', '10111', '00', '001011']",1,5,14,10,4,24,5.502597402597402,31,31
"['00011', '0001', '1111', '1010', '00']",1,5,10,9,3,19,4.932539682539682,26,27
"['101000', '00', '010', '100']",1,4,10,4,2,14,4.1,14,20
"['0010001', '1010', '1111111']",1,3,7,11,2,18,1.1948051948051948,14,6
"['010011', '11011', '1']",1,3,4,8,0,12,1.3463203463203464,11,11
"['1001100', '001111', '10']",1,3,7,8,0,15,1.3098290598290598,13,8
"['00111', '111', '11001']",1,3,4,9,2,13,2.1,8,15
"['111101', '10010', '1001010', '011000']",1,4,12,12,2,24,3.836829836829837,17,16
"['101000', '1', '001101']",1,3,7,6,2,13,1.0714285714285714,13,7
"['01', '00101', '000010', '11']",1,4,9,6,2,15,3.12012987012987,18,12
"['00010', '010', '1100101']",1,3,9,6,0,15,2.0166666666666666,9,6
"['0', '001101', '100', '100101', '001100', '1110']",1,6,14,12,3,26,7.873015873015873,47,41
"['0', '010000', '001101', '0011000', '101']",1,5,15,8,2,23,4.871001221001221,38,31
"['0010', '110', '000001']",1,3,9,4,0,13,1.3936507936507936,10,8
"['00001', '11', '00100', '0111', '110', '01100']",1,6,13,11,3,24,8.036507936507936,39,41
"['1000100', '01', '111010', '101', '100', '10000', '111111']",1,7,15,17,4,32,10.947175047175048,70,63
"['00111', '0011', '001']",1,3,6,6,0,12,2.496031746031746,4,14
"['010', '001010', '111', '0100']",1,4,9,7,2,16,3.3873015873015873,15,17
"['010011', '010111', '110111']",1,3,6,12,3,18,2.3333333333333335,4,16
"['10001', '010', '011110', '101101']",1,4,9,11,2,20,3.590909090909091,19,12
"['01', '10001', '010']",1,3,6,4,0,10,1.8714285714285714,7,6
"['01', '00101', '11', '10000', '1110110', '01000']",1,6,14,12,5,26,7.4603174603174605,52,36
"['010', '001110', '10011', '11']",1,4,7,9,0,16,3.365367965367965,18,11
"['0010111', '000000', '11']",1,3,9,6,0,15,0.905982905982906,15,8
"['100', '1001', '0110010', '000100', '11100']",1,5,15,10,0,25,6.849100899100899,28,28
"['110', '10010', '11']",1,3,4,6,0,10,1.8714285714285714,6,9
"['01', '1000101', '10111', '00', '1100011']",1,5,11,12,4,23,5.158730158730158,36,24
"['0', '110111', '11110', '10']",1,4,4,10,0,14,2.9025974025974026,19,14
"['11010', '0101110', '1111', '01010', '1110']",1,5,9,16,4,25,6.3782828282828286,21,38
"['0', '0001111', '1010', '100111', '110', '001011']",1,6,12,15,2,27,7.517177267177267,52,38
"['0001', '111100', '101001']",1,3,8,8,2,16,1.8666666666666667,10,9
"['11110', '01', '110001', '1001', '11101', '0000011', '000', '0011011']",1,8,19,20,4,39,14.96107226107226,95,82
"['0', '011100', '1111110', '11101', '10010']",1,5,9,15,2,24,4.6904928404928405,38,21
"['00111', '011001', '100100', '11111']",1,4,9,13,4,22,3.2666666666666666,18,17
"['101', '1', '100001', '00011']",1,4,8,7,0,15,3.012987012987013,19,20
"['1100010', '1', '000010']",1,3,9,5,0,14,1.304945054945055,13,8
"['1101000', '1010100', '1', '01100']",1,4,11,9,2,20,3.1904761904761902,23,14
"['1110010', '1', '011100', '0000', '1101', '0101']",1,6,13,13,3,26,7.0231268731268734,50,32
"['1', '001011', '1011101', '01011', '0100']",1,5,10,13,0,23,5.2723110223110226,34,25
"['0', '11000', '1010', '011100']",1,4,9,7,0,16,3.012987012987013,19,15
"['1011110', '001', '011', '01110']",1,4,7,11,2,18,3.75,17,17
"['0', '1100', '0011100', '1111']",1,4,7,9,2,16,2.422727272727273,22,16
"['01', '100', '0110', '1010', '0001000']",1,5,13,7,2,20,6.047258297258297,28,27
"['1110111', '011', '11', '10001', '10101', '1000']",1,6,10,16,2,26,8.742207792207791,43,56
"['0000', '010000', '101101']",1,3,11,5,2,16,1.7000000000000002,10,10
"['110000', '0', '111', '1010101', '1010001', '1011111']",1,6,13,18,3,31,7.115323565323565,58,49
"['0001', '1', '0000']",1,3,7,2,2,9,1.15,8,8
"['1', '00011', '0011', '111011', '0100']",1,5,9,11,2,20,4.797835497835497,32,30
"['1110000', '1100010', '101', '10011', '110', '0001000']",1,6,18,14,5,32,8.726190476190476,55,41
"['0100011', '1', '00000']",1,3,9,4,0,13,0.75,14,4
"['00110', '0101111', '110', '0100']",1,4,9,10,0,19,3.377994227994228,18,20
"['00', '10110', '01000']",1,3,8,4,2,12,1.7428571428571429,9,10
"['1000001', '00101', '11', '1001', '0001101', '1000', '10']",1,7,18,13,6,31,12.287518037518037,64,70
"['110000', '001', '10', '0111', '0101', '110']",1,6,11,11,4,22,7.98015873015873,39,38
"['101100', '10100', '010000']",1,3,11,6,2,17,2.3030303030303028,6,12
"['010', '0001', '10000', '101001', '1110']",1,5,13,9,2,22,5.416089466089466,26,24
"['11110', '1100', '00', '10', '11100', '0100']",1,6,11,11,6,22,9.383333333333333,32,50
"['0', '0010111', '0110111', '11100', '01011']",1,5,10,15,4,25,5.09047619047619,38,33
"['0010', '010', '0001', '100', '11101', '000001', '110', '0011100']",1,8,21,14,5,35,15.893140193140193,80,83
"['110000', '001', '11011', '101011', '1001', '10110', '111110', '01010']",1,8,17,23,6,40,16.27128427128427,74,79
"['1001', '1110100', '0000', '1100', '0111100']",1,5,14,12,5,26,5.737012987012987,31,32
"['01', '111', '011100', '000001', '0101001']",1,5,13,11,2,24,5.205128205128205,35,26
"['1010', '111', '00001']",1,3,6,6,0,12,1.2658730158730158,9,6
"['0', '0101', '00110', '010']",1,4,8,5,0,13,3.507142857142857,15,21
"['011110', '01', '0111011']",1,3,5,10,0,15,1.7136752136752138,11,11
"['00100', '10101', '1100100', '000', '0001011', '1010000']",1,6,22,12,5,34,9.673809523809524,47,59
"['1', '00101', '1001000', '100000', '1011']",1,5,14,9,0,23,4.708674658674658,35,30
"['0101000', '111', '101', '011101', '01100']",1,5,11,13,2,24,6.1759906759906755,29,23
"['010100', '011', '0110100', '11', '00', '111110']",1,6,12,14,4,26,7.267948717948718,50,47
"['00', '1101101', '10000']",1,3,8,6,0,14,1.5158730158730158,12,6
"['1110111', '111110', '0110', '0000']",1,4,8,13,2,21,2.6426573426573428,22,16
"['101000', '00110', '1001111']",1,3,9,9,0,18,1.491841491841492,10,6
"['001', '111010', '00001', '011011', '11', '000', '0101', '1001011']",1,8,18,18,4,36,14.934398934398935,82,77
"['01101', '00100', '01', '00']",1,4,9,5,4,14,3.3857142857142857,15,20
"['0111000', '01', '011', '01111', '10110', '1101110', '0111110']",1,7,13,23,5,36,13.652380952380952,66,74
"['0', '10', '1110']",1,3,3,4,0,7,1.7333333333333334,6,7
"['101011', '00', '111', '1111010']",1,4,6,12,0,18,2.6042735042735043,22,17
"['1100011', '01', '11011', '0001101']",1,4,9,12,2,21,3.6746031746031744,23,21
"['0', '1100001', '0101', '011']",1,4,8,7,0,15,2.9525974025974024,21,13
"['01001', '110', '0111']",1,3,5,7,0,12,1.7380952380952381,7,8
"['1001110', '110001', '000', '0101100', '0101', '01011']",1,6,17,15,2,32,9.022688422688423,47,42
"['011', '00101', '0001', '1101110', '0100']",1,5,12,11,2,23,5.735281385281385,28,26
"['01', '0000100', '1101000', '10110', '10011', '1000011', '000111']",1,7,22,17,5,39,12.252214452214453,74,60
"['010', '011', '00110', '10', '000', '1100']",1,6,12,8,3,20,9.135714285714286,30,46
"['01', '0011', '1001', '1000', '1000011', '11111', '0001011']",1,7,16,17,5,33,11.333333333333334,67,73
"['010', '00001', '1101000', '0110', '10110', '11111']",1,6,14,15,3,29,7.78037518037518,46,38
"['0000110', '1', '111010']",1,3,7,7,0,14,0.9972527472527473,15,5
"['10100', '010', '100011', '110100']",1,4,11,9,2,20,3.8156565656565657,17,16
"['0001', '100', '00']",1,3,7,2,0,9,2.038095238095238,5,11
"['100', '1', '010101']",1,3,5,5,0,10,1.4523809523809523,10,6
"['001001', '1', '01011']",1,3,6,6,0,12,1.3463203463203464,11,6
"['00', '0101', '0111011']",1,3,6,7,0,13,1.8383838383838382,10,7
"['0011', '10', '01010']",1,3,6,5,0,11,1.5714285714285714,8,7
"['00000', '001000', '1001', '1010101', '110011', '111101']",1,6,18,16,3,34,8.10878010878011,47,41
"['1000001', '111100', '110001', '00', '10010', '1011', '110']",1,7,17,16,2,33,11.402919302919303,66,59
"['0011', '011', '11']",1,3,3,6,0,9,2.3238095238095235,4,12
"['0110010', '11', '0011', '01100', '000', '01001', '111101']",1,7,16,16,2,32,11.417549117549118,63,55
"['1011010', '1111000', '110111', '0111101', '101110']",1,5,11,22,5,33,7.283882783882785,27,27
"['101011', '1010110', '1100100']",1,3,9,11,2,20,2.2527472527472527,8,12
"['001', '10', '0101100', '01010', '000001', '1101']",1,6,16,11,0,27,7.587418137418137,47,39
"['0', '0000101', '0111']",1,3,7,5,0,12,1.1954545454545453,13,6
"['00', '0011101', '011', '0100101']",1,4,10,9,2,19,3.2031746031746033,23,17
"['01', '0010', '111010', '0000', '1110', '0100']",1,6,14,10,4,24,8.15,37,49
"['1111100', '111010', '00011', '0001111', '0111111', '000100']",1,6,16,22,5,38,8.642191142191143,53,67
"['0101101', '010', '1']",1,3,5,6,0,11,1.35,12,6
"['01', '1110011', '00000']",1,3,8,6,0,14,1.0634920634920635,14,4
"['101000', '11000', '100', '10100', '000']",1,5,15,7,4,22,7.368181818181818,19,47
"['0000101', '10111', '0010', '1100000']",1,4,14,9,2,23,3.2647907647907646,23,16
"['101', '01101', '0000001', '111']",1,4,9,9,2,18,3.1,20,18
"['111', '1101110', '00', '10', '1101', '111001']",1,6,8,16,2,24,8.055355755355755,46,45
"['00', '1100', '10', '01110']",1,4,7,6,2,13,3.642857142857143,13,17
"['110', '10', '01100']",1,3,5,5,0,10,2.1214285714285714,6,7
"['01', '010', '000101']",1,3,7,4,0,11,1.9666666666666668,8,8
"['0100110', '0111011', '1001010', '1111', '000', '1011000', '010011']",1,7,20,21,4,41,11.67081807081807,71,59
"['010', '1110010', '011', '1101011', '00', '001011', '0100']",1,7,16,16,4,32,12.673937173937174,66,67
"['110000', '01', '11011', '0011110', '010010', '10', '000']",1,7,17,14,4,31,10.599578199578199,73,56
"['1001010', '0010100', '00110', '10', '1100']",1,5,15,10,2,25,6.59018759018759,30,33
"['1101101', '0010011', '1010', '10100', '00']",1,5,13,12,2,25,6.193362193362193,33,27
"['100', '1111', '011001', '00010', '0101']",1,5,11,11,2,22,5.53997113997114,27,21
"['10100', '0101100', '0101', '110', '101111', '011000']",1,6,15,16,2,31,9.367155067155068,43,40
"['01', '1000101', '1000110', '00010', '001001', '101110', '0110110']",1,7,22,18,5,40,12.844155844155845,70,61
"['11', '10010', '10', '0110011']",1,4,7,9,2,16,3.198412698412698,20,16
"['0011', '1000111', '100000', '1110', '0100']",1,5,14,11,3,25,5.333566433566434,34,28
"['011101', '1010010', '011', '000']",1,4,10,9,2,19,3.105982905982906,21,14
"['00', '1010101', '011']",1,3,6,6,0,12,1.4444444444444444,11,4
"['110000', '0010', '1001010', '11', '10']",1,5,12,9,2,21,5.285392385392385,33,26
"['0', '10101', '0110100']",1,3,7,6,0,13,1.25,13,4
"['1110110', '010', '01000', '0100']",1,4,11,8,0,19,3.9414862914862914,16,27
"['010', '1', '100010']",1,3,6,4,0,10,1.4523809523809523,10,6
"['1011', '0110010', '1000']",1,3,8,7,2,15,1.7727272727272727,9,5
"['1101001', '0', '110111', '0100100', '0111', '01100', '110101']",1,7,16,20,4,36,11.885248085248085,70,61
"['0', '110', '0010100', '011001']",1,4,10,7,0,17,2.5639194139194137,23,14
"['1000100', '01', '001', '001111', '10110', '011101']",1,6,14,15,2,29,8.54097014097014,49,39
"['11', '1000', '000000', '0111101', '1100', '0111110']",1,6,15,15,4,30,6.929598179598179,59,41
"['1000100', '01', '1011001', '11', '1100001', '0011010']",1,6,17,15,6,32,8.055555555555555,61,38
"['0010', '100', '10100', '11111', '0100']",1,5,11,10,4,21,5.578571428571428,25,29
"['010111', '00000', '1110', '1011000']",1,4,12,10,0,22,3.0285159285159287,21,18
"['00', '111', '111101']",1,3,3,8,0,11,0.9166666666666666,11,8
"['11000', '10110', '1000010', '00110', '10']",1,5,14,10,3,24,6.158730158730158,31,32
"['11011', '001', '0011', '1000000', '111000']",1,5,14,11,0,25,5.126062826062826,36,34
"['1', '00101', '0011', '10111', '1101011', '0000001', '1100110']",1,7,17,19,5,36,11.043650793650793,75,64
"['0101111', '010', '110', '10110']",1,4,7,11,2,18,3.833333333333333,17,19
"['0011', '1010', '00', '100011', '111000']",1,5,12,10,4,22,5.9,31,29
"['0', '0011', '101', '111001']",1,4,6,8,0,14,3.0238095238095237,19,12
"['1101111', '111', '0011000']",1,3,6,11,2,17,1.4285714285714286,14,10
"['01101', '001', '0011101', '11', '10101', '0100100', '011010']",1,7,17,18,4,35,12.281418581418581,63,58
"['0111001', '001', '10', '00001']",1,4,10,7,0,17,3.1468253968253967,20,19
"['01', '00', '001010', '10011', '01011']",1,5,11,9,4,20,6.04025974025974,28,23
"['100001', '011011', '10101', '1101100', '0111111', '1101', '110', '0100']",1,8,17,25,6,42,16.512309912309913,86,81
"['10101', '100001', '1']",1,3,6,6,0,12,1.3463203463203464,11,14
"['10101', '00', '101110']",1,3,6,7,0,13,1.7987012987012987,9,6
"['00100', '01', '0110', '01100']",1,4,10,6,2,16,4.1650793650793645,12,26
"['1011', '000110', '10', '1111110']",1,4,7,12,0,19,3.0362859362859362,22,16
"['00111', '1010', '001010', '1100100']",1,4,12,10,0,22,3.968220668220668,17,20
"['0', '100110', '100']",1,3,6,4,0,10,1.4523809523809523,10,8
"['1111100', '01', '100', '01010']",1,4,8,9,0,17,3.0436507936507935,21,15
"['0110000', '001111', '011']",1,3,8,8,0,16,1.7282051282051283,12,10
"['001', '010001', '011', '1100001', '10010', '000', '11100']",1,7,19,13,5,32,12.56013986013986,60,56
"['010100', '001001', '10000', '1011111']",1,4,13,11,2,24,3.1806526806526807,20,14
"['0000101', '0111000', '010', '111']",1,4,11,9,4,20,2.961904761904762,24,13
"['001100', '10001', '010000', '110100']",1,4,15,8,3,23,3.818181818181818,17,16
"['011', '001111', '111']",1,3,3,9,2,12,2.0,7,13
"['010100', '110110', '011100', '000011', '0001', '100101', '0111']",1,7,20,18,7,38,12.466666666666667,63,57
"['11001', '01', '110001', '1010', '100000']",1,5,13,10,2,23,5.9759740259740255,29,30
"['1011110', '01', '101110', '11']",1,4,5,12,2,17,3.3119658119658117,20,19
"['010000', '101011', '1111', '001011', '01110']",1,5,12,15,3,27,5.136363636363637,30,26
"['1000100', '11', '101', '0000011', '000', '0111', '1001100']",1,7,19,14,5,33,10.845021645021644,76,61
"['011111', '11000', '111']",1,3,4,10,0,14,1.5303030303030303,10,13
"['111010', '11', '100100', '1101', '1001111']",1,5,9,16,2,25,5.954001554001554,34,39
"['0101010', '00110', '100', '000010']",1,4,14,7,0,21,3.3999222999223,17,25
"['1110111', '00', '010101', '11111', '01001']",1,5,9,16,2,25,5.096914196914197,34,29
"['0', '0110010', '110']",1,3,6,5,0,11,1.35,12,9
"['010', '100100', '11101', '000']",1,4,10,7,2,17,3.2954545454545454,17,12
"['0', '01101', '11']",1,3,3,5,0,8,0.9047619047619047,9,4
"['011', '101', '100', '000001', '1011111']",1,5,10,12,3,22,4.907692307692307,36,29
"['0', '11000', '1001111']",1,3,6,7,0,13,1.0833333333333333,15,5
"['0111', '00010', '110', '1110']",1,4,7,9,2,16,3.567460317460317,14,20
"['001', '100000', '000', '01010']",1,4,13,4,2,17,3.573232323232323,15,21
"['00', '1', '111011']",1,3,3,6,0,9,0.5357142857142857,12,4
"['011111', '10011', '1110']",1,3,4,11,0,15,1.5898989898989897,9,10
"['110000', '110001', '1', '101111']",1,4,8,11,3,19,2.5238095238095237,25,24
"['0011101', '111', '01110']",1,3,5,10,0,15,2.1833333333333336,8,4
"['111', '00111', '100', '010011', '001011']",1,5,10,13,4,23,6.053030303030303,26,36
"['0111000', '0100110', '0000']",1,3,12,6,2,18,1.6623376623376622,10,17
"['101', '0110', '11']",1,3,3,6,0,9,2.038095238095238,6,4
"['0010001', '11110', '011', '00000']",1,4,12,8,2,20,2.3833333333333333,22,15
"['00010', '0101', '01011', '0110110']",1,4,11,10,2,21,4.216161616161616,13,20
"['011011', '110000', '100', '0111110']",1,4,10,12,2,22,3.241880341880342,22,16
"['101000', '0001', '110110', '00001']",1,4,13,8,2,21,3.4646464646464645,18,21
"['00', '1110', '0100']",1,3,6,4,2,10,1.5,7,10
"['01001', '110001', '0001110', '10']",1,4,11,9,0,20,3.5251970251970253,23,13
"['0100001', '01', '11101', '1110']",1,4,8,10,0,18,2.935064935064935,21,19
"['001', '11', '00000', '100101', '10', '011001', '01001']",1,7,17,12,6,29,10.924025974025973,62,54
"['11011', '1000101', '011100', '1011000']",1,4,12,13,2,25,3.680985680985681,21,12
"['1000', '1', '110100', '1011000']",1,4,10,8,0,18,3.0322177822177823,22,18
"['1101', '10', '000', '11111']",1,4,5,9,0,14,2.3047619047619046,18,12
"['0010111', '011', '0000', '0101', '110']",1,5,11,10,4,21,5.4393939393939394,29,26
"['0111001', '011', '1110011', '001110', '000', '1001001']",1,6,16,17,5,33,9.00952380952381,53,36
"['110110', '011011', '10001', '01111', '1011011', '000111']",1,6,13,22,5,35,10.025874125874125,39,50
"['1000000', '1', '0101100', '011100']",1,4,13,8,2,21,2.598901098901099,26,16
"['01', '00001', '11', '1110100', '10011']",1,5,10,11,4,21,4.822222222222222,35,29
"['0', '0010', '10010', '110', '110101']",1,5,10,9,0,19,5.473304473304474,27,25
"['01', '1000111', '000', '011001', '0110011']",1,5,13,12,2,25,5.486080586080586,35,27
"['1010', '01', '100', '0101001']",1,4,9,7,0,16,3.6955266955266954,17,15
"['11110', '101', '100', '0000', '1010010']",1,5,12,10,2,22,4.824819624819624,30,25
"['1010', '110010', '01101']",1,3,7,8,0,15,2.193939393939394,8,8
"['1', '0100', '1101010']",1,3,6,6,0,12,1.3772727272727274,12,4
"['01', '111110', '0110111']",1,3,4,11,0,15,1.1559829059829059,13,9
"['1000', '0011100', '0100']",1,3,10,5,2,15,2.0227272727272725,9,14
"['0', '001', '111']",1,3,3,4,2,7,0.8333333333333333,7,4
"['1110010', '011', '00111', '1110101', '10']",1,5,9,15,2,24,5.181746031746032,38,31
"['1101001', '1011101', '11100', '011']",1,4,8,14,2,22,3.4047619047619047,19,18
"['0', '1000', '111']",1,3,4,4,0,8,0.6857142857142857,9,4
"['011', '001000', '11000', '1101000', '00']",1,5,15,8,0,23,5.59015429015429,33,46
"['11101', '001', '011']",1,3,4,7,2,11,1.6666666666666665,7,8
"['0110', '011', '00001']",1,3,7,5,0,12,1.8015873015873014,7,8
"['0000101', '0101', '100001']",1,3,11,6,0,17,1.8965034965034966,8,11
"['00111', '100', '0101011', '1001', '010101', '11101', '0100101', '0001000']",1,8,23,21,5,44,17.31055611055611,80,84
"['11001', '0011101', '111100', '011', '01111']",1,5,9,17,2,26,6.464374514374514,30,32
"['00111', '11000', '0']",1,3,6,5,2,11,1.0666666666666667,13,8
"['011111', '001', '00001']",1,3,7,7,0,14,1.558080808080808,10,9
"['11', '101011', '10111', '000100', '0100101', '1110']",1,6,13,17,2,30,7.892213342213342,49,42
"['0', '0110101', '010']",1,3,6,5,0,11,1.35,12,9
"['0111111', '110', '011']",1,3,3,10,2,13,1.6666666666666665,11,11
"['0010001', '101100', '01', '010', '00001', '10111', '111001']",1,7,18,16,4,34,11.701598401598401,66,59
"['00', '1100', '01100']",1,3,7,4,0,11,2.126984126984127,6,15
"['1111101', '00101', '11', '00', '100000', '1010001', '110', '1001011']",1,8,19,20,5,39,13.37042402042402,102,82
"['110110', '0100110', '001101', '0001110', '00100', '1110001', '1010', '01000', '111001']",1,9,28,25,8,53,22.89090909090909,111,104
"['01', '0001001', '00', '011']",1,4,9,5,2,14,3.188888888888889,18,16
"['11001', '11', '0000001', '00', '01010', '101111']",1,6,14,13,4,27,6.534315684315684,56,35
"['00', '100', '0110100']",1,3,8,4,0,12,1.8444444444444446,10,14
"['0101', '1100', '0011111', '11']",1,4,6,11,2,17,3.186868686868687,20,18
"['01101', '1', '100100', '0111', '00010']",1,5,11,10,2,21,4.958441558441558,32,21
"['0100001', '101', '000010']",1,3,11,5,0,16,1.6136752136752137,11,5
"['0010001', '1101101', '0110', '00', '0110001']",1,5,15,12,3,27,6.142857142857142,35,29
"['1000001', '01101', '011', '00', '110']",1,5,11,9,2,20,5.282539682539682,32,22
"['1100011', '11101', '01110']",1,3,6,11,2,17,1.9666666666666668,10,6
"['1001100', '011', '000']",1,3,8,5,2,13,1.5333333333333332,10,8
"['0', '0010', '01101', '11']",1,4,6,6,0,12,2.3047619047619046,17,10
"['0110101', '11010', '0100', '0']",1,4,9,8,0,17,3.028787878787879,20,15
"['1011', '10010', '011', '01000']",1,4,9,8,2,17,3.768253968253968,14,14
"['11', '001011', '01000', '011000']",1,4,11,8,2,19,3.24025974025974,19,18
"['1010', '0100111', '1', '0000011']",1,4,10,9,2,19,2.5233766233766235,26,13
"['000011', '11000', '0110', '011010', '1110']",1,5,13,12,4,25,6.256060606060606,28,34
"['01', '11110', '0001110', '0']",1,4,7,8,0,15,2.6468253968253967,23,17
"['0101111', '110', '1']",1,3,3,8,0,11,1.15,13,7
"['0011101', '1101000', '110100', '10', '1101', '000111', '1100']",1,7,17,19,6,36,12.89015429015429,71,78
"['11110', '0001', '1011101', '000']",1,4,9,10,0,19,2.9263347763347762,20,15
"['0100010', '101011', '1000101', '111']",1,4,11,12,2,23,3.6862026862026864,19,15
"['01', '101', '0001', '0010100', '1110101', '00110']",1,6,15,13,2,28,8.678932178932179,47,39
"['11001', '001', '0011', '10101', '000101', '110100', '00010', '110']",1,8,20,17,7,37,17.615945165945167,71,87
"['00', '100000', '010110', '1']",1,4,10,5,2,15,2.071428571428571,24,12
"['1111100', '1001', '100111', '10', '1010001']",1,5,11,15,2,26,5.776634476634476,37,38
"['10111', '00', '01111', '11']",1,4,4,10,4,14,2.5142857142857142,18,16
"['001001', '100', '0000001']",1,3,12,4,0,16,1.528205128205128,10,11
"['011', '110001', '01001', '01110', '1110']",1,5,10,13,2,23,6.3219336219336215,26,30
"['0', '100110', '011011', '100111']",1,4,8,11,3,19,3.0238095238095237,22,15
"['0', '1010101', '10000', '11101', '011010']",1,5,12,12,2,24,4.657159507159507,35,19
"['000110', '0101000', '1', '100001', '00100', '10100', '00110', '1100101', '011000']",1,9,30,18,8,48,21.06726606726607,113,102
"['1010001', '00', '011', '111']",1,4,7,8,2,15,2.7111111111111112,19,12
"['01', '010', '001000', '00000', '00111', '1111110', '1101100']",1,7,19,16,4,35,9.833033633033633,76,70
"['01', '000111', '01011']",1,3,6,7,0,13,1.7987012987012987,9,8
"['0001', '0010', '110100', '11']",1,4,9,7,2,16,2.9166666666666665,19,15
"['000111', '10000', '110101']",1,3,9,8,2,17,1.5909090909090908,10,9
"['010', '1', '000001', '1110']",1,4,8,6,0,14,2.4015873015873015,21,11
"['110110', '010', '111', '1010111', '11100']",1,5,8,16,2,24,5.890947940947941,29,33
"['001', '1100', '0111']",1,3,5,6,2,11,1.6428571428571428,8,8
"['010', '100000', '1110000', '0111']",1,4,12,8,0,20,2.9305583305583305,23,18
"['101', '0110010', '01111', '0110011']",1,4,9,13,2,22,4.057142857142857,17,20
"['000110', '01', '001', '110']",1,4,8,6,2,14,3.3666666666666667,16,16
"['0101111', '10101', '0010101', '1111', '0001101', '0111', '0000', '0100001']",1,8,22,23,7,45,16.61327561327561,85,88
"['01', '001001', '0100010', '000', '111000']",1,5,16,8,2,24,5.2585470085470085,35,31
"['0', '0001110', '10']",1,3,6,4,0,10,1.3611111111111112,12,9
"['00', '111', '1110']",1,3,3,6,0,9,1.1904761904761905,7,8
"['00111', '1101011', '0111']",1,3,5,11,0,16,2.1010101010101008,7,13
"['11001', '010', '000111']",1,3,7,7,0,14,1.4898989898989898,11,5
"['101', '0100011', '110', '1001010']",1,4,10,10,4,20,3.238095238095238,22,15
"['11001', '110010', '011', '0110', '000']",1,5,11,10,2,21,6.048773448773448,25,27
"['001', '10110', '0111']",1,3,5,7,0,12,1.7380952380952381,7,6
"['011', '0000000', '00010', '000111', '1101010']",1,5,18,10,2,28,5.2122544122544125,36,38
"['1100011', '01', '001', '1101011']",1,4,8,11,2,19,3.546031746031746,20,21
"['111', '00000', '10011', '011001', '1011', '101111']",1,6,12,17,4,29,7.982539682539683,43,51
"['011010', '1111101', '1110']",1,3,5,12,0,17,1.9426573426573426,8,7
"['01', '100', '001011']",1,3,6,5,0,11,1.3444444444444446,10,7
"['0', '01', '1000111']",1,3,5,5,0,10,1.3611111111111112,12,4
"['11110', '11011', '00011', '00110', '1100']",1,5,10,14,4,24,6.044444444444444,26,34
"['00100', '01', '001110', '010110']",1,4,11,8,2,19,3.8593073593073592,17,24
"['010001', '00100', '101', '1101000', '1000']",1,5,16,9,0,25,6.472982572982573,28,27
"['010', '10', '011110']",1,3,5,6,0,11,1.9666666666666668,8,12
"['011111', '100', '110', '0110']",1,4,6,10,2,16,3.3619047619047615,16,17
"['01', '111', '0110', '000', '01110']",1,5,8,9,2,17,5.31984126984127,22,26
"['1101', '1100', '01000', '00000']",1,4,12,6,4,18,3.1277777777777778,14,19
"['011011', '0110000', '01001']",1,3,10,8,0,18,2.0093240093240095,8,11
"['1001', '110100', '000001', '1110', '1011111']",1,5,12,15,4,27,4.693473193473193,37,30
"['0', '0011', '001', '101000']",1,4,9,5,0,14,2.8873015873015873,19,16
"['10111', '101', '0110000', '00', '1010']",1,5,11,10,0,21,5.516089466089466,32,24
"['001', '111100', '10001', '0010100', '1111110', '01000', '00', '1100011', '1111111', '110101']",1,10,24,31,8,55,23.53341658341658,164,143
"['1011', '01', '001101', '0111']",1,4,6,10,2,16,3.9833333333333334,15,15
"['0001', '010', '10000']",1,3,9,3,0,12,1.7380952380952381,7,8
"['00101', '0011100', '11']",1,3,7,7,0,14,1.6825396825396823,11,7
"['00100', '1100', '111100', '0100']",1,4,11,8,2,19,4.251010101010101,12,32
"['0110000', '1011011', '11']",1,3,7,9,2,16,1.4603174603174602,14,6
"['0011', '00', '10010', '110']",1,4,8,6,0,14,3.376190476190476,14,16
"['0111001', '00000', '100', '1010', '0011111', '01010', '01001']",1,7,20,16,5,36,12.447186147186146,65,60
"['0', '11', '00111', '100101', '01011']",1,5,8,11,2,19,4.84978354978355,32,23
"['0000', '100011', '0000111', '1111011']",1,4,12,12,2,24,3.3222777222777222,22,23
"['00', '01010', '1100101', '01100']",1,4,11,8,2,19,3.7206349206349207,20,15
"['011011', '0100001', '000011']",1,3,11,8,2,19,1.8846153846153846,7,9
"['01', '11101', '1101111']",1,3,3,11,0,14,1.6825396825396823,11,12
"['110000', '0001001', '0001', '0001111', '111110', '100011', '011110', '1011000', '111000']",1,9,28,27,8,55,21.415018315018315,122,126
"['010', '1', '000010', '111011']",1,4,8,8,2,16,2.515873015873016,23,10
"['11110', '00011', '000101', '1000010', '11111']",1,5,13,15,3,28,5.3389277389277385,32,33
"['0000011', '011', '01011']",1,3,8,7,0,15,2.0166666666666666,9,13
"['101', '100110', '1000', '11101', '0111']",1,5,9,13,2,22,6.047907647907648,26,30
"['0', '10111', '100']",1,3,4,5,0,9,1.3333333333333333,9,5
"['0001', '100010', '101111', '0110010', '1110']",1,5,13,14,4,27,5.607342657342658,31,26
"['0001010', '010', '1']",1,3,7,4,0,11,1.35,12,6
"['010101', '1', '101110', '000101']",1,4,9,10,3,19,2.6904761904761902,23,15
"['110110', '01', '010010', '10100', '000']",1,5,13,9,2,22,5.703751803751803,29,26
"['101100', '110', '11101', '010111', '11100', '111001']",1,6,11,20,5,31,10.44141414141414,36,56
"['1010', '1000', '1100', '10011']",1,4,9,8,3,17,4.25,11,18
"['1101001', '00', '00101']",1,3,8,6,0,14,1.5158730158730158,11,7
"['00', '1111111', '10', '0111']",1,4,4,11,2,15,1.9343434343434343,24,14
"['1011', '1000', '10000', '1110']",1,4,9,8,3,17,3.2777777777777777,13,20
"['0', '11110', '0101']",1,3,4,6,0,10,1.1777777777777778,10,6
"['10101', '011', '0000001']",1,3,9,6,0,15,1.4833333333333334,11,7
"['1100111', '100110', '11']",1,3,5,10,0,15,1.7136752136752138,11,12
"['101100', '101010', '1011101', '100100', '1000000', '100111', '010110', '000', '011111']",1,9,27,26,8,53,21.590964590964592,111,107
"['100110', '010', '1011010', '11']",1,4,8,10,0,18,3.158119658119658,20,15
"['1101', '1', '001111']",1,3,3,8,0,11,1.2857142857142856,11,9
"['1', '001000', '101000', '1100', '0100']",1,5,14,7,4,21,5.954761904761905,27,31
"['0', '1110', '11']",1,3,2,5,0,7,1.0666666666666667,7,6
"['101', '010010', '1111000', '0110000', '110111', '0000011', '11111', '111000']",1,8,22,25,6,47,15.185070485070485,100,99
"['11001', '11010', '100001', '1100', '01110']",1,5,12,13,3,25,6.680808080808081,24,28
"['011', '101', '10001', '000', '00010', '0111101']",1,6,14,12,5,26,8.483333333333333,44,37
"['0', '010', '111101']",1,3,4,6,0,10,1.2301587301587302,11,4
"['11001', '0010110', '010', '101', '100', '1111', '110111', '000100']",1,8,17,20,5,37,15.397169497169497,85,70
"['1100001', '00', '010110']",1,3,9,6,0,15,1.4059829059829059,13,4
"['01', '00', '111110', '0111', '1010010']",1,5,9,12,2,21,4.342035742035742,36,24
"['11110', '110001', '01111', '1001101', '10']",1,5,9,16,2,25,5.641214341214341,34,30
"['1001', '1111011', '11']",1,3,3,10,0,13,1.6565656565656566,11,16
"['0', '1010000', '011001']",1,3,9,5,0,14,1.151098901098901,14,6
"['1101011', '111', '0110']",1,3,4,10,0,14,1.7168831168831167,10,8
"['0100111', '011', '111001', '00', '1010010', '110101']",1,6,14,17,4,31,8.916849816849817,52,37
"['0110000', '110', '10']",1,3,7,5,0,12,1.8444444444444446,10,7
"['011111', '0101111', '010010']",1,3,7,12,2,19,1.8846153846153846,7,13
"['11000', '0101011', '11']",1,3,6,8,0,14,1.349206349206349,12,11
"['101100', '001', '111', '00', '0001000']",1,5,13,8,2,21,4.3820512820512825,35,31
"['1000010', '0101111', '1110', '00001']",1,4,12,11,2,23,2.7265512265512264,23,15
"['101010', '1011', '010011', '0100010']",1,4,12,11,2,23,4.350582750582751,15,19
"['10101', '100', '0001', '0100']",1,4,10,6,2,16,3.7896825396825395,11,16
"['110', '1111001', '110100']",1,3,6,10,0,16,1.882051282051282,9,10
"['11010', '001', '11', '101110', '01110']",1,5,8,13,2,21,5.541847041847042,27,26
"['0', '010011', '1111']",1,3,4,7,0,11,0.6857142857142857,12,6
"['0011', '00101', '010110', '11']",1,4,8,9,0,17,4.154256854256854,15,14
"['001001', '01100', '00001']",1,3,11,5,2,16,1.6727272727272728,6,11
"['110000', '1100101', '1001101']",1,3,10,10,2,20,2.087912087912088,8,13
"['1001', '0110', '100111', '01010', '1000011']",1,5,13,13,2,26,6.542968142968143,30,26
"['110110', '11101', '100011', '0000']",1,4,10,11,2,21,2.9797979797979797,20,13
"['101', '001', '1']",1,3,3,4,2,7,1.6666666666666665,5,9
"['0101111', '011', '1100001', '00', '10']",1,5,10,11,4,21,4.363492063492063,38,22
"['001111', '00101', '11', '10101', '1100100']",1,5,11,14,2,25,5.954900654900655,32,34
"['0010', '0010000', '10111', '00', '1010011']",1,5,15,10,2,25,5.296536796536796,36,29
"['1', '101101', '1001000', '1111000', '00110', '100111', '0111']",1,7,16,20,4,36,11.457042957042956,73,59
"['010', '0010111', '011', '000011', '1100111', '111001']",1,6,14,18,6,32,8.542490842490842,52,49
"['1001010', '10110', '00110', '00', '10', '1110110', '1110']",1,7,15,17,6,32,12.724242424242425,60,77
"['010100', '000101', '10110']",1,3,10,7,2,17,1.9393939393939394,7,7
"['001', '0011001', '0110', '1010', '1100', '101110']",1,6,14,14,3,28,9.824114774114774,41,42
"['01', '0100110', '00100', '10111', '110001', '1010', '01001', '1011011']",1,8,20,21,5,41,17.37247197247197,84,73
"['0', '000100', '0101', '0000110', '01011']",1,5,15,8,0,23,5.284743034743035,34,32
"['01', '11011', '001', '000', '011010']",1,5,10,9,2,19,5.5264790764790765,26,22
"['0010', '100', '00']",1,3,7,2,0,9,2.038095238095238,5,13
"['0011000', '100', '0010100', '100000', '1011', '111000']",1,6,21,12,4,33,8.98101898101898,47,59
"['011011', '0010', '11111']",1,3,5,10,0,15,1.5494949494949495,9,6
"['101100', '111100', '111', '101', '1010', '011111']",1,6,9,19,5,28,9.228571428571428,41,52
"['100111', '00101', '1']",1,3,5,7,0,12,1.3463203463203464,11,8
"['1110010', '00001', '00111', '11', '100', '1101110', '01010']",1,7,16,18,5,34,11.005555555555555,73,57
"['0', '110', '101101']",1,3,4,6,0,10,1.4523809523809523,10,4
"['10111', '01', '101001']",1,3,5,8,0,13,1.7987012987012987,9,11
"['101', '1000', '010011']",1,3,7,6,0,13,1.838095238095238,8,7
"['0010001', '010000', '011', '101', '0101010', '1110100']",1,6,19,14,5,33,8.90940170940171,52,37
"['011', '11000', '100101', '01010', '01001', '111001']",1,6,15,15,5,30,9.777777777777779,41,40
"['111', '101000', '1100100', '110011', '11101', '011110']",1,6,13,20,3,33,9.294444444444444,47,49
"['101', '00', '0000010']",1,3,9,3,0,12,1.2444444444444445,12,6
"['11110', '1111', '00110', '001110', '10', '1101', '111000', '01100']",1,8,15,22,7,37,17.672366522366524,73,86
"['01', '1101100', '100000', '10', '1100']",1,5,12,9,2,21,4.927700077700077,35,28
"['010100', '0100110', '0001', '1001', '1111', '00']",1,6,15,12,3,27,7.611344211344211,45,35
"['0001', '0111010', '10110', '1']",1,4,8,9,0,17,2.458080808080808,23,11
"['0001', '0101', '1', '01110']",1,4,7,7,2,14,2.7444444444444445,16,12
"['00111', '0001', '10001', '111111', '100000', '10', '010110', '001001', '101001', '0100']",1,10,27,23,9,50,24.673809523809524,134,128
"['010', '011', '1100010', '0011', '110100', '1111', '1010']",1,7,14,17,5,31,12.37947607947608,56,64
"['01', '011100', '0000011', '000', '0011100']",1,5,16,9,2,25,5.38937728937729,38,46
"['01', '101100', '10100', '000']",1,4,10,6,0,16,3.324963924963925,15,20
"['1101001', '0111000', '0010', '000011', '011010', '01000']",1,6,21,14,4,35,9.578155178155178,45,51
"['1101', '010', '1', '000']",1,4,6,5,2,11,2.4238095238095236,14,8
"['101', '11000', '100', '111011', '00', '001010']",1,6,13,12,4,25,8.473448773448773,43,38
"['0', '0110100', '1110', '11']",1,4,6,8,0,14,2.3065656565656565,21,12
"['0010001', '110000', '1', '001001', '01000']",1,5,17,8,2,25,5.4811022311022315,34,30
"['1101', '1000101', '101111', '11']",1,4,6,13,0,19,3.3999222999223,20,32
"['0', '0001110', '111011', '11111']",1,4,6,13,0,19,2.56018981018981,26,14
"['01', '110010', '001', '100', '0011011']",1,5,11,10,2,21,5.75982905982906,33,26
"['01', '111', '101', '1110011', '110']",1,5,5,13,3,18,5.844444444444444,26,37
"['1000000', '100', '100111', '101']",1,4,11,8,2,19,3.4615384615384617,20,24
"['0100000', '0100', '111011']",1,3,10,7,0,17,1.434965034965035,12,8
"['0', '111', '10110', '000101', '1110101', '00010']",1,6,13,14,2,27,6.633422133422133,52,38
"['00', '0010111', '001101']",1,3,8,7,0,15,1.7136752136752138,11,12
"['0100001', '1010001', '0011']",1,3,11,7,2,18,1.948051948051948,10,9
"['0', '11001', '011', '111', '01010', '1101']",1,6,8,13,4,21,8.317460317460316,36,38
"['0011', '001001', '1110100']",1,3,9,8,0,17,1.779020979020979,11,11
"['010', '00000', '0001', '1110001', '10']",1,5,14,7,0,21,5.228860028860029,32,26
"['1111001', '1000011', '1101', '1100', '0011100']",1,5,13,16,5,29,6.425324675324675,34,32
"['000111', '000', '1110']",1,3,7,6,0,13,1.5523809523809522,10,12
"['11', '101101', '0011', '1010011', '11100', '0011100']",1,6,13,18,2,31,9.309290709290709,49,53
"['010', '000111', '1111']",1,3,5,8,0,13,1.33015873015873,10,8
"['0100001', '10010', '1']",1,3,8,5,0,13,1.0833333333333333,13,6
"['101', '001001', '1011']",1,3,6,7,0,13,2.123809523809524,7,11
"['1101', '10001', '0000']",1,3,8,5,2,13,1.5833333333333333,7,5
"['11001', '1010110', '010', '0000001', '0111', '11100', '1110']",1,7,17,18,6,35,11.685642135642135,69,58
"['110', '100011', '10', '011110']",1,4,7,10,2,17,3.411111111111111,20,16
"['11010', '111', '10001', '100101', '10', '10011', '0100001', '1001001']",1,8,20,20,5,40,18.005222555222556,75,112
"['010100', '000110', '1111101', '001101', '00100', '011101', '000']",1,7,21,18,4,39,13.055672105672105,60,81
"['101000', '10100', '00', '010011', '01100']",1,5,15,9,4,24,6.700432900432901,28,37
"['010011', '00', '110', '0111']",1,4,7,8,0,15,2.8492063492063493,17,16
"['101010', '00', '100100']",1,3,9,5,2,14,1.8333333333333335,10,9
"['011', '00011', '10101', '0011110', '000001', '010110', '1011', '01001', '01000']",1,9,25,21,6,46,22.76720501720502,96,101
"['11', '0001111', '000001', '0111', '1100']",1,5,11,12,2,23,5.034071484071484,36,34
"['1011', '1000', '111', '111011']",1,4,5,12,2,17,3.223809523809524,15,31
"['001101', '10101', '1111010', '111111', '00010']",1,5,11,18,4,29,5.651282051282052,30,29
"['110110', '0101010', '0101011', '010111']",1,4,11,15,4,26,4.6007326007326,11,27
"['1000110', '0101', '0000100', '01011']",1,4,14,9,2,23,3.8607503607503606,18,15
"['00101', '100', '0110', '10', '1011']",1,5,9,9,2,18,6.43095238095238,21,23
"['01010', '011000', '000', '101101']",1,4,12,8,2,20,3.9823232323232323,17,17
"['01', '010000', '110001', '0001111', '0001101']",1,5,16,12,4,28,5.7203907203907205,39,31
"['1000000', '10001', '1111']",1,3,9,7,0,16,1.2929292929292928,12,11
"['110000', '1010', '1000', '011100']",1,4,12,8,4,20,4.016666666666667,15,17
"['01', '0111010', '11', '0000000', '1000']",1,5,14,8,4,22,3.797258297258297,42,23
"['0', '000110', '0111000', '110100', '000100']",1,5,17,9,3,26,4.9532967032967035,37,47
"['011011', '1010', '100', '000']",1,4,9,7,2,16,3.584126984126984,15,15
"['001100', '1010', '1011']",1,3,7,7,2,14,1.95,7,6
"['101100', '110', '100', '011010', '11100', '1001111']",1,6,13,17,4,30,10.033799533799534,42,44
"['0', '0011', '1101', '111']",1,4,4,8,2,12,2.7285714285714286,15,15
"['101', '0010', '0011111', '111011']",1,4,7,13,0,20,3.045088245088245,21,15
"['1010', '110010', '11']",1,3,5,7,0,12,1.9666666666666668,8,10
"['11001', '100001', '1010', '00', '01000', '011000']",1,6,18,10,4,28,9.7004329004329,40,37
"['1101001', '110', '10']",1,3,5,7,0,12,1.8444444444444446,10,9
"['01', '100', '1111', '000010', '110']",1,5,9,9,2,18,4.246031746031746,30,22
"['01', '011001', '1', '00011']",1,4,7,7,0,14,2.9025974025974026,20,14
"['110010', '0010', '1111', '10', '001001']",1,5,11,11,4,22,5.516666666666667,30,28
"['01', '11110', '1100100']",1,3,6,8,0,14,1.2301587301587302,12,7
"['001', '1', '011']",1,3,3,4,2,7,1.6666666666666665,5,6
"['11010', '01101', '0100111', '101', '0101']",1,5,10,14,2,24,7.006637806637807,24,31
"['101', '0010', '11']",1,3,4,5,0,9,1.7047619047619047,6,4
"['1000101', '1001111', '1', '010110']",1,4,9,12,2,21,2.730769230769231,27,14
"['01', '001101', '011011', '1101', '11101', '1100111', '00010']",1,7,14,21,4,35,13.25979575979576,60,67
"['01101', '00001', '11', '1100010', '1110011', '110001', '000', '110']",1,8,19,19,6,38,15.757170607170607,87,91
"['1100010', '10001', '1', '00101']",1,4,10,8,2,18,3.0166666666666666,22,15
"['1110111', '001', '0101111', '1', '000111']",1,5,8,16,2,24,4.851282051282052,39,34
"['0011110', '100001', '011', '01100']",1,4,11,10,0,21,3.468104118104118,22,13
"['1000010', '0100011', '1']",1,3,9,6,2,15,1.2142857142857144,15,6
"['0001010', '10010', '01010']",1,3,11,6,2,17,2.1,7,16
"['01', '11010', '100', '1011', '101001']",1,5,9,11,0,20,6.32012987012987,25,28
"['0101111', '110100', '10', '000000', '0101']",1,5,14,11,2,25,4.690947940947941,38,26
"['11001', '010', '0101110', '001101', '0011', '0001', '1010100']",1,7,19,17,4,36,12.496187146187147,62,56
"['010', '011', '100', '00110', '00010']",1,5,12,7,5,19,6.216666666666667,22,34
"['1000011', '01', '10', '11']",1,4,6,7,3,13,2.833333333333333,19,17
"['0', '101010', '001', '011']",1,4,7,6,2,13,3.0634920634920633,16,12
"['1011010', '001', '0000']",1,3,9,5,0,14,1.516883116883117,10,8
"['0010', '1000', '1010000', '1101', '110']",1,5,13,9,3,22,5.968181818181818,27,26
"['0010', '111110', '1']",1,3,4,7,0,11,1.0857142857142859,12,5
"['010', '0001110', '111', '0001', '1011111']",1,5,10,14,4,24,5.052813852813853,35,24
"['01', '111010', '10100', '10010', '001110', '1011']",1,6,13,15,4,28,9.354978354978355,41,38
"['0001', '0110', '0000010', '01110']",1,4,13,7,2,20,3.606060606060606,18,26
"['1100011', '11011', '010001', '0000']",1,4,12,10,0,22,3.515695415695416,17,16
"['01', '011', '1001010', '11000', '01100']",1,5,12,10,2,22,5.9182539682539685,31,26
"['00110', '0101111', '11100']",1,3,7,10,2,17,1.7666666666666666,10,9
"['0', '0010', '01101', '0011', '010101']",1,5,11,9,2,20,5.429653679653679,25,27
"['010', '001111', '110100', '0000']",1,4,11,8,2,19,2.8158730158730156,21,20
"['001101', '10101', '0010010', '110', '01100']",1,5,14,12,2,26,6.291958041958042,26,25
"['0100010', '00010', '1111000']",1,3,12,7,2,19,1.9047619047619047,11,14
"['0', '110010', '111', '1011110', '110']",1,5,7,13,2,20,4.697252747252747,34,28
"['011', '111010', '000000']",1,3,9,6,2,15,1.0,13,7
"['1111100', '010', '110', '1']",1,4,5,9,2,14,2.9166666666666665,20,12
"['001', '010101', '1101111', '10']",1,4,7,11,0,18,2.804273504273504,22,13
"['0', '111100', '111', '110100', '1100']",1,5,8,12,2,20,5.142857142857142,29,37
"['111101', '10110', '1']",1,3,3,9,0,12,1.3463203463203464,11,8
"['010', '00111', '100', '000', '1010010']",1,5,13,8,3,21,5.8,30,30
"['01', '0100000', '10000', '110100', '111110']",1,5,15,11,2,26,4.645659895659896,36,27
"['101', '111000', '11']",1,3,4,7,0,11,1.7444444444444445,9,10
"['100', '100011', '000001', '1101110']",1,4,12,10,2,22,3.3008547008547007,21,16
"['0001001', '0010', '00111', '0011', '0001', '1000']",1,6,18,10,4,28,10.31060606060606,36,56
"['11001', '10', '0111', '0000']",1,4,8,7,2,15,2.599206349206349,18,11
"['100', '000010', '0111100']",1,3,10,6,0,16,1.3521367521367522,12,12
"['0010', '01', '001111', '001101', '1001000', '1111', '11101', '111000']",1,8,18,22,5,40,16.3014208014208,88,96
"['01000', '0001', '001', '011110']",1,4,11,7,0,18,3.4137085137085137,17,21
"['001', '100001', '1011', '101110', '1011111']",1,5,10,16,2,26,5.940581640581641,32,42
"['00110', '010', '1']",1,3,5,4,0,9,1.5833333333333333,8,5
"['0', '1000110', '111110', '110', '1111111']",1,5,7,17,2,24,4.372710622710622,41,35
"['011101', '1011', '0001', '1101110']",1,4,8,13,2,21,3.36013986013986,19,14
"['0011', '000100', '0000100']",1,3,13,4,0,17,2.0685314685314684,8,21
"['1011010', '111100', '00', '10', '0111']",1,5,9,12,2,21,5.152059052059052,33,26
"['00101', '00001', '0001', '000101', '111011', '1000', '111111']",1,7,18,18,7,36,11.596464646464646,60,78
"['000110', '1010110', '111', '101000', '00', '100000', '1010011', '1101']",1,8,22,19,5,41,15.025707625707625,92,85
"['0001011', '0001', '10011']",1,3,9,7,0,16,2.0606060606060606,8,11
"['00111', '0001', '100', '001110', '000100', '1101010']",1,6,18,13,2,31,8.91097791097791,44,54
"['11001', '101100', '001', '010', '0101011', '1000', '10011']",1,7,17,16,4,33,12.713797313797313,58,55
"['0', '000111', '1100']",1,3,6,5,0,11,1.0857142857142859,13,8
"['0110010', '01', '100', '1010011']",1,4,10,9,2,19,3.2031746031746033,23,12
"['10111', '010', '111']",1,3,3,8,2,11,1.5833333333333333,7,8
"['10001', '10', '1101', '001011', '0100']",1,5,11,10,2,21,5.983549783549783,27,22
"['01', '010000', '11010', '0011', '11111']",1,5,10,12,2,22,4.63997113997114,33,25
"['0010', '100', '01111']",1,3,6,6,0,12,1.2658730158730158,9,7
"['1000', '110100', '000000']",1,3,12,4,2,16,1.5333333333333332,8,13
"['1100', '10', '01000']",1,3,7,4,0,11,1.9047619047619047,7,7
"['000100', '001', '10', '1001010']",1,4,12,6,0,18,3.3803418803418803,20,16
"['0111010', '011', '101000', '10001', '100100', '000', '1010001', '1001111']",1,8,24,20,7,44,17.183910533910534,91,84
"['101010', '0001', '00', '1100100']",1,4,12,7,0,19,3.3257964257964256,21,17
"['0', '1000', '1100']",1,3,6,3,2,9,1.55,7,7
"['01', '01010', '011000', '11']",1,4,8,7,2,15,3.37012987012987,17,13
"['111111', '011', '1001111']",1,3,3,13,0,16,1.6598290598290597,10,17
"['0', '00010', '1110111']",1,3,6,7,0,13,0.9166666666666666,15,4
"['1101001', '00111', '10101', '1001', '010010', '1111010']",1,6,15,19,4,34,9.946065046065046,43,42
"['11110', '01', '10100', '1110100', '010011']",1,5,11,14,2,25,5.407881007881008,33,29
"['0100010', '10111', '1']",1,3,6,7,0,13,1.0833333333333333,14,4
"['001', '100', '1111', '000', '0001010', '110', '01100']",1,7,16,12,4,28,10.317604617604617,58,62
"['0101101', '1011010', '0101111', '110']",1,4,9,15,3,24,4.0285714285714285,19,18
"['010100', '011', '01100']",1,3,8,6,0,14,2.3257575757575757,6,14
"['0001111', '0010010', '00101', '011001']",1,4,14,11,2,25,4.001498501498501,17,18
"['101011', '100', '1111', '00', '1011011']",1,5,8,14,0,22,5.0394827394827395,30,33
"['001', '011', '11', '1111000', '0111']",1,5,7,12,2,19,5.7518037518037515,28,33
"['1000110', '10', '0000111', '0011011', '001001', '1011011']",1,6,18,18,4,36,8.956654456654457,54,45
"['101', '000111', '11']",1,3,4,7,0,11,1.7444444444444445,9,10
"['0010', '11010', '1001', '1110001', '1110']",1,5,11,13,3,24,6.416666666666666,26,29
"['0001001', '10101', '010111']",1,3,9,9,0,18,2.0093240093240095,8,7
"['001', '10110', '10011']",1,3,6,7,2,13,2.05,7,7
"['110', '01110', '111101', '0001111']",1,4,7,14,0,21,3.825990675990676,19,17
"['0010001', '011', '00001', '101', '10', '1001001', '00010']",1,7,20,12,6,32,12.136507936507936,64,58
"['0110111', '101', '111011', '0001100', '1110001', '0111', '1010001']",1,7,17,24,4,41,12.731401931401932,73,73
"['011011', '010', '010101', '0']",1,4,8,8,2,16,3.238095238095238,20,18
"['01', '0110111', '0110', '11']",1,4,5,10,2,15,3.4494949494949494,18,17
"['010000', '101011', '1000', '10', '0101']",1,5,13,9,4,22,6.133333333333333,29,25
"['010', '110', '0110100', '1100100', '11101', '0111', '1100']",1,7,15,18,6,33,13.639177489177488,58,67
"['100', '0110', '00', '100111', '01110', '0111101', '01000']",1,7,16,16,2,32,13.146336996336997,61,65
"['00000', '1111', '011101', '100011', '1100101', '011001', '0101', '0101001']",1,8,22,23,7,45,16.7997557997558,80,86
"['0', '010', '101110']",1,3,5,5,0,10,1.4523809523809523,10,9
"['0110101', '010', '010110', '000000', '1100']",1,5,16,10,2,26,5.586735486735487,33,33
"['0', '0110111', '100001', '101101', '0000101', '111001']",1,6,16,17,5,33,7.47985347985348,55,41
"['1000101', '00111', '100', '1001101', '10010', '0000', '001001', '0110110']",1,8,25,19,5,44,18.714790764790763,80,80
"['00100', '0011', '01110']",1,3,8,6,2,14,1.9333333333333331,6,11
"['111', '001110', '000', '011110', '0110010']",1,5,12,13,4,25,5.862393162393162,30,33
"['00100', '1101', '100000', '111101']",1,4,11,10,2,21,2.886868686868687,19,16
"['110111', '1111001', '01000', '111011']",1,4,8,16,2,24,3.4452214452214456,19,23
"['11010', '010001', '010', '0011', '0000000', '11101', '11100']",1,7,20,15,3,35,10.834482184482184,69,58
"['0', '1101', '1000']",1,3,5,4,2,9,1.3,8,4
"['0', '11010', '1111101', '1010001', '110']",1,5,9,14,2,23,4.845238095238095,37,24
"['101', '10111', '00100', '01100']",1,4,9,9,3,18,3.55,15,13
"['0', '01001', '110', '000001']",1,4,10,5,0,15,2.5685425685425685,21,14
"['01', '0011', '11000', '10010', '01100']",1,5,12,9,3,21,6.073015873015873,28,25
"['101', '0110010', '111100', '1101']",1,4,8,12,0,20,3.844244644244644,18,13
"['1011', '1010010', '11101']",1,3,6,10,0,16,1.893939393939394,8,11
"['0010', '010', '1100', '01011']",1,4,9,7,2,16,3.7896825396825395,13,20
"['01', '101110', '0010101', '00011']",1,4,10,10,0,20,3.343378843378843,20,14
"['0', '001', '1000111', '11111']",1,4,6,10,0,16,2.1,24,14
"['00', '110', '1', '010111']",1,4,5,7,0,12,2.13015873015873,19,11
"['0101', '101101', '10111', '10001', '100', '010011', '00010']",1,7,17,17,5,34,13.299206349206349,48,59
"['1100111', '0110000', '10101']",1,3,9,10,2,19,1.7380952380952381,11,4
"['010', '101101', '1001', '1101011', '1001111']",1,5,10,17,2,27,6.5915417915417915,30,32
"['0', '1011001', '10111', '0000010', '011110']",1,5,13,13,2,26,4.661338661338661,43,20
"['00111', '11111', '0101', '110', '0100101']",1,5,9,15,2,24,5.576479076479076,29,32
"['0000111', '100000', '01', '1001000']",1,4,15,7,2,22,2.798229548229548,25,21
"['101', '10100', '10', '11']",1,4,5,7,2,12,3.992857142857143,11,18
"['0', '1110110', '0101111', '110']",1,4,6,12,2,18,2.571428571428571,27,18
"['1110101', '010000', '111']",1,3,7,9,0,16,1.2837606837606836,13,8
"['11000', '001', '1', '01010']",1,4,8,6,2,14,2.7666666666666666,17,11
"['0001110', '00101', '0111011', '100', '011110', '000000', '1111011']",1,7,20,21,5,41,11.373937173937174,77,65
"['1', '00101', '01010', '0100011', '0110110']",1,5,13,12,4,25,5.228571428571429,36,23
"['0', '0100101', '100001', '1110']",1,4,10,8,0,18,2.4685814185814188,24,11
"['010', '0101110', '0001', '0110', '10011', '01001', '011000']",1,7,19,15,4,34,13.846481296481297,55,69
"['01', '0101000', '1']",1,3,6,4,0,10,1.3611111111111112,12,5
"['1', '101', '101000', '0010011', '100010', '1100']",1,6,15,12,2,27,8.06908091908092,50,40
"['011101', '101', '100', '11100']",1,4,7,10,2,17,3.755050505050505,15,17
"['01', '00111', '1100001', '00', '1101']",1,5,10,10,2,20,5.203463203463203,32,27
"['0001', '10101', '10', '01001', '111000', '11100', '0110011']",1,7,17,17,3,34,12.879165279165278,61,58
"['100', '1101011', '1110100']",1,3,7,10,2,17,1.9142857142857141,11,10
"['0101011', '0001101', '0000', '1011', '001001']",1,5,16,12,4,28,6.305344655344656,29,29
"['1001110', '0010110', '00111', '0100110']",1,4,13,13,3,26,4.904761904761905,13,23
"['011', '1110000', '1100100', '0010100', '1000', '001110', '001011', '01110']",1,8,25,20,5,45,16.816022866022866,92,103
"['1010', '110010', '001001', '00']",1,4,11,7,2,18,3.7333333333333334,18,16
"['0', '001', '001101', '1100110', '111101']",1,5,10,13,2,23,5.0838217338217335,37,26
"['011', '10111', '1101101', '11101', '10', '000111', '1111111', '0100']",1,8,12,27,4,39,14.961050061050061,92,96
"['1110001', '010', '01111', '0100']",1,4,9,10,0,19,3.4137085137085137,20,16
"['0101', '01000', '00011']",1,3,9,5,2,14,1.9333333333333331,7,10
"['1001', '110', '011', '000']",1,4,7,6,3,13,3.0476190476190474,12,11
"['0', '01', '111110']",1,3,3,6,0,9,1.2023809523809523,11,6
"['010', '1', '0110111', '000', '11100']",1,5,9,10,2,19,4.25,35,23
"['101011', '1', '00001']",1,3,6,6,0,12,0.9826839826839826,12,8
"['0', '10', '01110']",1,3,4,4,0,8,1.5714285714285714,8,9
"['0', '000111', '110111', '101001']",1,4,8,11,3,19,2.8571428571428568,24,14
"['00', '10010', '100111', '01110', '1101010']",1,5,12,13,2,25,5.723898323898323,31,26
"['1010', '10100', '111000', '1110011']",1,4,10,12,0,22,4.1975135975135975,15,21
"['0011', '1010', '01111']",1,3,5,8,2,13,1.6111111111111112,7,7
"['001', '111', '0100010', '0011', '100']",1,5,11,9,3,20,5.4787878787878785,29,24
"['11', '1100010', '0001', '1000010', '000', '110']",1,6,16,10,4,26,8.01010101010101,46,44
"['01', '110', '11100']",1,3,4,6,0,10,1.4357142857142857,8,7
"['11010', '111100', '101000', '100000', '10', '11100', '01110']",1,7,18,17,6,35,12.883982683982683,55,62
"['011', '1110101', '00110', '10100', '0101', '11100']",1,6,13,16,3,29,9.512193362193361,39,41
"['0', '001', '011101', '1010011', '111101']",1,5,9,14,2,23,4.5667277167277165,37,25
"['0101', '010001', '110001', '1110']",1,4,10,10,4,20,3.533333333333333,16,21
"['11001', '11100', '11']",1,3,4,8,2,12,1.9428571428571428,8,13
"['11110', '0011000', '0001', '0000000', '1000010', '100000', '10']",1,7,27,11,3,38,10.541891441891442,76,79
"['100000', '010110', '0100']",1,3,11,5,2,16,1.9,9,11
"['011111', '101', '00', '10']",1,4,5,8,2,13,2.6444444444444444,18,11
"['11', '101011', '0001', '101', '0001100', '01000']",1,6,15,12,0,27,7.956365856365856,48,40
"['010001', '011', '00001', '11', '1010010', '100', '011010']",1,7,18,14,4,32,11.954168054168054,64,53
"['1011010', '00', '1', '0010100']",1,4,10,7,2,17,2.1031746031746033,27,14
"['1001110', '0011101', '010', '1001', '100', '1111000', '1010111', '10011']",1,8,19,24,6,43,17.955772005772005,93,85
"['11011', '011100', '00001', '1000110', '100', '110100', '1010', '0011111', '010110']",1,9,24,25,7,49,20.85996225996226,111,100
"['0', '1010101', '0010100', '111110']",1,4,10,11,2,21,2.1153846153846154,26,10
"['00101', '10', '1']",1,3,4,4,0,8,1.5714285714285714,8,6
"['0', '0101', '1010011', '00111']",1,4,8,9,0,17,3.043939393939394,21,11
"['1111100', '1', '10111', '1100001', '1010011']",1,5,10,17,3,27,4.773809523809524,43,41
"['1011', '1010', '111010']",1,3,5,9,2,14,2.15,6,12
"['100110', '01111', '11']",1,3,4,9,0,13,1.6168831168831168,10,8
"['0111011', '101010', '10000', '1110100', '001001']",1,5,16,15,4,31,6.102397602397603,31,25
"['1011010', '11010', '011000']",1,3,9,9,0,18,2.3298368298368297,6,10
"['1000010', '11101', '000011', '00001']",1,4,14,9,2,23,3.7752913752913755,16,18
"['11001', '100100', '1111', '00', '001010']",1,5,12,11,2,23,5.144155844155844,34,23
"['0001110', '00101', '001000', '1111001', '110']",1,5,15,13,2,28,5.532889332889333,36,30
"['011011', '010', '1001101']",1,3,7,9,0,16,2.0358974358974358,10,5
"['0', '000110', '11010', '111010', '10011']",1,5,11,12,4,23,4.6835497835497835,33,27
"['00100', '00', '0101000']",1,3,11,3,0,14,1.8492063492063493,10,20
"['0111000', '0100010', '011', '000']",1,4,13,7,4,20,3.4476190476190474,21,26
"['0011', '1000110', '10101', '101000', '1101110', '100000', '110', '0101001', '011000']",1,9,28,23,6,51,21.812798312798314,111,102
"['00', '11101', '10110', '11010']",1,4,7,10,3,17,3.8285714285714287,16,12
"['1000011', '00100', '111']",1,3,8,7,0,15,1.15,12,6
"['01', '001', '0011100', '001000']",1,4,12,6,0,18,3.7803418803418802,19,26
"['1100011', '1110101', '011']",1,3,6,11,2,17,1.7142857142857144,11,14
"['01', '000101', '01011']",1,3,7,6,0,13,1.7987012987012987,9,8
"['001', '1001', '11111']",1,3,4,8,0,12,1.5515873015873014,8,10
"['0', '1000101', '1011111']",1,3,6,9,2,15,0.9285714285714286,15,5
"['1', '1000110', '0001111', '000000', '110']",1,5,14,10,2,24,4.013431013431013,44,25
"['0110101', '1010', '010011', '11']",1,4,8,11,0,19,3.3999222999223,19,15
"['10000', '10', '101001', '001100']",1,4,12,7,2,19,3.329004329004329,19,15
"['01', '001', '101011', '0011010', '1101100', '0000110']",1,6,17,15,3,32,8.677777777777777,55,38
"['0001101', '10001', '100', '110001']",1,4,12,9,0,21,4.0078088578088575,18,23
"['0', '001100', '0010011', '1101010']",1,4,12,9,2,21,2.587912087912088,28,18
"['00110', '1000', '0110']",1,3,8,5,2,13,2.0555555555555554,7,12
"['0', '00100', '110', '11001']",1,4,8,6,2,14,3.0166666666666666,18,12
"['01', '1110011', '111']",1,3,3,9,0,12,1.4444444444444444,11,14
"['01', '1010100', '1111011', '11']",1,4,6,12,4,18,2.849206349206349,25,18
"['100', '010001', '111011']",1,3,7,8,2,15,1.6111111111111112,10,6
"['1110101', '100', '11100', '0101100']",1,4,10,12,2,22,4.188095238095238,18,20
"['0', '101', '100101']",1,3,5,5,0,10,1.4523809523809523,10,7
"['101011', '1000110', '0110']",1,3,8,9,0,17,2.0965034965034963,8,8
"['101', '00', '010000', '010111']",1,4,10,7,2,17,3.011111111111111,20,14
"['1111100', '0010', '010', '1010100', '011010', '1011111']",1,6,15,19,3,34,8.842690642690643,50,47
"['0011', '00', '100010']",1,3,8,4,0,12,1.7666666666666666,9,8
"['101101', '110001', '000', '01010', '111001']",1,5,13,13,3,26,6.275252525252525,29,21
"['110011', '0101', '10', '111']",1,4,5,10,0,15,3.4047619047619047,16,18
"['0011', '01', '11101']",1,3,4,7,0,11,1.6825396825396823,8,8
"['1111100', '00011', '10101', '1010', '110']",1,5,10,14,2,24,5.483549783549783,31,28
"['0', '101000', '110', '0100100']",1,4,11,6,0,17,2.6493894993894993,23,15
"['1111100', '01', '010000', '11', '000010', '1100']",1,6,15,12,4,27,6.82983682983683,56,44
"['11010', '0111011', '0011', '01111', '00', '110111']",1,6,10,19,2,29,8.798595848595848,45,51
"['1', '000', '01100', '010111']",1,4,8,7,0,15,2.1089466089466087,21,13
"['0', '010', '1101011', '010111', '1000011']",1,5,11,13,2,24,5.051282051282051,38,24
"['0010110', '000011', '1101101', '1101', '0101', '1110']",1,6,14,18,5,32,9.009390609390609,46,46
"['0001', '1110010', '101110']",1,3,8,9,0,17,1.5608391608391607,11,7
"['000110', '001', '1001', '1111', '010011', '1100']",1,6,13,14,5,27,9.030952380952382,40,38
"['0010', '111', '00', '0000010', '1101', '0101']",1,6,14,10,3,24,7.661760461760462,45,38
"['0111001', '1', '10000', '01001', '111001']",1,5,12,12,2,24,5.331518481518481,34,34
"['100', '1010', '00', '1110100', '01001', '01011']",1,6,14,12,2,26,9.788383838383838,41,40
"['01', '010', '111000', '00']",1,4,8,5,2,13,3.2944444444444443,16,17
"['111100', '1001', '1101100', '00', '10', '110', '1111111', '1110']",1,8,12,23,6,35,15.249572649572649,91,88
"['1001', '10', '0010101']",1,3,7,6,0,13,1.6565656565656566,10,8
"['1001010', '11', '101000', '100', '10110', '001110']",1,6,15,14,2,29,8.716144966144967,44,43
"['0001', '10', '111']",1,3,4,5,0,9,1.019047619047619,8,6
"['101', '1101', '001', '000000']",1,4,10,6,2,16,2.9619047619047616,18,16
"['0111000', '10001', '10010', '000', '101111', '110101']",1,6,16,16,4,32,9.342890442890443,48,36
"['00', '10', '01011', '111']",1,4,5,7,2,12,2.5428571428571427,14,12
"['010100', '0110101', '0', '100100', '11111']",1,5,12,13,2,25,4.2794705294705295,39,22
"['0010101', '0011', '110', '1110']",1,4,8,10,2,18,3.4194805194805196,18,19
"['11001', '00011', '101010', '00100', '0010100', '0000', '11111']",1,7,21,16,4,37,12.141958041958041,62,67
"['00011', '0010010', '0110', '0100']",1,4,13,7,2,20,3.9823232323232323,16,23
"['000110', '0101', '0100']",1,3,9,5,2,14,1.75,7,11
"['101100', '11110', '0001', '10101', '10', '101001']",1,6,13,15,4,28,8.303463203463204,42,48
"['1011', '11010', '10']",1,3,4,7,0,11,1.9047619047619047,7,9
"['1010001', '0101', '000101']",1,3,10,7,0,17,1.9608391608391609,8,11
"['11110', '001', '110010', '10', '0101100', '1100111']",1,6,13,17,2,30,7.945149295149295,51,41
"['00', '0111111', '100011', '11']",1,4,6,11,2,17,2.128205128205128,25,15
"['0', '1000110', '01111']",1,3,6,7,0,13,1.0833333333333333,14,6
"['0110000', '0001', '1', '1110']",1,4,9,7,2,16,2.3909090909090907,24,12
"['1000', '0111101', '111111']",1,3,5,12,0,17,1.3328671328671329,12,6
"['01', '0011', '000', '0011011', '1001111', '111001']",1,6,13,16,2,29,8.46003996003996,52,44
"['001', '111', '101101', '0011', '0001111', '1010', '0111', '00010']",1,8,16,20,5,36,16.836091686091684,72,82
"['0001110', '1010101', '1101011', '00110', '10']",1,5,13,15,3,28,5.571428571428571,37,22
"['01101', '00', '010', '111010']",1,4,8,8,0,16,4.0153679653679655,15,17
"['0001010', '1000101', '11']",1,3,9,7,2,16,1.746031746031746,12,4
"['0011001', '1000000', '00', '010010']",1,4,16,6,2,22,3.2020757020757022,24,19
"['10110', '10', '011100', '0100']",1,4,9,8,0,17,3.932034632034632,16,19
"['1000001', '1', '1010001', '101111', '0100']",1,5,13,12,2,25,4.64965034965035,39,31
"['0000', '001', '10', '00011']",1,4,10,4,0,14,3.007142857142857,15,19
"['110001', '1111010', '10100', '000001', '000000', '0101100']",1,6,23,14,5,37,8.13036963036963,47,48
"['010001', '1110', '00000']",1,3,10,5,0,15,1.1676767676767676,10,6
"['0', '0110111', '001000', '0110', '1010', '10011', '1111111']",1,7,14,20,4,34,9.375124875124875,81,50
"['1000111', '010111', '01100']",1,3,8,10,0,18,1.8146853146853146,10,8
"['0010', '10100', '000', '01110', '101111']",1,5,12,11,2,23,5.485425685425685,27,28
"['0101', '0110110', '0110011']",1,3,8,10,2,18,2.311688311688312,8,11
"['110000', '1', '1001', '0111', '0101']",1,5,9,10,3,19,4.885714285714286,32,25
"['1000100', '11', '00111', '0001100', '00', '0111']",1,6,15,12,4,27,7.742424242424242,52,49
"['0001110', '0100010', '0001', '10001', '011101', '1100']",1,6,19,14,4,33,9.745365745365746,44,40
"['0', '10100', '111000', '1100111']",1,4,9,10,0,19,2.8783716283716285,25,14
"['010', '0110', '110']",1,3,5,5,2,10,2.380952380952381,3,13
"['1001', '1', '0100101', '110']",1,4,7,8,0,15,2.8487012987012985,20,15
"['101', '0110100', '0010111', '0001001']",1,4,13,11,3,24,3.8,21,14
"['0', '1111101', '011', '1010011', '000111']",1,5,9,15,2,24,4.611721611721611,42,26
"['11', '1100001', '10', '000', '11100']",1,5,10,9,2,19,4.698412698412699,32,25
"['00', '111101', '1110', '11']",1,4,4,10,2,14,2.55,18,16
"['00', '0001', '1110', '001000']",1,4,11,5,2,16,2.75,20,23
"['011101', '00100', '0010010', '000']",1,4,14,7,0,21,3.7886169386169386,18,29
"['101010', '11011', '010', '100011']",1,4,9,11,2,20,3.7323232323232323,16,16
"['11001', '0', '1111', '0100100', '1100110']",1,5,11,13,2,24,4.805194805194805,37,24
"['0101', '111', '0100']",1,3,5,6,2,11,1.6071428571428572,6,6
"['0', '1101', '01001', '10100']",1,4,8,7,2,15,3.2,17,11
"['110010', '011100', '100', '10110', '110011', '00', '0110010']",1,7,18,17,3,35,13.96074481074481,60,63
"['000110', '10100', '110', '1']",1,4,8,7,0,15,2.6493506493506493,19,13
"['0111111', '010000', '000010']",1,3,11,8,2,19,1.282051282051282,12,12
"['0', '101110', '0111011']",1,3,5,9,0,14,1.304945054945055,14,6
"['01', '001', '11000', '1110011', '110001', '010110', '000001', '1010001', '110101']",1,9,25,23,6,48,21.864024864024863,109,120
"['010', '001', '11', '1110011', '1110101']",1,5,8,14,4,22,5.212698412698413,35,31
"['000110', '1', '101101', '100', '1110']",1,5,9,11,2,20,5.220634920634921,32,22
"['0100000', '11011', '00', '10', '0101', '1110']",1,6,13,11,4,24,7.655122655122655,48,35
"['1000', '00', '100101']",1,3,8,4,0,12,1.9666666666666668,8,8
"['110011', '11000', '01001', '0100']",1,4,11,9,2,20,4.21010101010101,12,18
"['101', '0101', '1', '000']",1,4,6,5,2,11,2.6619047619047618,13,12
"['0111000', '010100', '011', '11', '000100']",1,5,14,10,2,24,5.923504273504274,32,34
"['0010', '001', '1010110', '000', '0011100']",1,5,15,9,4,24,6.567965367965368,28,43
"['1101', '10', '01100']",1,3,5,6,0,11,1.9047619047619047,7,4
"['01001', '1001', '011']",1,3,6,6,0,12,2.2103174603174605,5,10
"['1011010', '11010', '0101100']",1,3,9,10,2,19,2.357142857142857,7,10
"['00001', '10', '1111']",1,3,5,6,0,11,0.8412698412698412,11,6
"['1101000', '100', '0001', '000', '1100110']",1,5,15,9,4,24,6.3004329004329005,31,36
"['010100', '0011', '001', '001111']",1,4,10,9,2,19,3.8682539682539683,16,23
"['001011', '01', '0001', '011']",1,4,8,7,0,15,3.8047619047619046,14,17
"['0', '110110', '0110100', '11101', '0100100']",1,5,13,13,2,26,4.969030969030969,37,25
"['101011', '000101', '0001100', '0000', '1001001']",1,5,19,11,4,30,6.958574758574759,28,32
"['1011', '1', '01010', '011000']",1,4,8,8,0,16,3.012987012987013,20,9
"['1010', '1', '000']",1,3,5,3,0,8,0.9714285714285714,8,4
"['00110', '1011011', '001010', '11']",1,4,9,11,0,20,3.707015207015207,19,13
"['01101', '11', '0001111', '000010', '111101']",1,5,11,15,2,26,5.269369519369519,37,30
"['101', '001', '10', '111']",1,4,4,7,3,11,3.2666666666666666,9,16
"['011011', '10111', '0001001', '000']",1,4,11,10,0,21,3.137101787101787,22,15
"['0', '11011', '0101110', '100001', '000011']",1,5,13,12,2,25,4.668747918747918,39,19
"['111111', '1101', '11010']",1,3,3,12,0,15,2.0343434343434343,7,15
"['101', '1000010', '1010', '1011', '110', '0100']",1,6,13,12,5,25,9.484848484848484,36,42
"['00111', '01', '010']",1,3,5,5,0,10,1.8714285714285714,7,7
"['1010110', '01101', '0110']",1,3,7,9,0,16,2.282828282828283,8,12
"['1111101', '100', '10', '0111', '1010001', '01001']",1,6,12,16,2,28,8.148845598845599,50,42
"['01', '010', '1000']",1,3,6,3,0,9,1.7047619047619047,6,7
"['000110', '001', '000011', '11', '11000', '0010100', '110111', '01010']",1,8,22,18,5,40,16.099111999111997,87,85
"['110000', '011011', '1010', '10011', '011010', '1100', '01110']",1,7,17,19,7,36,13.812626262626262,52,64
"['0', '1010', '110100', '1111']",1,4,6,9,2,15,2.585714285714286,19,12
"['101000', '100', '010010', '001010', '0000']",1,5,18,7,3,25,6.738095238095238,23,40
"['0', '00111', '1100']",1,3,5,5,0,10,1.1777777777777778,11,8
"['0', '1001', '110', '1110']",1,4,5,7,2,12,3.2285714285714286,14,13
"['0', '01', '011', '01110']",1,4,5,6,0,11,3.6214285714285714,13,18
"['0011', '0110', '1101100', '1010', '000000', '1011111']",1,6,16,16,5,32,7.869330669330669,54,39
"['10101', '010', '001010']",1,3,8,6,0,14,2.143939393939394,7,6
"['1', '0000010', '0011000']",1,3,11,4,2,15,0.9285714285714286,15,7
"['0110101', '0010110', '11000', '10101', '110111', '101111']",1,6,14,22,6,36,9.804295704295704,42,44
"['1010', '100', '100011', '110']",1,4,8,8,2,16,3.806349206349206,13,18
"['111111', '01', '1001010']",1,3,5,10,0,15,1.1559829059829059,14,6
"['1010000', '0111111', '001001', '0101']",1,4,12,12,2,24,3.2535464535464538,23,15
"['11001', '1101001', '10', '1000010']",1,4,11,10,2,21,3.5317460317460316,21,21
"['0011', '1100100', '001100']",1,3,10,7,0,17,1.9608391608391609,9,15
"['0', '0001', '0011101', '01110']",1,4,9,8,0,17,2.8065656565656565,21,16
"['00110', '00', '101110']",1,3,7,6,0,13,1.7987012987012987,9,12
"['101', '1000', '01000']",1,3,8,4,0,12,1.9603174603174602,6,8
"['101', '100', '1011', '00010', '110101']",1,5,10,11,2,21,6.218470418470418,24,28
"['1000010', '110', '10', '0011100']",1,4,11,8,2,19,3.1174603174603175,23,16
"['0011', '0001', '1001', '101']",1,4,8,7,3,15,4.25,9,20
"['001', '1', '000101', '111101']",1,4,7,9,2,16,2.6825396825396823,22,19
"['01', '01011', '100010']",1,3,7,6,0,13,1.6168831168831168,10,7
"['1011010', '0100110', '1001', '010010', '000', '1011']",1,6,17,14,4,31,9.881801531801532,40,39
"['0', '010001', '1111101', '111']",1,4,6,11,0,17,1.8878510378510378,26,15
"['01', '01101', '100', '1010', '1111111']",1,5,7,14,0,21,4.947763347763348,35,23
"['01001', '1000', '000', '0001111']",1,4,12,7,0,19,3.8359307359307357,18,22
"['1000001', '1000100', '1', '001000', '1100100', '1010001']",1,6,23,12,4,35,8.780219780219781,53,46
"['100', '1100', '1001111', '101001']",1,4,9,11,0,20,4.084648684648685,18,21
"['000110', '00110', '0110', '01011']",1,4,11,9,2,20,4.791919191919192,10,30
"['1110000', '1000', '0100111', '111010']",1,4,12,12,2,24,3.5320679320679322,21,21
"['11000', '1', '101110']",1,3,5,7,0,12,1.1645021645021645,12,6
"['11011', '0110011', '00001', '100', '100011', '0111', '000', '1101010']",1,8,20,20,6,40,16.375380175380176,82,85
"['1010111', '01', '1001101']",1,3,6,10,2,16,1.3174603174603174,12,10
"['0001100', '11110', '001', '1001']",1,4,10,9,0,19,3.197041847041847,20,14
"['0011000', '100', '011101', '00110', '1110']",1,5,13,12,0,25,6.303984903984904,28,32
"['001', '010000', '010011', '10000', '110011', '10', '1101']",1,7,18,14,3,32,12.031746031746032,59,60
"['100', '00110', '10010', '10011', '11111']",1,5,10,13,4,23,5.8500000000000005,24,29
"['101', '1000', '010']",1,3,6,4,2,10,1.8095238095238093,6,5
"['0', '10111', '10110']",1,3,4,7,2,11,1.4666666666666668,9,7
"['1', '011100', '101', '10101', '000']",1,5,9,9,2,18,4.136724386724387,31,22
"['110110', '1100010', '101', '101000', '000000']",1,5,17,11,3,28,5.809401709401709,32,27
"['0011', '0010', '1000']",1,3,8,4,3,12,2.0,6,10
"['110000', '011010', '1000101', '10011']",1,4,13,11,2,24,3.9755244755244754,18,13
"['101', '1000110', '10']",1,3,6,6,0,12,1.8444444444444446,10,10
"['101', '1000000', '0001100', '10', '11100']",1,5,15,9,2,24,5.155555555555556,37,29
"['011100', '0001', '110', '1']",1,4,7,7,0,14,2.538095238095238,20,11
"['0', '1110100', '10', '101101']",1,4,7,9,0,16,2.916056166056166,24,11
"['1000000', '1011', '1010010', '10']",1,4,12,8,2,20,3.217893217893218,22,20
"['1000001', '0010', '101101', '10101', '1100101', '100000', '0001000']",1,7,26,16,5,42,13.370662670662671,58,68
"['1000100', '1010110', '1011011', '1100']",1,4,12,13,3,25,3.6363636363636362,18,19
"['0', '1000101', '011100', '0001', '10110']",1,5,13,10,0,23,4.52957597957598,38,21
"['11', '00100', '1011101', '1000111', '10100']",1,5,12,14,4,26,5.426984126984127,36,30
"['0111000', '01111', '0']",1,3,6,7,0,13,1.25,13,11
"['0110', '00', '001010', '011010', '110', '01011']",1,6,14,12,2,26,9.479076479076479,36,59
"['000101', '10011', '100010']",1,3,10,7,2,17,2.287878787878788,6,8
"['0011', '101', '100100', '110011', '0100100', '0101', '011000']",1,7,20,16,5,36,13.936768786768786,59,59
"['01', '01101', '00', '11101', '010111', '001010']",1,6,12,14,6,26,8.512121212121212,44,40
"['110110', '0011001', '00111', '1100000', '10']",1,5,14,13,2,27,5.188922188922189,40,30
"['000111', '00000', '100010']",1,3,12,5,2,17,1.9393939393939394,8,10
"['0', '1011100', '11']",1,3,4,6,0,10,0.6944444444444444,13,4
"['11011', '001', '0110100', '1100001', '100000', '0011011', '111101', '001100']",1,8,24,23,6,47,16.330380730380732,93,89
"['1010110', '11101', '100', '10']",1,4,7,10,0,17,3.4158730158730157,19,16
"['010', '11', '1010100', '1001000', '1010', '0100001', '1011']",1,7,19,15,5,34,13.006277056277057,66,57
"['001', '10010', '10011']",1,3,7,6,2,13,2.3,5,9
"['1001', '010010', '111011', '1000010', '10', '0111', '1010001']",1,7,18,18,6,36,12.182195582195583,69,60
"['0', '11010', '111100', '011100', '1011101', '011001', '00010', '0111101']",1,8,19,24,7,43,16.414518814518814,89,78
"['011', '01000', '00011']",1,3,8,5,2,13,1.85,8,11
"['110110', '1000', '001111', '10']",1,4,8,10,2,18,2.9166666666666665,23,16
"['111', '00001', '101', '01010', '0100']",1,5,11,9,4,20,5.257142857142857,24,20
"['0110101', '00', '110', '1']",1,4,6,7,0,13,2.1944444444444446,21,10
"['1110010', '1', '111001']",1,3,5,9,0,14,1.458791208791209,12,13
"['00', '01101', '011110']",1,3,6,7,0,13,1.7987012987012987,9,10
"['1001001', '1001', '1', '10']",1,4,7,7,0,14,3.155050505050505,20,26
"['0010', '0011001', '1011110', '000', '01100']",1,5,15,11,2,26,6.145743145743146,30,37
"['00', '100', '01010']",1,3,7,3,0,10,2.1214285714285714,6,10
"['0010', '011011', '0010101', '1010', '0111111', '1100011', '0100']",1,7,18,21,6,39,12.53051948051948,68,57
"['1011', '01101', '01011', '000']",1,4,8,9,2,17,3.441269841269841,15,14
"['0010110', '0111010', '0']",1,3,8,7,2,15,1.0714285714285714,15,13
"['10000', '10', '11']",1,3,5,4,2,9,1.3571428571428572,8,7
"['0', '00110', '000001']",1,3,9,3,0,12,1.1645021645021645,12,9
"['0011', '00', '00010', '00101']",1,4,11,5,2,16,4.1650793650793645,13,24
"['11011', '010', '0010000', '000011', '00100', '1011', '110', '01100', '1101010']",1,9,25,20,7,45,21.674037074037074,110,116
"['001', '111100', '100', '1001000', '110111', '011001']",1,6,15,16,5,31,8.571794871794872,51,44
"['0011', '101', '1110']",1,3,4,7,2,11,1.6428571428571428,7,7
"['01', '111010', '1010', '1010000', '01001', '1011011']",1,6,15,16,2,31,9.383028083028083,47,43
"['01', '0011000', '0100']",1,3,9,4,0,13,1.8383838383838382,10,11
"['1111010', '01101', '011100']",1,3,7,11,0,18,2.163170163170163,7,8
"['01', '0010', '111', '00000', '0011100']",1,5,13,8,0,21,4.743145743145743,33,29
"['0', '111', '1101011', '1011100', '0100']",1,5,9,13,2,22,4.22987012987013,40,22
"['0110100', '10111', '0001000', '1001', '01000']",1,5,17,11,4,28,6.038528138528139,32,27
"['00110', '100100', '111']",1,3,7,7,0,14,1.6717171717171717,9,5
"['0001011', '011', '011110', '0']",1,4,8,9,0,17,2.763919413919414,24,18
"['0010', '010', '01111', '10000', '11100']",1,5,12,10,3,22,5.3126984126984125,28,30
"['10010', '1', '10']",1,3,4,4,0,8,1.5714285714285714,8,8
"['0', '1100111', '11101', '10']",1,4,5,10,0,15,2.9325396825396823,22,13
"['1101001', '00000', '101', '1100001', '1011', '1111011']",1,6,15,18,3,33,8.257070707070707,50,58
"['1101', '10', '0110110']",1,3,5,8,0,13,1.8383838383838382,10,5
"['10001', '01101', '011']",1,3,6,7,2,13,1.85,8,9
"['1011101', '10', '00000']",1,3,8,6,0,14,1.0634920634920635,14,5
"['110110', '11010', '1000', '111']",1,4,7,11,0,18,3.878138528138528,14,20
"['011011', '000000', '10', '101111']",1,4,10,10,3,20,2.4166666666666665,24,12
"['11110', '1110110', '111', '0100']",1,4,6,13,0,19,3.2922799422799423,18,22
"['101', '01111', '1101011', '1010', '1011100', '110']",1,6,10,19,4,29,9.132323232323232,45,45
"['010', '011', '10001', '1001000', '001110', '0100']",1,6,17,11,2,28,9.05001665001665,44,40
"['1111110', '0101010', '00', '0111111', '10', '110']",1,6,10,18,5,28,6.814285714285714,58,47
"['1011110', '1001', '100111', '0000010', '0101001']",1,5,16,15,3,31,6.035764235764236,34,27
"['00100', '001', '111011']",1,3,7,7,0,14,1.558080808080808,10,7
"['101011', '1011101', '011000', '00011']",1,4,11,13,2,24,3.5034965034965033,19,16
"['00011', '0000', '10', '11111', '1011']",1,5,9,11,4,20,3.999206349206349,30,29
"['100001', '011', '011100', '11111', '101', '011001']",1,6,12,17,5,29,8.676767676767676,47,43
"['0', '101100', '10', '1110']",1,4,6,7,0,13,3.319047619047619,17,14
"['0', '010', '1111101', '1001101', '001100']",1,5,11,13,2,24,4.897435897435898,39,19
"['110110', '010', '1']",1,3,4,6,0,10,1.2301587301587302,10,5
"['10111', '01', '1001010']",1,3,6,8,0,14,1.5158730158730158,11,7
"['0', '000011', '1111', '0111', '0110001']",1,5,10,12,2,22,4.727672327672328,36,27
"['0001', '111110', '1']",1,3,4,7,0,11,0.8857142857142857,13,6
"['010', '11', '101', '100010', '10100']",1,5,10,9,2,19,6.316883116883117,24,24
"['00100', '01', '101', '000011']",1,4,10,6,0,16,3.3613275613275615,18,13
"['010100', '01', '010', '0101110', '11000', '111011', '1111111']",1,7,14,22,4,36,10.659662559662559,78,60
"['0101000', '00001', '0100010', '1101100', '0111']",1,5,18,12,3,30,5.747474747474747,33,31
"['11010', '010', '1101110', '011101', '10', '000001']",1,6,14,15,2,29,8.361482961482961,51,42
"['0100110', '11000', '00100', '101000', '000001', '110']",1,6,21,11,4,32,9.061888111888111,43,49
"['1001110', '010', '1', '0110111', '01111', '000111']",1,6,11,18,2,29,7.876845376845377,52,40
"['0111000', '00010', '011', '1111111']",1,4,9,13,2,22,2.5952380952380953,26,16
"['001', '11100', '1111']",1,3,4,8,0,12,1.4523809523809523,9,11
"['1011001', '011', '00110', '11101', '0000111', '110101']",1,6,14,19,4,33,9.124925074925075,49,42
"['01', '001', '0111001', '1110000', '0001', '1110011', '1010011']",1,7,18,19,4,37,13.053391053391053,70,69
"['1011010', '0010', '001', '1101', '00110', '110111', '0000', '1011', '010011']",1,9,21,22,6,43,21.83937728937729,96,98
"['111', '10', '0000', '0001010', '110', '0110110']",1,6,14,12,4,26,7.361616161616162,51,43
"['0', '100', '0110', '111010']",1,4,7,7,0,14,3.0238095238095237,18,15
"['110010', '001', '11', '1000', '1011000']",1,5,12,10,0,22,5.612376512376512,32,28
"['001', '10010', '00101', '0110110']",1,4,11,9,2,20,4.033333333333333,16,16
"['010', '100', '001001']",1,3,8,4,2,12,2.0,8,7
"['1011', '11010', '100', '11']",1,4,5,9,0,14,3.626190476190476,13,20
"['10111', '01', '11']",1,3,2,7,2,9,1.6428571428571428,7,10
"['100', '0010100', '000']",1,3,10,3,2,13,1.8666666666666667,9,17
"['111010', '0110', '1101100', '10010', '000', '011111', '001011']",1,7,17,20,3,37,12.07970362970363,65,62
"['0100000', '1', '00100', '100111', '0000', '0100001']",1,6,21,9,2,30,7.675335775335776,53,43
"['00101', '010010', '110011', '11101', '110111', '01000']",1,6,15,18,6,33,9.236363636363636,38,42
"['11', '1100001', '10001', '010010', '100010', '00110', '100000', '000']",1,8,26,14,5,40,17.721450771450773,81,77
"['11', '01100', '1011000']",1,3,7,7,0,14,1.8492063492063493,10,5
"['1110110', '000101', '10']",1,3,7,8,0,15,1.4059829059829059,14,7
"['11001', '11000', '010']",1,3,7,6,2,13,1.8,7,7
"['1101', '0111001', '1', '0110100']",1,4,8,11,2,19,3.2116883116883117,23,13
"['0011', '00', '01101', '111']",1,4,6,8,0,14,3.2261904761904763,14,14
"['0010', '10', '101101']",1,3,6,6,0,12,1.7666666666666666,9,6
"['01', '110', '011100']",1,3,5,6,0,11,1.5666666666666667,9,7
"['0011', '01001', '0110', '0010011']",1,4,11,9,2,20,4.1893939393939394,15,18
"['01', '10111', '101', '010010', '111110', '100011', '1001011']",1,7,14,21,3,35,12.011832611832611,65,65
"['0010110', '100101', '1111011']",1,3,8,12,2,20,1.9560439560439562,10,4
"['0001', '100100', '011', '0010']",1,4,11,6,2,17,3.7373015873015873,15,15
"['11100', '101', '100', '001111']",1,4,7,10,2,17,3.3510101010101008,19,19
"['0101110', '1101111', '000011', '00111', '10', '011111', '001001', '110', '1110']",1,9,18,28,5,46,20.47237207237207,118,113
"['10100', '010110', '000010']",1,3,11,6,2,17,1.7727272727272727,7,10
"['0010', '010', '01000', '1011', '1111111']",1,5,10,13,2,23,4.701803751803752,34,23
"['11001', '1000001', '00101', '11', '011011', '110001', '100111', '1101']",1,8,18,23,5,41,18.031435231435232,79,127
"['0010010', '01011', '00001']",1,3,11,6,2,17,1.5666666666666667,7,7
"['01', '00111', '101', '1001', '0111']",1,5,7,11,2,18,6.688888888888888,21,30
"['0010', '001', '0110111', '00011', '00111', '1001000', '1010001', '1100', '0110011']",1,9,26,23,8,49,22.55988455988456,112,109
"['1111101', '1', '100100', '000', '01110']",1,5,10,12,0,22,3.7275557775557777,40,18
"['1', '1001010', '100011', '000001', '1010001']",1,5,16,11,4,27,5.0787545787545785,36,33
"['0', '110110', '001', '1010101', '11100', '01100']",1,6,13,14,2,27,7.570601620601621,51,35
"['0110101', '01', '010', '001111', '000111', '1100']",1,6,13,15,2,28,8.383316683316684,50,41
"['01', '100', '10011', '000']",1,4,8,5,2,13,3.288095238095238,13,14
"['0010', '11011', '010', '1010', '11101']",1,5,9,12,4,21,6.4865079365079366,21,24
"['1100111', '010011', '010']",1,3,7,9,0,16,1.835897435897436,10,8
"['011', '11000', '1111', '1010', '000', '11100']",1,6,11,13,6,24,8.042063492063491,36,46
"['0', '110110', '011010']",1,3,6,7,2,13,1.4047619047619047,12,9
"['101', '0011110', '0110', '1010101', '00', '1101']",1,6,12,15,4,27,8.584343434343435,49,36
"['010010', '10', '110010']",1,3,8,6,2,14,1.8333333333333335,9,12
"['1101111', '11', '101', '100100', '1100', '0100']",1,6,11,15,2,26,8.674597624597624,44,47
"['110000', '10', '01000']",1,3,9,4,0,13,1.7987012987012987,9,8
"['01', '0110', '0110000', '001010', '100111', '000010', '0110010']",1,7,23,15,5,38,12.892884892884894,65,80
"['010100', '0010', '011', '11', '10010']",1,5,11,9,0,20,5.977200577200577,25,25
"['0', '01111', '0110', '101010']",1,4,7,9,0,16,3.031168831168831,19,17
"['001110', '110', '10']",1,3,5,6,0,11,1.9666666666666668,8,10
"['00', '001', '10011']",1,3,6,4,0,10,2.1214285714285714,6,6
"['0101000', '01111', '1', '1001']",1,4,8,9,0,17,2.473232323232323,24,11
"['011', '1001', '1010', '000001', '0000011']",1,5,15,9,2,24,5.769469419469419,31,30
"['1010', '00010', '01011', '1010011']",1,4,11,10,2,21,4.16060606060606,14,17
"['110', '11000', '100', '0010100', '001010', '1011', '1100', '01110']",1,8,20,17,6,37,17.953452103452104,70,92
"['00', '10', '1100110']",1,3,6,5,2,11,1.3888888888888888,11,7
"['001', '1', '1110']",1,3,3,5,0,8,1.1857142857142857,8,6
"['1101', '01111', '001011', '11']",1,4,5,12,0,17,3.55021645021645,16,23
"['00', '10', '01100']",1,3,6,3,2,9,1.6428571428571428,7,10
"['01', '11010', '0001', '101110']",1,4,8,9,0,17,3.127994227994228,18,14
"['101100', '001', '00000', '101011', '101', '101000', '10']",1,7,18,13,5,31,11.175108225108225,62,69
"['01', '100', '0110110']",1,3,6,6,0,12,1.4444444444444444,11,7
"['100', '011', '0111110', '0110011']",1,4,8,12,4,20,3.2476190476190476,23,20
"['1001000', '0111100', '11111']",1,3,8,11,2,19,1.4285714285714284,12,5
"['111', '0000001', '0001101', '11101', '10', '001001']",1,6,16,14,2,30,7.48019203019203,53,49
"['00', '0000010', '1100', '011']",1,4,11,5,0,16,2.846176046176046,22,20
"['101000', '110', '001101']",1,3,8,7,2,15,1.6111111111111112,9,7
"['1001110', '0', '1110', '101101']",1,4,7,11,0,18,3.2322177822177824,22,14
"['0110010', '0001010', '010011', '1010011']",1,4,15,12,3,27,4.461538461538462,16,18
"['101', '00', '000111', '010111']",1,4,8,9,2,17,3.3444444444444446,18,15
"['00100', '1', '0110']",1,3,6,4,0,10,1.4,9,4
"['01', '10100', '00', '0101100', '011110']",1,5,12,10,2,22,5.344100344100344,32,35
"['01', '100', '0111']",1,3,4,5,0,9,1.3523809523809525,7,7
"['0111111', '100011', '110111', '000', '1011000']",1,5,12,17,4,29,5.0918192918192915,39,29
"['0000', '01', '00001']",1,3,9,2,0,11,1.7936507936507935,7,13
"['0100110', '11', '0001', '10', '110']",1,5,9,9,2,18,5.268542568542569,29,24
"['0001', '0110', '0110110']",1,3,8,7,2,15,1.5909090909090908,10,14
"['0010001', '001', '10']",1,3,8,4,0,12,1.4444444444444444,11,10
"['00111', '001100', '1']",1,3,6,6,0,12,1.3463203463203464,11,8
"['101', '1000', '00', '1111']",1,4,6,7,2,13,2.4595238095238097,15,13
"['11110', '0010', '000', '1100011', '0100']",1,5,13,10,2,23,5.508369408369408,30,28
"['11110', '11101', '0001', '1001']",1,4,7,11,4,18,3.3277777777777775,15,20
"['00111', '01', '0100100']",1,3,8,6,0,14,1.5158730158730158,12,8
"['101', '10101', '10010', '1101100']",1,4,9,11,2,20,4.066666666666666,16,20
"['1010111', '100', '110100', '11']",1,4,7,11,0,18,3.2264957264957266,21,22
"['0101111', '1', '00100', '01000', '0111100']",1,5,13,12,4,25,5.014285714285714,39,30
"['0', '1000101', '011000']",1,3,9,5,0,14,1.151098901098901,15,4
"['01010', '011', '10000', '1001011']",1,4,11,9,2,20,3.533333333333333,19,15
"['0', '110010', '1000101', '011', '101101']",1,5,11,12,2,23,4.92997557997558,36,22
"['0111111', '010', '110']",1,3,4,9,2,13,1.4666666666666668,11,9
"['1110101', '001', '000011']",1,3,8,8,0,16,1.3743589743589744,11,9
"['100110', '110010', '00', '10']",1,4,9,7,4,16,3.3333333333333335,19,16
"['01', '1010', '000001', '000011']",1,4,12,6,2,18,3.3,19,16
"['0010', '10001', '1110001', '0111', '1001001']",1,5,14,13,4,27,6.355699855699855,31,32
"['10', '0111011', '11111']",1,3,3,11,0,14,1.5634920634920635,11,8
"['10110', '00101', '1']",1,3,5,6,2,11,1.2666666666666666,11,6
"['010110', '0010101', '011001']",1,3,10,9,2,19,1.8974358974358974,8,8
"['00', '1', '1011100', '001000']",1,4,10,6,0,16,2.0955433455433456,25,18
"['10001', '11101', '0101001']",1,3,8,9,2,17,1.7666666666666666,7,12
"['111', '1101000', '0110', '0101', '1100']",1,5,10,12,3,22,6.132467532467532,27,26
"['010', '0001110', '000000', '1101100']",1,4,15,8,2,23,3.138949938949939,22,26
"['010000', '0010111', '111', '0111', '1011']",1,5,10,14,2,24,5.716877566877567,31,35
"['011', '100', '0001111', '0110000', '11100']",1,5,13,12,4,25,5.378571428571428,39,34
"['01', '11000', '1000', '11011']",1,4,8,8,2,16,3.123809523809524,16,18
"['11001', '01', '10111', '0000', '001100', '01001']",1,6,15,12,3,27,8.276911976911977,43,37
"['0', '011', '10010', '1010011', '1001111']",1,5,10,13,2,23,5.080952380952381,38,27
"['110111', '1011', '10', '01100']",1,4,6,11,0,17,3.75021645021645,18,13
"['000110', '10101', '001001', '1011']",1,4,11,10,2,21,4.028282828282828,16,14
"['01', '11', '0101101', '111011', '11100']",1,5,7,15,2,22,5.2553557553557555,34,34
"['110110', '01001', '10']",1,3,6,7,0,13,1.6168831168831168,10,7
"['001101', '1110010', '111010']",1,3,8,11,2,19,2.2051282051282053,8,11
"['0001', '01000', '11111']",1,3,7,7,2,14,1.0888888888888888,10,6
"['1101011', '1101100', '110011', '10', '0000', '010011']",1,6,15,17,4,32,8.22019092019092,51,52
"['0111010', '101', '0010100', '111000', '0100']",1,5,15,12,2,27,6.187501387501388,31,28
"['101010', '011', '1', '000001']",1,4,9,7,2,16,2.515873015873016,23,12
"['00', '0000010', '01100', '11']",1,4,11,5,2,16,2.142857142857143,23,17
"['10001', '111111', '0101', '1100']",1,4,7,12,2,19,2.996969696969697,18,17
"['010001', '10010', '11100', '1100100']",1,4,13,10,2,23,3.8062937062937063,16,15
"['0111000', '0110101', '010', '1', '011011', '000111']",1,6,14,16,4,30,8.032722832722833,57,42
"['101101', '001101', '0111011', '00011']",1,4,10,14,2,24,3.9906759906759905,14,19
"['11011', '0101111', '001101', '011', '10']",1,5,8,15,0,23,5.941863691863691,31,27
"['1001', '1100', '10000', '1110']",1,4,9,8,3,17,3.7777777777777777,13,16
"['110110', '010', '00010', '0001111', '10100', '100111', '1101', '011010', '001011']",1,9,23,25,6,48,22.25954045954046,102,100
"['1100011', '00', '001', '011001']",1,4,10,8,0,18,3.7803418803418802,20,14
"['0', '0101111', '0111010', '010', '001101', '0101', '1011111']",1,7,14,21,3,35,12.145238095238096,72,59
"['0101010', '110', '01010', '0110011']",1,4,11,11,2,22,3.7142857142857144,18,27
"['010000', '1000101', '1001', '1000', '10011', '1011', '0010010']",1,7,22,15,5,37,14.542646242646242,52,65
"['0001010', '0101', '100010']",1,3,11,6,0,17,2.0965034965034963,8,8
"['1011', '0110010', '10001', '11']",1,4,8,10,0,18,3.5613275613275612,19,15
"['0', '1100001', '0101', '1000']",1,4,10,6,2,16,2.8227272727272728,22,11
"['1011010', '010', '10']",1,3,6,6,0,12,1.8444444444444446,10,11
"['01', '1000', '10', '0111']",1,4,6,6,4,12,2.75,16,14
"['0001011', '1100001', '01']",1,3,9,7,2,16,1.4603174603174602,14,8
"['0', '010', '011101', '01110']",1,4,7,8,0,15,3.4448051948051948,17,25
"['01', '000', '11111']",1,3,4,6,0,10,0.6857142857142857,11,4
"['110010', '1', '00011', '1101011', '110100', '0111']",1,6,12,17,2,29,7.914435564435564,52,53
"['11', '00110', '010111', '10', '00010']",1,5,10,10,4,20,5.572727272727272,28,24
"['101', '1000', '11101', '110']",1,4,6,9,2,15,3.753968253968254,13,18
"['0010001', '101', '011', '00001']",1,4,11,7,2,18,3.5,18,18
"['0100010', '100', '1', '01010']",1,4,10,6,0,16,3.2666666666666666,20,14
"['001', '001111', '101011', '1101100', '100101']",1,5,12,16,3,28,6.190598290598291,31,31
"['010', '000111', '110']",1,3,6,6,2,12,1.5555555555555554,9,8
"['101', '1', '1111000']",1,3,4,7,0,11,1.15,13,8
"['00100', '0001', '0100101']",1,3,11,5,0,16,2.0606060606060606,8,9
"['010', '101', '00110', '000', '110']",1,5,10,7,4,17,6.083333333333333,19,26
"['111010', '000111', '0111110']",1,3,7,12,2,19,1.7307692307692308,10,9
"['011101', '0100000', '1', '0100']",1,4,11,7,0,18,2.7245254745254748,24,16
"['101100', '11100', '0111110', '11']",1,4,7,13,0,20,3.707015207015207,19,15
"['11000', '1000', '01001']",1,3,9,5,2,14,2.1555555555555554,5,9
"['00111', '1001', '1100110', '11']",1,4,7,11,0,18,3.743145743145743,19,19
"['101100', '0010100', '01110', '111']",1,4,10,11,0,21,3.7576146076146077,17,13
"['1111100', '011', '000101', '0110010', '01110']",1,5,13,15,2,28,6.110472860472861,34,31
"['001', '111010', '11', '0000000', '100011', '0100100']",1,6,19,12,4,31,6.706471306471307,59,36
"['010011', '110', '000001', '11']",1,4,9,8,2,17,2.8833333333333333,21,17
"['010', '001', '111', '00110', '1000011']",1,5,11,10,3,21,5.4,30,21
"['0000', '0011', '01111', '11']",1,4,7,8,2,15,2.626984126984127,17,17
"['101', '100010', '110111', '1000011', '1100', '0110001']",1,6,16,17,4,33,9.56100566100566,46,48
"['101010', '1000100', '001', '111110']",1,4,11,11,2,22,2.6769230769230767,20,15
"['11110', '100', '1', '10000']",1,4,7,7,2,14,2.8166666666666664,18,15
"['01', '1010', '0101000', '110']",1,4,9,7,0,16,3.2098124098124097,17,14
"['1011010', '100', '100000', '01000']",1,4,14,7,0,21,3.859324009324009,17,20
"['001111', '101', '1001', '100011', '10011', '1011100', '110']",1,7,14,20,4,34,13.25953490953491,61,79
"['001', '100', '1110']",1,3,5,5,2,10,1.5238095238095237,7,7
"['010', '011100', '1101110']",1,3,7,9,0,16,2.0358974358974358,10,10
"['101', '001', '10', '01000']",1,4,8,5,2,13,3.4380952380952383,13,13
"['1101001', '100101', '0001000']",1,3,12,8,2,20,1.8021978021978022,8,5
"['11', '1100010', '10110', '1100100', '0011111', '1000011', '01000']",1,7,20,20,6,40,11.44920634920635,83,61
"['001111', '010110', '1']",1,3,5,8,2,13,1.2380952380952381,13,4
"['001', '0001110', '10']",1,3,7,5,0,12,1.4444444444444444,11,8
"['110010', '0010', '011100', '100', '000', '110']",1,6,15,10,5,25,9.31111111111111,35,53
"['11001', '10100', '110', '000']",1,4,9,7,4,16,3.3833333333333333,13,14
"['0001', '0000001', '1110101', '0100011', '110']",1,5,16,12,3,28,4.875324675324675,38,30
"['100', '10110', '011']",1,3,5,6,2,11,1.8333333333333333,7,7
"['0010', '1', '00000', '100', '111000', '101110']",1,6,15,10,2,25,7.318614718614718,50,41
"['110011', '1000', '1010101', '010111']",1,4,10,13,2,23,3.9324009324009324,17,17
"['011011', '01', '001', '1110']",1,4,6,9,0,15,2.9634920634920636,17,15
"['0', '1111101', '1110']",1,3,3,9,0,12,1.3772727272727274,12,6
"['11000', '100100', '1', '010110']",1,4,10,8,2,18,2.844155844155844,22,11
"['00', '00110', '0100001', '1011', '0100']",1,5,14,8,2,22,5.3997113997114,31,28
"['0101101', '100010', '01110', '0100']",1,4,12,10,0,22,3.4857808857808856,17,19
"['0011', '00101', '000']",1,3,8,4,0,12,2.2103174603174605,5,12
"['11000', '00010', '1']",1,3,7,4,2,11,1.2666666666666666,11,6
"['0011', '101011', '100', '0000000', '111011', '1101110']",1,6,16,17,4,33,8.110678210678211,56,47
"['10100', '100', '1']",1,3,5,4,0,9,1.5833333333333333,8,9
"['00100', '001111', '0011100']",1,3,10,8,0,18,2.148018648018648,7,22
"['110000', '1101110', '0111100', '0010011']",1,4,13,14,3,27,3.4065934065934065,22,19
"['0100000', '010', '001000', '110001', '001110', '000000', '101110']",1,7,27,13,5,40,12.065811965811966,64,83
"['1110010', '1001010', '0011000', '00', '1101']",1,5,15,12,3,27,5.666666666666667,37,25
"['00', '110', '111011']",1,3,4,7,0,11,1.3166666666666667,10,6
"['101', '1001101', '110101']",1,3,6,10,0,16,1.882051282051282,9,19
"['01', '1111000', '1010', '111110', '011111', '1010000', '001011']",1,7,16,22,5,38,10.406243756243756,77,64
"['1100001', '001', '011']",1,3,7,6,2,13,1.6666666666666665,10,9
"['0', '1110111', '101', '10001', '001001']",1,5,10,12,0,22,5.074525474525474,36,25
"['11010', '1100111', '001', '1000', '0000111', '0111110', '1111111']",1,7,15,25,4,40,10.76969696969697,78,66
"['1011010', '01101', '1111110', '1111', '0101', '01011']",1,6,10,22,6,32,9.075468975468976,39,47
"['0', '11101', '100111', '10011']",1,4,6,11,2,17,2.806926406926407,20,20
"['00111', '0100', '0100011', '101111', '1110']",1,5,11,15,2,26,5.711344211344211,31,31
"['01', '0001110', '00', '110111', '10', '000111']",1,6,12,13,5,25,7.538461538461538,51,42
"['100', '1', '110111']",1,3,3,7,0,10,1.2301587301587302,11,8
"['1110101', '0011100', '0011000']",1,3,11,10,3,21,2.142857142857143,9,10
"['01', '100010', '1110101', '100011', '0100']",1,5,13,12,2,25,5.612975912975913,33,25
"['000110', '1', '00000']",1,3,9,3,0,12,1.012987012987013,12,8
"['000001', '10', '1110000']",1,3,10,5,0,15,1.3098290598290598,14,9
"['01', '1101011', '00', '1100', '0011100']",1,5,11,11,4,22,5.303751803751804,37,31
"['110110', '101010', '1000110', '1111', '0000', '1001111']",1,6,15,19,6,34,8.744821844821844,45,46
"['0100000', '111', '011100']",1,3,9,7,0,16,1.4820512820512821,12,6
"['1001100', '0001', '0101', '0']",1,4,10,6,2,16,2.6409090909090907,21,14
"['001', '0000110', '1110000']",1,3,11,6,2,17,1.5714285714285714,14,11
"['1011001', '11', '10100', '00', '10', '0000110']",1,6,14,11,5,25,7.119047619047619,54,36
"['0', '00111', '10110', '1111000', '1010', '1001011']",1,6,13,16,4,29,7.829004329004329,53,38
"['00100', '1000110', '100', '11']",1,4,10,7,0,17,3.1468253968253967,20,15
"['101010', '00110', '0001', '100']",1,4,11,7,0,18,3.1683982683982683,15,17
"['101', '100001', '011']",1,3,6,6,2,12,1.7777777777777777,9,10
"['11011', '110101', '100', '11']",1,4,5,11,0,16,3.547186147186147,16,28
"['011100', '101', '110100', '010111', '0000111', '1011']",1,6,14,18,3,32,9.25986235986236,49,43
"['0001', '100000', '00001']",1,3,12,3,0,15,2.216161616161616,6,16
"['0110000', '1101', '111011']",1,3,7,10,0,17,1.806993006993007,10,6
"['1111100', '01101', '0110111', '0011', '000', '1110', '0100']",1,7,15,19,5,34,11.263203463203462,66,69
"['011101', '11010', '11011', '11']",1,4,5,13,2,18,3.897402597402597,17,24
"['0', '1011', '011010', '10']",1,4,6,7,0,13,3.119047619047619,18,12
"['0011', '1010111', '0110000', '000010', '1100']",1,5,16,12,4,28,5.550949050949051,38,29
"['011100', '0110', '100010', '0001011', '01000']",1,5,17,11,2,28,6.297435897435897,31,35
"['0100110', '11', '10111', '110001', '110']",1,5,9,14,0,23,5.91004551004551,32,32
"['01', '010', '00001', '1011100', '000000', '011111', '01011']",1,7,19,15,4,34,10.365934065934066,73,62
"['011', '101', '10001', '100100', '00', '10', '1011100']",1,7,15,13,4,28,11.448334998334998,62,59
"['1000101', '001111', '100', '1101110', '01011', '0011100']",1,6,16,19,3,35,9.186002886002886,51,42
"['01', '0011111', '1110110', '1100', '0110011']",1,5,10,17,3,27,5.0562770562770565,39,29
"['1101', '1000101', '010110', '10']",1,4,9,10,0,19,3.5537684537684537,21,14
"['0', '0101', '0110']",1,3,5,4,2,9,1.55,8,9
"['1110011', '10110', '0010011', '00', '11111', '001100']",1,6,14,18,4,32,7.896281496281496,53,48
"['11010', '001', '11']",1,3,4,6,0,10,1.4714285714285715,8,8
"['010', '000101', '011']",1,3,7,5,2,12,2.0,7,7
"['00', '110001', '01100', '11']",1,4,8,7,2,15,2.87012987012987,19,12
"['0000', '1', '110100', '011001']",1,4,10,7,2,17,2.038095238095238,23,12
"['000100', '1011001', '0111010']",1,3,11,9,2,20,1.8021978021978022,9,4
"['001', '1111110', '001010', '0000110', '111101']",1,5,13,16,4,29,5.147374847374848,38,30
"['110110', '10000', '10011', '1011000', '1101']",1,5,13,14,2,27,6.2651903651903655,27,33
"['0', '01001', '0000110', '111']",1,4,9,7,0,16,2.15,24,10
"['0001', '11011', '1100', '10']",1,4,7,8,2,15,3.1825396825396823,16,16
"['0001', '100', '110010']",1,3,8,5,0,13,1.838095238095238,8,7
"['1110111', '11110', '0101010', '00110', '10', '000111']",1,6,13,19,4,32,8.123337773337774,51,47
"['00101', '10001', '1000010', '010110', '110']",1,5,15,11,2,26,5.900932400932401,30,26
"['101111', '100', '0101000', '0000']",1,4,12,8,0,20,2.8228660228660227,22,18
"['0', '1001', '111110', '0000010', '0110110']",1,5,13,12,2,25,3.8744255744255742,42,24
"['011111', '00', '0111101', '1000101']",1,4,9,13,2,22,3.094932844932845,24,16
"['0', '0001', '011110']",1,3,6,5,0,11,1.0857142857142859,12,8
"['1000001', '1000', '010']",1,3,10,4,0,14,1.6987012987012986,10,7
"['0110101', '100011', '1', '011001']",1,4,9,11,2,20,2.8727106227106227,24,18
"['011011', '0000011', '110', '111']",1,4,8,11,2,19,3.2615384615384615,21,22
"['001001', '110', '111']",1,3,5,7,2,12,1.5555555555555554,9,8
"['10001', '010', '011001']",1,3,8,6,0,14,1.893939393939394,8,7
"['1010111', '01', '0001110', '0']",1,4,8,9,2,17,2.7698412698412698,26,10
"['1100111', '1010', '001', '111101']",1,4,7,13,0,20,3.376712176712177,20,18
"['101100', '1101000', '1']",1,3,7,7,0,14,1.304945054945055,13,7
"['00111', '100', '00011']",1,3,7,6,2,13,1.8,8,10
"['1110101', '00101', '10']",1,3,6,8,0,14,1.6825396825396823,11,9
"['00010', '1', '0010100']",1,3,9,4,0,13,1.25,12,6
"['0', '101000', '011111', '0010101']",1,4,10,10,2,20,2.3855311355311355,27,13
"['0', '0110100', '1001010', '10111', '01010', '1000011']",1,6,17,15,5,32,7.873809523809523,57,36
"['0010', '1011110', '0110', '1100011', '0101']",1,5,12,14,5,26,6.275974025974026,33,23
"['10101', '010011', '00101', '10011']",1,4,10,11,3,21,4.763636363636364,12,22
"['11011', '1', '000', '1001']",1,4,6,7,0,13,2.2214285714285715,18,12
"['001', '11', '1001101', '000001', '1100']",1,5,12,10,0,22,5.006199356199356,35,31
"['1', '1101010', '101', '100110', '1010001', '110101']",1,6,13,17,4,30,8.088278388278388,53,56
"['100', '0100', '1101110']",1,3,7,7,0,14,2.0025974025974023,9,8
"['1000100', '0100111', '0101110', '011', '101', '01010', '000', '0010010', '1100']",1,9,26,20,7,46,21.88896103896104,114,104
"['000110', '110111', '111']",1,3,5,10,2,15,1.6111111111111112,10,10
"['10001', '01001', '10010', '01000']",1,4,13,7,4,20,4.800000000000001,11,17
"['011011', '0101110', '0011000']",1,3,10,10,2,20,2.098901098901099,9,9
"['0101000', '11', '0011', '1101101', '1010011', '01011', '01100']",1,7,17,20,5,37,13.283261183261184,67,64
"['00110', '111110', '010111', '0100']",1,4,9,12,2,21,3.217171717171717,17,21
"['11', '00', '100010']",1,3,6,4,2,10,1.0,10,4
"['0', '010001', '011', '011100', '1001', '11111']",1,6,11,14,2,25,7.296392496392496,50,34
"['0', '01011', '111001']",1,3,5,7,0,12,0.9826839826839826,12,5
"['010', '1', '011', '0000']",1,4,7,4,2,11,2.5238095238095237,14,11
"['0', '101100', '011', '0001111']",1,4,8,9,0,17,2.763919413919414,24,14
"['0010', '00', '1100']",1,3,7,3,2,10,1.8333333333333333,7,13
"['1111000', '0011011', '10']",1,3,7,9,2,16,1.3174603174603174,14,8
"['0100000', '0100111', '1', '000']",1,4,12,6,2,18,2.071428571428571,26,17
"['010', '1', '1001', '1010000', '010011']",1,5,12,9,0,21,5.234648684648684,35,21
"['000111', '100000', '01110']",1,3,10,7,2,17,1.5909090909090908,11,8
"['0100010', '00', '10100', '11101', '10011', '0111', '01100']",1,7,17,16,4,33,11.7010101010101,63,53
"['0101010', '00010', '1111110', '000']",1,4,12,10,2,22,2.669047619047619,22,26
"['00111', '0001', '000', '100010']",1,4,12,6,0,18,4.0359307359307355,14,19
"['01', '1000', '0100', '0000']",1,4,11,3,3,14,3.333333333333333,12,22
"['11', '100', '1111000', '111011']",1,4,6,12,0,18,3.0042735042735043,22,24
"['0', '111', '0011110', '1100000', '1101', '001001']",1,6,14,14,2,28,6.683705183705183,61,37
"['00110', '1', '0110100']",1,3,7,6,0,13,1.25,13,5
"['10101', '000', '00001']",1,3,9,4,2,13,1.65,7,9
"['100', '1', '0000']",1,3,6,2,0,8,1.0714285714285714,8,6
"['1001110', '0101110', '00001', '0101010', '1010', '0111', '11111', '0111100']",1,8,20,26,8,46,16.392640692640693,86,83
"['00010', '10001', '110']",1,3,8,5,2,13,1.8,8,5
"['01', '01101', '1100']",1,3,5,6,0,11,1.5714285714285714,8,8
"['0010110', '0101000', '1101011', '00', '10']",1,5,14,11,5,25,5.166666666666666,40,26
"['11010', '00100', '0011', '100100', '0101100', '01010', '000', '000100', '1001111']",1,9,29,19,7,48,23.10781440781441,96,142
"['01100', '1000', '11000', '01000']",1,4,13,6,3,19,4.844444444444444,8,27
"['110110', '0011011', '1110110', '0111110', '1110']",1,5,10,21,3,31,6.753846153846154,26,44
"['11', '1011000', '0000']",1,3,8,5,0,13,0.9898989898989898,12,8
"['1000100', '01', '1', '00100', '10011', '0000111']",1,6,16,11,4,27,7.7031746031746025,55,39
"['011101', '0001', '001', '10']",1,4,8,7,0,15,2.9349206349206347,16,17
"['1111100', '110010', '11101', '1101', '0101']",1,5,9,17,2,26,6.6239704739704734,26,37
"['00111', '1010', '11011']",1,3,5,9,2,14,1.711111111111111,8,8
"['01', '001101', '11000', '100', '00', '100111']",1,6,13,11,4,24,8.342496392496393,46,41
"['0011', '0101011', '10011', '0000']",1,4,11,9,2,20,3.9393939393939394,15,19
"['0', '0010', '1001000', '111100']",1,4,11,7,0,18,2.5245254745254746,24,17
"['010', '00011', '1111000', '011101', '100011', '0000110', '01011']",1,7,20,19,6,39,12.765673215673216,70,62
"['101', '010101', '1111']",1,3,4,9,0,13,1.838095238095238,8,10
"['01', '1110000', '101', '1011101', '0001', '011000']",1,6,15,14,2,29,8.114341214341215,53,44
"['01', '110011', '00', '10', '1011111']",1,5,7,12,3,19,4.726495726495727,35,21
"['110010', '0100000', '1', '011']",1,4,10,7,0,17,2.4955433455433456,25,12
"['11110', '10', '101110']",1,3,4,9,0,13,1.9805194805194803,8,12
"['11010', '0101', '101110', '110100']",1,4,9,12,2,21,3.987878787878788,14,17
"['001', '0111100', '00011']",1,3,8,7,0,15,1.65,11,9
"['011111', '11000', '0101011', '1']",1,4,7,12,0,19,2.0275557775557775,25,16
"['001', '010110', '0001000', '111']",1,4,11,8,2,19,2.6376068376068376,21,12
"['00', '00010', '10', '111010']",1,4,9,6,2,15,3.188311688311688,18,20
"['1001100', '100', '0100', '00001']",1,4,13,6,0,19,3.447041847041847,17,23
"['0010', '01101', '0110', '00', '0000011', '1001011', '1110']",1,7,18,15,5,33,12.01154401154401,64,58
"['1101', '0110', '111001']",1,3,5,9,2,14,2.15,7,6
"['00', '1000101', '11']",1,3,6,5,2,11,0.8888888888888888,12,4
"['0000101', '01', '10', '001011']",1,4,10,7,2,17,3.158119658119658,22,14
"['00100', '1', '010110', '0000100']",1,4,13,6,0,19,3.045038295038295,22,19
"['100', '1000111', '0000', '1011', '1110']",1,5,11,11,3,22,5.132467532467532,29,28
"['1000', '0101', '000', '0111']",1,4,9,6,3,15,3.2142857142857144,14,17
"['01', '11000', '010110', '0000', '011000']",1,5,15,8,2,23,5.606926406926407,29,41
"['1110000', '10', '0111', '1001']",1,4,8,9,2,17,3.035353535353535,22,15
"['10100', '1', '1011100', '111010']",1,4,8,11,0,19,3.198884448884449,22,16
"['1111100', '11110', '0100111', '1', '1000110']",1,5,10,17,3,27,4.7976190476190474,43,29
"['00100', '01001', '001', '110']",1,4,10,6,4,16,3.6333333333333333,15,17
"['0010', '11011', '10001', '111111', '0101001', '1110']",1,6,12,19,4,31,7.9170940170940165,45,43
"['1101001', '01', '10', '111']",1,4,5,9,2,14,2.7888888888888888,20,17
"['11110', '01', '10']",1,3,3,6,2,9,1.3571428571428572,9,7
"['1000', '0110', '101110']",1,3,7,7,2,14,1.9,8,9
"['1110010', '010001', '101000', '000001', '000', '001100']",1,6,23,11,4,34,9.728205128205127,43,53
"['010', '1', '0000']",1,3,6,2,0,8,1.0714285714285714,8,4
"['1', '0011', '10001', '0000', '1010000', '001011']",1,6,17,10,2,27,7.266949716949717,51,45
"['0011101', '00101', '10111', '0011', '100', '0111111']",1,6,12,19,4,31,8.98066378066378,46,47
"['001', '11100', '0110', '0010011']",1,4,10,9,0,19,3.3835497835497836,20,17
"['1000001', '001', '10111', '0001', '011101', '1011']",1,6,14,15,2,29,8.767887667887667,43,53
"['011101', '00', '0110', '11']",1,4,6,8,2,14,3.1333333333333333,16,12
"['001', '011', '0111011', '1001', '1110101', '1110100']",1,6,12,19,5,31,8.96017316017316,47,50
"['000110', '111100', '101000', '1110011', '1000011']",1,5,16,16,5,32,6.227106227106227,33,31
"['0', '1001001', '110', '111']",1,4,6,8,2,14,2.4166666666666665,20,12
"['0101', '111000', '1', '000000']",1,4,11,6,2,17,1.9857142857142858,25,14
"['0010', '111000', '01011', '011100']",1,4,11,10,2,21,3.409090909090909,18,19
"['000011', '11101', '1111111', '101111']",1,4,6,18,2,24,3.1806526806526807,19,34
"['1110111', '00', '0000100']",1,3,9,7,2,16,0.9523809523809523,16,8
"['010001', '011', '001000', '1000', '0011111', '0101']",1,6,17,13,4,30,9.01946941946942,47,44
"['1110101', '001111', '0000111', '011000']",1,4,12,14,4,26,3.39010989010989,22,20
"['1010111', '111111', '11011', '000']",1,4,6,15,0,21,2.672144522144522,21,22
"['1010', '000', '11010', '1111']",1,4,7,9,2,16,3.126984126984127,14,15
"['101', '101110', '0100101']",1,3,7,9,0,16,1.7282051282051283,11,10
"['000100', '010', '110', '1010100', '0011111', '000', '0101', '1100']",1,8,21,16,7,37,15.767421467421467,84,94
"['1001110', '01', '01111', '00', '0110010']",1,5,11,12,4,23,5.182539682539682,38,27
"['1000001', '00011', '011011', '110111', '01000']",1,5,15,14,4,29,5.68974358974359,31,27
"['011', '1000110', '1001', '1111000', '1000111', '000010', '1100', '01000', '0110011']",1,9,27,23,6,50,22.317021867021868,120,104
"['0010', '100', '0101100', '0000']",1,4,13,5,2,18,3.401948051948052,15,28
"['0001101', '01', '0001011']",1,3,9,7,2,16,1.746031746031746,12,10
"['00100', '010111', '0011111']",1,3,8,10,0,18,1.8146853146853146,9,11
"['1001', '1110', '11']",1,3,3,7,2,10,1.8333333333333333,7,10
"['00', '1110100', '11']",1,3,5,6,2,11,0.8888888888888888,12,8
"['11', '1001', '0110', '10000', '10110', '00', '01110']",1,7,14,13,7,27,12.10952380952381,53,53
"['110011', '00', '0101', '101010']",1,4,9,9,2,18,3.7333333333333334,18,10
"['11000', '00', '00101', '0100']",1,4,11,5,2,16,3.5428571428571427,16,23
"['0', '01', '0101100']",1,3,6,4,0,10,1.3611111111111112,12,9
"['000110', '01', '11010', '00111', '0001', '0000', '011111', '1111111']",1,8,17,22,6,39,14.21927516927517,95,90
"['011011', '0000101', '1001101']",1,3,10,10,2,20,2.098901098901099,8,8
"['0100110', '10110', '1100100', '1110']",1,4,11,12,2,23,4.066378066378066,14,20
"['0', '111110', '110100']",1,3,5,8,2,13,1.0714285714285714,12,7
"['0010', '11', '00111', '10000', '0011010', '0010011', '10010', '010110']",1,8,23,18,5,41,16.988966588966587,81,91
"['011', '111', '0100']",1,3,4,6,2,10,1.5238095238095237,6,7
"['1000', '01010', '01110']",1,3,8,6,2,14,1.911111111111111,6,10
"['11011', '1', '101010', '1101101', '00010']",1,5,10,14,2,24,4.811005661005661,35,27
"['0011101', '001', '1001010', '00111', '11000', '1010011', '111000']",1,7,20,20,5,40,13.195143745143746,70,69
"['1101001', '111000', '01111']",1,3,7,11,0,18,1.9813519813519813,10,10
"['11011', '100', '010010', '1000010', '011111', '1110']",1,6,14,17,2,31,7.758452658452658,48,42
"['011010', '01000', '11']",1,3,7,6,0,13,1.331168831168831,10,5
"['101010', '01', '011011', '0100101']",1,4,10,11,2,21,3.6495726495726495,21,16
"['010', '111100', '101', '0011', '110']",1,5,8,11,3,19,5.669841269841269,27,23
"['011101', '1100000', '0']",1,3,8,6,0,14,0.9972527472527473,16,6
"['0001110', '1001', '111110', '11101', '0110010']",1,5,12,17,2,29,6.191208791208791,32,24
"['101111', '000', '00011']",1,3,7,7,0,14,1.5176767676767677,10,9
"['010', '0001', '0010100', '1000010', '111110', '0101']",1,6,18,13,4,31,7.905283605283605,49,41
"['011010', '000001', '1001010']",1,3,12,7,2,19,1.564102564102564,9,9
"['1101', '1', '0000100']",1,3,7,5,0,12,1.0136363636363637,14,4
"['01', '0011', '111111', '01000']",1,4,7,10,0,17,2.5143578643578643,22,14
"['00111', '111', '0001000', '00011']",1,4,11,9,2,20,3.4166666666666665,19,25
"['011101', '1011011', '00101', '0']",1,4,8,11,0,19,2.8655511155511157,23,12
"['001', '0010000', '0110', '1000', '0111', '010011']",1,6,17,11,3,28,8.532700632700632,44,44
"['001', '111010', '00101', '10101', '011110', '101111']",1,6,12,19,5,31,9.004545454545454,41,40
"['01101', '101', '010']",1,3,5,6,2,11,2.1666666666666665,6,7
"['101100', '111000', '1001', '100']",1,4,10,9,2,19,4.223809523809524,15,20
"['0110000', '11010', '100']",1,3,9,6,0,15,2.0166666666666666,9,7
"['0110', '0111', '010111']",1,3,5,9,2,14,2.15,6,13
"['010', '1101111', '111', '1101101', '100101', '1011']",1,6,9,21,4,30,9.151981351981352,42,61
"['0', '001010', '1110100']",1,3,8,6,0,14,1.151098901098901,14,9
"['0010001', '1010110', '100', '111101', '10010', '1101', '0001000']",1,7,21,18,3,39,11.927644577644577,70,56
"['00', '1100101', '1', '00011']",1,4,8,7,0,15,2.265873015873016,23,13
"['111111', '10101', '0010', '1110']",1,4,6,13,2,19,2.9565656565656564,17,15
"['11', '00100', '100', '000', '1101', '0101']",1,6,12,9,4,21,8.046825396825396,33,39
"['011010', '10', '110100', '01110']",1,4,9,10,2,19,3.8593073593073592,17,19
"['01', '00', '0011111', '11']",1,4,5,8,3,13,2.333333333333333,19,14
"['0', '110', '0100']",1,3,5,3,0,8,1.4714285714285715,7,8
"['1011101', '111', '101001', '1011100']",1,4,8,15,2,23,4.262271062271062,17,28
"['0', '0101111', '001']",1,3,5,6,0,11,1.15,12,6
"['00', '001001', '0110']",1,3,8,4,0,12,1.7666666666666666,9,10
"['101', '00010', '1001', '0101001']",1,4,11,8,0,19,4.017748917748918,16,16
"['0010001', '0001110', '011', '0010000', '1', '1010']",1,6,18,11,3,29,7.457792207792208,59,39
"['100110', '011', '011100', '1011000']",1,4,11,11,2,22,3.971794871794872,18,16
"['01', '00010', '110100']",1,3,8,5,0,13,1.6168831168831168,10,7
"['1010', '01000', '11']",1,3,6,5,0,11,1.619047619047619,8,4
"['11001', '0011011', '1110111', '11']",1,4,6,15,2,21,3.507936507936508,22,31
"['0011', '1111', '1010', '0111', '01011']",1,5,7,14,4,21,6.166666666666666,17,33
"['0100101', '00', '1110']",1,3,7,6,0,13,1.1414141414141414,12,6
"['001', '1011110', '1111', '010111', '0000', '1011', '111101']",1,7,12,22,5,34,10.724103674103674,65,64
"['001', '11100', '10110']",1,3,6,7,2,13,1.8,9,7
"['01', '0010', '1111001', '10', '000']",1,5,10,8,2,18,5.324819624819625,31,22
"['01', '1110010', '0111']",1,3,5,8,0,13,1.6565656565656566,11,9
"['0001', '1001', '00001']",1,3,9,4,2,13,2.3055555555555554,4,15
"['011010', '111010', '110100']",1,3,8,10,3,18,2.5,5,11
"['0', '01000', '0111100']",1,3,8,5,0,13,1.25,13,14
"['1101001', '110', '01110', '0']",1,4,7,9,0,16,2.933333333333333,22,14
"['0001110', '11', '0100010', '10', '011001']",1,5,13,11,4,24,5.376678876678877,38,22
"['0011', '10', '1101110']",1,3,5,8,0,13,1.323232323232323,12,8
"['11000', '01', '110111']",1,3,5,8,0,13,1.331168831168831,11,9
"['110011', '101011', '110100']",1,3,7,11,3,18,2.1666666666666665,8,15
"['1000001', '001111', '010110', '0']",1,4,11,9,2,20,2.411172161172161,28,10
"['1011', '10010', '101101']",1,3,6,9,0,15,2.193939393939394,6,13
"['1010', '11110', '0011110']",1,3,6,10,0,16,1.6414141414141414,8,12
"['1', '010', '000011', '0010000']",1,4,12,5,0,17,2.6955433455433457,24,14
"['1010', '0001', '0001110']",1,3,9,6,2,15,1.5909090909090908,10,10
"['0001001', '11', '00000', '11000', '1001101']",1,5,16,10,4,26,4.965079365079365,36,31
"['0', '10001', '1110011', '01111', '1101100', '101110']",1,6,12,19,4,31,7.557342657342657,58,35
"['101', '11011', '110']",1,3,3,8,2,11,2.1666666666666665,6,11
"['0110000', '01100', '11']",1,3,8,6,0,14,1.8492063492063493,10,9
"['1101', '000111', '100111', '10010']",1,4,9,12,2,21,3.9727272727272727,15,23
"['1101', '1', '000']",1,3,4,4,0,8,0.6857142857142857,9,4
"['000100', '1000101', '1111011']",1,3,10,10,2,20,1.6483516483516483,11,4
"['0010000', '10010', '01010']",1,3,12,5,2,17,1.9333333333333331,8,10
"['1000001', '11010', '1', '101110']",1,4,9,10,0,19,2.376040626040626,25,16
"['0', '1001010', '110101']",1,3,7,7,0,14,1.304945054945055,13,4
"['1001001', '1101', '0111111']",1,3,6,12,2,18,1.5194805194805194,12,10
"['1000001', '11110', '001', '11', '101']",1,5,9,11,2,20,5.165873015873016,32,33
"['00', '0111', '11']",1,3,3,5,2,8,1.0,7,6
"['1110010', '010000', '001', '10']",1,4,11,7,0,18,3.0042735042735043,22,14
"['00100', '0010', '10010']",1,3,10,4,2,14,2.5777777777777775,4,15
"['0010', '1100101', '111']",1,3,6,8,0,14,1.612987012987013,10,6
"['0101111', '0011010', '10011', '0000', '01100']",1,5,15,13,4,28,5.675036075036075,33,27
"['010011', '0100111', '000', '1101']",1,4,10,10,0,20,2.8168720168720167,18,18
"['11110', '10', '111000', '1100', '101001']",1,5,10,13,2,23,6.2623376623376625,26,27
"['00101', '000111', '0100100', '1011', '0101']",1,5,14,12,2,26,6.7876068376068375,26,27
"['1001100', '011', '011000']",1,3,9,7,0,16,2.0358974358974358,10,9
"['0011', '1000111', '1111', '10', '1101']",1,5,7,14,3,21,5.345959595959596,29,38
"['011010', '1101011', '001001', '01000']",1,4,13,11,2,24,3.824009324009324,17,12
"['01', '0100110', '1', '1100100', '110011', '00010']",1,6,15,13,2,28,7.5680430680430675,53,34
"['0010', '001', '101', '1100', '01011']",1,5,10,9,4,19,6.099206349206349,21,24
"['010', '1', '1000010', '101110', '01100']",1,5,12,10,0,22,5.228371628371629,35,24
"['11', '10111', '001100', '00010', '001011']",1,5,12,12,4,24,5.651082251082251,30,27
"['0', '101', '1111110']",1,3,3,8,0,11,1.15,13,4
"['01111', '0100110', '111', '000']",1,4,8,10,2,18,2.5,20,15
"['0', '11110', '1001', '0010011', '111011', '100011']",1,6,12,17,2,29,7.602003552003552,52,46
"['110111', '010', '10', '1011100']",1,4,7,11,0,18,3.558119658119658,21,12
"['0', '001111', '101110']",1,3,5,8,2,13,1.2380952380952381,12,6
"['1000000', '100000', '100001']",1,3,15,4,2,19,2.5256410256410255,4,23
"['1111100', '0110100', '1001', '10100', '000001', '110111', '11100']",1,7,19,21,6,40,11.839493839493839,65,71
"['000110', '11110', '110', '0111']",1,4,7,11,0,18,3.80021645021645,15,22
"['111111', '1100', '011']",1,3,3,10,0,13,1.4158730158730157,11,11
"['0010', '010', '1111', '00', '110']",1,5,8,8,4,16,5.069047619047619,21,28
"['110000', '00100', '10001', '0011010', '110100', '011110', '0111', '1100']",1,8,23,20,7,43,17.55182595182595,81,89
"['1010', '01001', '0010100', '0111']",1,4,11,9,2,20,3.7727272727272725,18,13
"['0010', '001111', '1', '10110', '100010', '0000110']",1,6,16,13,2,29,8.172710622710623,50,43
"['1100011', '00010', '0010111', '011']",1,4,11,11,2,22,3.6047619047619044,21,17
"['1111101', '00', '1100101', '110', '0101001']",1,5,11,15,3,26,4.825396825396825,38,26
"['01', '1010', '011', '000001']",1,4,9,6,0,15,3.3825396825396825,17,14
"['101', '100', '000011']",1,3,7,5,2,12,1.5555555555555554,9,8
"['1000001', '110000', '00000', '11100', '01110']",1,5,18,10,3,28,6.035897435897436,29,28
"['0000101', '1010101', '1']",1,3,8,7,2,15,1.0714285714285714,14,11
"['100110', '00', '0100110', '1110000']",1,4,13,9,2,22,3.498778998778999,23,21
"['010', '000', '011001']",1,3,8,4,2,12,1.7777777777777777,7,9
"['00011', '1010', '111111', '000000', '00010']",1,5,15,11,4,26,4.52929292929293,34,33
"['1000011', '00', '010001', '111']",1,4,10,8,0,18,2.558119658119658,23,12
"['0', '1111010', '0010', '00101']",1,4,9,8,0,17,2.9176767676767676,22,19
"['1', '00000', '000101', '1010001', '1110']",1,5,14,9,0,23,3.7642302142302144,39,23
"['00010', '10', '0001111']",1,3,8,6,0,14,1.4603174603174602,12,10
"['1', '00101', '101011', '1100001', '00110', '1100', '101110']",1,7,16,18,4,34,11.197341547341548,72,56
"['010000', '0110111', '001101', '0010000', '101011', '1111', '001110', '1011011', '01011']",1,9,25,29,7,54,21.835187035187037,109,112
"['011', '10010', '0111', '000', '1001111']",1,5,10,12,2,22,5.5645743145743145,29,27
"['0110000', '001', '11']",1,3,7,5,0,12,1.2444444444444445,12,5
"['010', '01101', '001000', '0100001', '01110']",1,5,16,10,2,26,6.593473193473193,29,36
"['110110', '0100000', '10111', '00', '011111']",1,5,12,14,2,26,4.5372682872682875,39,25
"['011101', '00', '0001110', '111']",1,4,8,10,0,18,2.9803418803418804,22,12
"['010100', '00', '111000', '1']",1,4,9,6,2,15,2.238095238095238,23,15
"['0', '111010', '0011', '10111', '111011', '111110', '00010']",1,7,12,21,5,33,10.314718614718615,66,66
"['1000', '000100', '11']",1,3,8,4,0,12,1.1833333333333333,11,7
"['1000100', '0010100', '011', '110100']",1,4,14,9,2,23,3.6971916971916974,19,25
"['11110', '1', '0100110', '0100']",1,4,8,9,0,17,2.8217171717171716,22,15
"['00010', '1001', '111010']",1,3,8,7,0,15,1.812121212121212,8,6
"['100', '110', '10', '1111']",1,4,4,8,2,12,3.4571428571428573,11,16
"['100100', '11011', '11']",1,3,5,8,0,13,1.6168831168831168,10,12
"['10001', '001', '111']",1,3,5,6,2,11,1.5833333333333333,7,10
"['0011101', '1101011', '100110', '0011111', '10', '1101']",1,6,12,21,3,33,8.542113442113441,54,48
"['01', '100', '10100', '0000', '011111']",1,5,11,9,0,20,4.356493506493506,32,28
"['0101110', '1', '001111', '111011']",1,4,6,14,2,20,2.706043956043956,25,13
"['100010', '100', '000', '11']",1,4,9,5,2,14,2.9,16,14
"['00100', '100010', '011101', '0000', '1011']",1,5,15,10,4,25,5.756060606060606,29,23
"['1', '10011', '0100100', '1101', '00010']",1,5,12,10,2,22,4.891414141414141,33,18
"['0111111', '010001', '0100111', '111']",1,4,8,15,2,23,3.446642246642247,20,27
"['110', '10', '00001']",1,3,6,4,0,10,1.3357142857142859,9,7
"['0010', '00101', '111', '0010100', '110']",1,5,12,10,2,22,5.773304473304473,27,33
"['1000011', '00100', '00', '10100']",1,4,13,6,2,19,3.3873015873015873,19,21
"['0', '1110011', '000101']",1,3,7,7,0,14,1.151098901098901,15,4
"['010010', '1111', '0111', '1011', '1101', '0100']",1,6,10,16,5,26,8.55,34,42
"['1101111', '1111101', '10011']",1,3,4,15,2,19,1.5714285714285714,9,19
"['11010', '001', '1000101', '011', '11', '00001', '10111', '00010']",1,8,18,17,6,35,15.842063492063492,79,76
"['011010', '1001000', '111', '011001']",1,4,11,11,2,22,3.7974358974358973,19,13
"['01101', '0011', '10', '000', '000111', '0110011']",1,6,14,13,0,27,8.661077811077812,45,45
"['010', '111', '101', '10000', '111110', '001100']",1,6,12,14,5,26,7.436868686868687,47,34
"['010100', '011', '101', '0111', '110101']",1,5,9,13,4,22,6.628571428571428,25,27
"['001100', '010', '011010', '1101111']",1,4,10,12,2,22,3.6435897435897435,21,15
"['110010', '11000', '100', '110', '1110']",1,5,10,11,2,21,7.104329004329004,19,35
"['11110', '1101011', '100001']",1,3,7,11,0,18,1.4790209790209792,10,10
"['0111001', '011', '1011110', '00', '001010', '1011000', '01110']",1,7,18,19,3,37,12.917199467199467,68,69
"['1110010', '001', '10010', '0000']",1,4,12,7,0,19,3.9668831168831167,16,18
"['101', '111000', '1101010', '11']",1,4,7,11,0,18,3.558119658119658,20,19
"['010', '111100', '011', '1001', '0110', '1010100', '1001100']",1,7,17,17,6,34,13.207004107004106,60,58
"['00101', '11', '1111110', '1001101', '111110']",1,5,8,19,2,27,5.6005106005106,36,37
"['1000011', '101', '1101']",1,3,6,8,0,14,2.0025974025974023,9,16
"['111', '000011', '101', '00', '100000']",1,5,12,8,4,20,4.288888888888889,34,28
"['1001001', '01101', '011']",1,3,7,8,0,15,1.85,9,9
"['011111', '01', '110', '01011']",1,4,5,11,0,16,2.961327561327561,18,18
"['01001', '1001', '10', '01000']",1,4,10,6,2,16,4.1650793650793645,12,17
"['1001110', '0101111', '010', '01010', '000', '110', '1011111']",1,7,15,20,6,35,11.785714285714285,69,63
"['01', '0100111', '11111', '0000111', '0111110']",1,5,10,18,3,28,5.4523809523809526,36,33
"['1011', '01010', '000']",1,3,7,5,0,12,1.7023809523809523,7,4
"['10111', '0011', '01111', '00110', '10010', '000010', '1001100', '01110', '110101']",1,9,23,25,7,48,23.13177933177933,92,100
"['101', '0110', '100110']",1,3,6,7,0,13,2.038095238095238,8,8
"['1100010', '10100', '001010', '10']",1,4,12,8,0,20,3.5251970251970253,20,18
"['110', '0110', '10', '0010100']",1,4,9,7,0,16,3.8955266955266956,16,18
"['10011', '10', '000', '111001']",1,4,8,8,0,16,3.1431457431457432,19,12
"['0010', '1110010', '110010', '011', '111010']",1,5,12,14,2,26,6.6670773670773675,26,45
"['010011', '11010', '010', '110']",1,4,8,9,2,17,3.823232323232323,15,22
"['101010', '001101', '0000']",1,3,10,6,2,16,1.7,9,8
"['1010000', '011', '10011', '01000']",1,4,12,8,2,20,3.5833333333333335,19,16
"['0010', '111010', '11', '00011', '1000', '10010', '001010', '11100']",1,8,20,17,7,37,17.03802308802309,74,94
"['001', '0101101', '101', '100100', '0001100', '00110', '111110', '01010', '000111', '0001000']",1,10,31,24,10,55,27.074947274947274,133,145
"['110110', '01011', '0111']",1,3,5,10,0,15,1.993939393939394,6,10
"['01', '1101101', '11100', '111101']",1,4,6,14,0,20,3.2394827394827397,19,23
"['01', '1101111', '011100', '10110', '10000', '01010']",1,6,14,16,3,30,8.488400488400488,50,34
"['01', '100100', '1', '0110001']",1,4,9,7,0,16,2.762210012210012,25,14
"['0001011', '11000', '10', '00011']",1,4,11,8,2,19,3.234920634920635,23,23
"['0101', '0001110', '1111011']",1,3,7,11,2,18,1.6623376623376622,13,4
"['011101', '00110', '100100', '01000']",1,4,13,9,4,22,3.827272727272727,17,18
"['111011', '00', '000010', '00001']",1,4,12,7,2,19,2.9274891774891776,21,18
"['1011', '1111101', '101001', '0101001']",1,4,9,15,2,24,3.885914085914086,16,28
"['110', '10101', '100100', '0000011', '1100']",1,5,14,11,0,25,5.520701520701521,31,29
"['0000101', '110', '1100', '001111']",1,4,10,10,0,20,3.0806082806082804,22,19
"['010001', '110', '011']",1,3,6,6,2,12,1.7777777777777777,9,8
"['110010', '111110', '000000']",1,3,10,8,3,18,1.1666666666666667,10,8
"['1', '0001110', '110100']",1,3,7,7,0,14,0.9972527472527473,15,5
"['11001', '00011', '00000', '011101', '110']",1,5,13,11,3,24,5.403030303030303,30,27
"['110', '10000', '011100']",1,3,8,6,0,14,1.712121212121212,9,7
"['10', '1011100', '000']",1,3,7,5,0,12,1.2444444444444445,11,9
"['000101', '00', '01010', '0101100', '0110011']",1,5,16,11,2,27,6.2864912864912865,34,36
"['1001110', '0', '0100']",1,3,7,5,0,12,1.1954545454545453,13,8
"['11010', '001', '111100', '0110100', '0001', '0111111', '0000010', '0000', '001100', '101111']",1,10,29,26,8,55,24.22244977244977,153,158
"['11001', '001001', '100', '1111000', '000', '1101', '0101']",1,7,17,15,4,32,12.72012432012432,56,64
"['01111', '0010011', '1010', '00', '1110']",1,5,10,12,2,22,4.75036075036075,32,27
"['11001', '111', '011', '00100', '00110', '0100']",1,6,13,12,5,25,8.773809523809524,36,40
"['010100', '0001100', '1101', '11101']",1,4,11,11,0,22,3.849028749028749,17,15
"['101100', '11011', '10011', '001000']",1,4,11,11,4,22,3.83030303030303,17,16
"['0000111', '111010', '0', '1000001']",1,4,12,9,2,21,2.4230769230769234,29,12
"['0011', '1101', '010', '1']",1,4,5,7,2,12,2.942857142857143,15,11
"['010', '110011', '100011', '10', '110']",1,5,9,11,4,20,6.1,27,30
"['111000', '011', '1101110']",1,3,6,10,0,16,1.6598290598290597,11,9
"['001101', '0110', '10000', '110100', '10', '1011', '000111', '111101']",1,8,18,21,6,39,16.126984126984127,87,75
"['1000010', '010', '10110', '000']",1,4,12,6,2,18,3.783333333333333,17,19
"['0', '000110', '1110101', '100011', '000100']",1,5,15,11,3,26,4.6712454212454215,39,21
"['101011', '0011', '01111', '11101']",1,4,6,14,2,20,3.802020202020202,13,22
"['0', '1010', '100001', '101101']",1,4,9,8,2,17,3.038095238095238,20,15
"['101010', '011011', '01100']",1,3,8,9,2,17,1.9393939393939394,8,9
"['0011101', '1', '001001']",1,3,7,7,0,14,1.304945054945055,13,9
"['1011', '0100000', '001', '10']",1,4,10,6,0,16,2.846176046176046,21,12
"['0', '100', '11100']",1,3,5,4,0,9,1.5833333333333333,8,8
"['101', '11010', '110', '111']",1,4,4,10,3,14,4.25,10,21
"['11001', '1100001', '0001', '00']",1,4,11,7,0,18,3.90981240981241,17,22
"['1010000', '0101', '011']",1,3,8,6,0,14,1.8025974025974025,10,7
"['00100', '110111', '01110']",1,3,7,9,2,16,1.690909090909091,9,4
"['0001', '110001', '1000', '1101', '11100']",1,5,12,11,3,23,6.6550505050505055,22,35
"['11110', '1100', '11']",1,3,3,8,0,11,1.9047619047619047,7,11
"['0110', '10', '1101110']",1,3,5,8,0,13,1.8383838383838382,10,10
"['0100010', '100', '10', '010110']",1,4,11,7,0,18,3.7803418803418802,19,20
"['11', '10110', '0000101', '110111', '001100']",1,5,12,14,2,26,5.5473415473415475,35,24
"['1011110', '0011', '1101101', '1100101']",1,4,9,16,3,25,3.818181818181818,19,20
"['0010', '1', '1111110', '01000']",1,4,8,9,0,17,2.3469696969696967,25,12
"['0', '0010', '110111', '010100']",1,4,9,8,2,17,2.4714285714285715,22,13
"['1011', '1101', '000', '01110']",1,4,7,9,2,16,3.1547619047619047,17,9
"['0', '0111010', '01011']",1,3,6,7,0,13,1.0833333333333333,13,9
"['0', '0011000', '101', '100', '011111']",1,5,10,10,2,20,4.33058608058608,38,21
"['001', '10001', '1001', '1001000', '1100', '110101']",1,6,16,13,2,29,10.410622710622711,36,57
"['00', '1', '101001']",1,3,5,4,0,9,0.7857142857142857,11,4
"['0', '1011', '01']",1,3,3,4,0,7,1.7333333333333334,6,4
"['00', '001', '0011101', '11']",1,4,7,7,2,14,2.688888888888889,19,17
"['1001011', '000111', '10110', '1110']",1,4,9,13,0,22,3.833877233877234,17,19
"['11011', '001', '101', '0001', '00100', '10000']",1,6,15,10,5,25,8.773015873015872,36,44
"['11', '111000', '1100', '00000']",1,4,10,7,0,17,2.9565656565656564,19,22
"['0000100', '0110', '0010101', '1010', '00', '10010', '0011111']",1,7,21,15,5,36,12.688672438672437,69,67
"['01111', '000', '1011000']",1,3,8,7,0,15,1.35,12,10
"['0', '00100', '111011', '1111', '1111010', '01010', '1110']",1,7,12,20,4,32,10.607470307470308,67,68
"['01', '1110000', '0110111', '111']",1,4,7,12,2,19,2.695238095238095,25,23
"['00', '001', '0011111']",1,3,6,6,0,12,1.8444444444444446,10,12
"['110010', '010', '1']",1,3,5,5,0,10,1.4523809523809523,10,6
"['0', '101', '111110', '0001111']",1,4,6,11,0,17,2.4955433455433456,26,13
"['101', '10111', '0001', '0110', '0010101', '1111', '1000000', '001010', '1110100', '101001']",1,10,27,26,8,53,25.781673881673882,140,131
"['111100', '010101', '0000111', '110', '111101']",1,5,11,17,3,28,5.549572649572649,34,34
"['0', '1111001', '00011']",1,3,6,7,0,13,1.0833333333333333,15,5
"['011111', '0001110', '000101', '0']",1,4,10,10,2,20,2.706043956043956,24,17
"['0010111', '101', '1101000', '100', '1000']",1,5,13,11,4,24,5.996536796536796,34,33
"['101010', '1000', '0']",1,3,7,4,0,11,1.4857142857142858,10,7
"['0101000', '1', '0110', '1101111']",1,4,8,11,2,19,2.601298701298701,26,9
"['111', '0100010', '101', '111110', '001100', '111000', '1001011', '1101010']",1,8,20,25,8,45,15.677045177045176,94,78
"['0010', '011', '0011', '1000110', '1010', '1011011']",1,6,14,15,5,29,9.914285714285715,39,44
"['010100', '01', '11010', '1000101', '01101', '1101101', '1110']",1,7,16,20,4,36,12.564246864246865,60,60
"['0', '011', '1110000']",1,3,6,5,0,11,1.15,13,7
"['0010011', '000111', '111001']",1,3,9,10,2,19,1.8846153846153846,10,11
"['11010', '001111', '00', '0111111', '100011', '1011', '1101', '1110']",1,8,13,25,5,38,15.176945276945277,86,88
"['0001001', '01011', '000']",1,3,10,5,0,15,1.7666666666666666,10,10
"['00001', '11', '0001111', '00', '1011', '01011']",1,6,12,13,4,25,7.501010101010101,46,45
"['001', '00111', '101', '01010', '000100', '110101']",1,6,15,13,6,28,9.034343434343434,39,37
"['101010', '010', '0000100']",1,3,11,5,0,16,1.882051282051282,10,10
"['100101', '0101010', '100000', '001101']",1,4,15,10,3,25,3.6794871794871797,17,15
"['11011', '110', '0011', '1101', '000010', '01001', '11100']",1,7,15,17,5,32,12.627561327561327,56,64
"['100100', '101101', '000', '11111']",1,4,9,11,2,20,2.686868686868687,20,13
"['0', '1011', '11']",1,3,2,5,0,7,1.0666666666666667,7,6
"['010', '01101', '00011', '00100', '0001', '011111']",1,6,15,13,3,28,8.852236652236652,39,45
"['1011', '101', '1001011', '11']",1,4,5,11,0,16,4.095526695526695,16,35
"['010101', '10', '111110']",1,3,5,9,2,14,1.3333333333333333,12,7
"['101100', '001', '011', '00000', '1001', '01111', '100010', '0001000']",1,8,24,15,6,39,15.403085803085803,86,80
"['0110010', '1010', '10011', '01110']",1,4,10,11,2,21,3.9383838383838383,15,17
"['001', '0101110', '000101']",1,3,9,7,0,16,1.682051282051282,10,8
"['0', '11101', '01000']",1,3,6,5,2,11,1.0666666666666667,11,4
"['10001', '011', '11']",1,3,4,6,0,10,1.8714285714285714,7,10
"['010011', '010', '100', '10011']",1,4,9,8,2,17,4.159090909090909,14,18
"['0', '0110111', '11']",1,3,3,7,0,10,0.6944444444444444,13,6
"['1110010', '1100100', '011100']",1,3,10,10,2,20,2.241758241758242,8,9
"['1000101', '011100', '101010', '10111', '01111', '1001100']",1,6,16,20,6,36,9.844122544122545,42,44
"['10100', '00', '01011', '11']",1,4,7,7,4,14,2.8857142857142857,17,14
"['01', '10111', '11000', '00100', '10110', '0011111', '110']",1,7,14,18,4,32,11.144444444444444,67,59
"['01', '010', '11', '000101', '10011']",1,5,9,9,2,18,5.736796536796537,26,22
"['1011', '00010', '011']",1,3,6,6,0,12,1.8015873015873014,7,6
"['010', '1000101', '111', '0110000', '001001', '110', '01100']",1,7,19,15,5,34,12.581729381729382,65,51
"['00111', '1', '1011100']",1,3,5,8,0,13,1.25,13,7
"['1000100', '010', '0011', '1001', '1110', '1011111']",1,6,13,16,5,29,8.165584415584416,51,38
"['11101', '001101', '001000']",1,3,9,8,2,17,1.7575757575757576,8,10
"['0001101', '0000', '1', '0010011']",1,4,12,7,2,19,2.668831168831169,25,17
"['010000', '011', '11', '000', '0001011']",1,5,13,8,2,21,4.60042735042735,35,35
"['0101010', '110001', '101001']",1,3,10,9,2,19,1.9102564102564104,8,6
"['0111010', '0000000', '0000001', '1110', '110101']",1,5,19,12,3,31,4.646953046953047,39,31
"['0001001', '0001', '100011', '01010', '1101']",1,5,15,11,2,26,6.083372183372183,27,26
"['1100', '1101111', '0110011']",1,3,6,12,2,18,1.987012987012987,10,12
"['101010', '110110', '0001', '001']",1,4,10,9,2,19,3.3793650793650793,17,16
"['11001', '11110', '1011001', '011', '110100', '0101']",1,6,12,18,2,30,9.300111000111,41,46
"['011111', '00', '001']",1,3,5,6,0,11,1.4944444444444445,10,8
"['1001', '1100', '001111', '000']",1,4,9,8,2,17,3.337301587301587,18,16
"['00001', '1000110', '10', '1011', '1100']",1,5,12,10,2,22,5.391774891774892,32,26
"['00010', '1000', '010011']",1,3,10,5,0,15,1.993939393939394,7,8
"['11011', '0001', '001', '10010']",1,4,9,8,2,17,3.818253968253968,13,15
"['0101101', '100', '0']",1,3,6,5,0,11,1.35,12,6
"['1010', '1', '000', '1011111']",1,4,6,9,0,15,1.966883116883117,24,12
"['1000000', '00', '1101']",1,3,9,4,0,13,1.1414141414141414,13,6
"['000100', '111', '000']",1,3,8,4,2,12,0.8888888888888888,11,10
"['100110', '1100', '10', '11']",1,4,6,8,2,14,3.433333333333333,16,16
"['1111100', '01', '001', '0001110', '101101', '0001', '1001']",1,7,16,17,4,33,12.392746142746143,70,62
"['0011', '111111', '100', '111011']",1,4,5,14,2,19,3.071428571428571,20,26
"['010', '101000', '00', '10011', '110']",1,5,11,8,2,19,5.594660894660895,26,23
"['101011', '0010010', '110']",1,3,8,8,0,16,1.45982905982906,10,6
"['100', '000', '1110']",1,3,6,4,2,10,1.5238095238095237,6,8
"['11101', '100011', '1']",1,3,4,8,0,12,0.9826839826839826,12,13
"['11001', '10011', '1100110']",1,3,7,10,2,17,2.466666666666667,6,14
"['010100', '11', '0011', '100101', '1001011']",1,5,12,13,2,25,6.443512043512044,31,32
"['1010', '1010101', '00101']",1,3,8,8,0,16,2.0606060606060606,7,12
"['10111', '01', '111']",1,3,2,8,0,10,1.7214285714285715,7,12
"['1101001', '101', '00010', '10001']",1,4,11,9,2,20,3.8166666666666664,17,17
"['110010', '01101', '10', '0011011', '101111']",1,5,10,16,2,26,6.034521034521035,33,25
"['1000000', '1100', '011', '11']",1,4,9,7,0,16,3.005772005772006,22,18
"['1001110', '101000', '001', '100111']",1,4,11,11,2,22,3.7495726495726496,19,20
"['0001', '0101100', '1101010']",1,3,10,8,2,18,1.4415584415584415,11,7
"['11', '010010', '101110', '0100']",1,4,9,9,2,18,3.4,19,14
"['1', '10110', '1010', '011110', '000', '011111']",1,6,10,15,2,25,6.837806637806637,48,38
"['0', '10001', '11']",1,3,4,4,0,8,0.9047619047619047,9,4
"['1001000', '1111', '1101110', '010101', '10', '0100']",1,6,14,16,4,30,8.022904872904872,52,35
"['0111010', '0010111', '00101', '111', '101011', '0001', '0011011']",1,7,17,22,3,39,12.90868020868021,59,65
"['1100', '110', '000000']",1,3,9,4,0,13,1.4793650793650794,10,10
"['0010', '010', '00000', '0011', '10', '0111110', '0111100']",1,7,18,14,4,32,11.488095238095237,66,85
"['1010110', '10000', '1111011']",1,3,8,11,2,19,1.7142857142857142,11,7
"['00', '100', '00011']",1,3,7,3,0,10,1.8714285714285714,7,11
"['11010', '100', '00010', '111']",1,4,8,8,4,16,3.183333333333333,15,15
"['001', '0101', '111100']",1,3,6,7,0,13,1.4158730158730157,10,8
"['1000100', '11', '111011', '11101', '100111', '1000011', '000111']",1,7,16,23,5,39,12.187423687423687,69,107
"['0101101', '1010', '0001', '101110']",1,4,10,11,2,21,3.3783216783216785,18,16
"['0', '010001', '1000101']",1,3,9,5,0,14,1.304945054945055,14,5
"['11001', '110000', '0', '111011', '11111']",1,5,8,15,4,23,4.732034632034632,33,37
"['101', '110001', '1000', '00', '0010010', '1101']",1,6,15,11,2,26,8.845976245976246,43,38
"['10100', '11011', '1110100', '0101100']",1,4,11,13,4,24,4.314285714285714,16,20
"['01', '0110', '01011', '11']",1,4,5,8,2,13,3.642857142857143,13,15
"['11', '00', '10', '01110', '01100']",1,5,8,8,5,16,5.228571428571429,23,25
"['1011', '1010', '01101', '000']",1,4,8,8,2,16,3.4404761904761902,15,12
"['010', '011', '111', '1000111', '001010', '0100011']",1,6,14,15,5,29,8.732356532356532,48,44
"['0000101', '1010', '011', '1111']",1,4,8,10,2,18,3.151948051948052,19,14
"['11010', '001', '1111001', '10011', '01000']",1,5,12,13,3,25,5.783333333333333,30,24
"['10001', '11011', '0010101']",1,3,8,9,2,17,1.7666666666666666,8,9
"['0010110', '11101', '1001000']",1,3,10,9,2,19,1.7142857142857144,11,5
"['10111', '1100000', '1111', '110011', '0001101', '1100', '1110']",1,7,15,22,5,37,12.47045177045177,63,89
"['0010110', '00101', '111', '0']",1,4,8,8,0,16,2.316666666666667,22,14
"['1000101', '111', '00101', '10101', '100', '10001', '1000000']",1,7,20,15,7,35,13.164285714285715,58,90
"['010001', '1101111', '101', '100111', '10']",1,5,9,15,2,24,5.852991452991453,33,33
"['00110', '100', '0111']",1,3,6,6,0,12,1.4523809523809523,8,7
"['0011011', '01', '1000', '101110']",1,4,9,10,0,19,3.0386169386169386,23,14
"['01', '0110', '11']",1,3,3,5,2,8,1.8333333333333333,5,5
"['01', '1101', '00', '11101']",1,4,5,8,2,13,3.246031746031746,14,16
"['00111', '001', '110', '000']",1,4,8,6,3,14,3.083333333333333,14,19
"['0011110', '001', '10']",1,3,6,6,0,12,1.4444444444444444,11,9
"['1110110', '100', '0111010', '00']",1,4,9,10,2,19,3.746031746031746,21,17
"['1000', '10110', '110111', '000000']",1,4,12,9,2,21,2.9242424242424243,20,15
"['01', '010111', '0010', '100010']",1,4,10,8,2,18,3.5666666666666664,19,16
"['1', '0011', '0001', '10111', '1101011', '01010', '1011000', '01000']",1,8,19,19,7,38,14.936580086580086,89,73
"['010', '011100', '01111', '00', '01100']",1,5,11,10,2,21,6.31017316017316,25,49
"['110000', '1001110', '0110111', '011', '11', '10001', '110011']",1,7,15,21,4,36,12.06077256077256,70,74
"['01', '001', '111011']",1,3,4,7,0,11,1.7444444444444445,9,7
"['001010', '1001111', '1101110']",1,3,8,12,2,20,1.9450549450549453,8,6
"['10001', '0001110', '011']",1,3,8,7,0,15,1.7666666666666666,11,4
"['01101', '11', '101000', '1110001', '10010', '00010']",1,6,16,14,3,30,8.96042846042846,47,37
"['1', '10', '1000111']",1,3,4,6,0,10,1.3611111111111112,12,9
"['00', '001101', '0100']",1,3,8,4,0,12,1.5666666666666667,9,13
"['0', '101', '1101101']",1,3,4,7,0,11,1.35,12,6
"['0000', '1000', '10', '01110', '111101']",1,5,11,10,2,21,5.037590187590188,30,24
"['11001', '011', '1000', '0111111', '10', '000001', '1100']",1,7,15,16,2,31,10.382728382728382,71,59
"['0011001', '11010', '1011100', '1011111']",1,4,10,16,3,26,3.833333333333333,19,18
"['1', '1011001', '100110', '010110', '0101', '0100']",1,6,14,14,4,28,8.815950715950716,48,38
"['1011', '11011', '0000']",1,3,6,7,2,13,1.3611111111111112,8,8
"['111', '1101101', '1001', '1000', '10']",1,5,8,12,2,20,5.657647907647908,28,33
"['0', '1000100', '011011', '101000', '1111', '10011', '001100', '1011']",1,8,19,20,5,39,14.039543789543789,92,79
"['100000', '01', '110']",1,3,7,4,0,11,1.0944444444444446,11,6
"['0110111', '1', '100111', '0000011', '010111']",1,5,11,16,4,27,5.256410256410256,36,36
"['10101', '010', '0110111']",1,3,6,9,0,15,2.0166666666666666,9,5
"['1011', '010010', '10']",1,3,6,6,0,12,1.7666666666666666,9,6
"['001', '110', '1011', '0101', '1100']",1,5,8,10,5,18,5.7976190476190474,21,26
"['00', '0101011', '00001']",1,3,9,5,0,14,1.349206349206349,11,8
"['0', '1101001', '100001', '011', '1010']",1,5,11,10,0,21,4.794244644244644,34,22
"['100', '010010', '011100']",1,3,9,6,2,15,2.0,9,11
"['011011', '0001', '00', '0110']",1,4,9,7,2,16,3.533333333333333,16,19
"['001', '010001', '001101']",1,3,9,6,2,15,1.8333333333333333,9,12
"['001000', '11', '00001', '1010', '0111', '1011', '0100']",1,7,16,13,4,29,11.142279942279941,57,52
"['0001001', '11110', '110010', '101011', '100', '01111', '1110101', '001010', '0111', '0110011']",1,10,24,32,8,56,27.218542568542567,136,133
"['01', '011', '1110000', '1001', '010111']",1,5,10,12,0,22,5.433977133977134,35,28
"['1', '101101', '00001']",1,3,6,6,0,12,0.9826839826839826,12,9
"['1011010', '00', '10001']",1,3,8,6,0,14,1.6825396825396823,11,5
"['00110', '100001', '0000']",1,3,11,4,0,15,2.012121212121212,8,6
"['010', '00000', '100', '011110', '011001', '000111']",1,6,17,12,5,29,8.272727272727272,49,48
"['0010001', '10100', '10', '111']",1,4,9,8,0,17,2.9825396825396826,21,14
"['1000001', '10100', '1']",1,3,8,5,0,13,1.0833333333333333,13,9
"['10', '10000', '11']",1,3,5,4,2,9,1.3571428571428572,8,7
"['1110010', '100', '0110', '010000']",1,4,12,8,0,20,3.5989343989343987,19,17
"['010100', '00', '11']",1,3,6,4,2,10,1.0,10,6
"['01', '110', '10']",1,3,3,4,2,7,1.7000000000000002,5,7
"['1101001', '0', '01111', '1000', '011001']",1,5,11,12,0,23,4.7998945498945496,36,24
"['0', '1010110', '101010']",1,3,7,7,0,14,1.458791208791209,12,11
"['00', '1001000', '011', '0111']",1,4,9,7,0,16,2.7985569985569985,21,17
"['1000001', '10001', '0100']",1,3,11,5,0,16,2.0454545454545454,9,10
"['10111', '0100000', '10000', '0000']",1,4,15,6,2,21,3.405050505050505,18,26
"['010', '0110111', '100', '00', '11100']",1,5,10,10,2,20,6.032539682539682,30,31
"['1000101', '011', '101', '01111', '0000101', '0111111', '1001001', '0110010', '1111111']",1,9,21,32,8,53,21.04047619047619,128,129
"['110000', '010', '11000', '1001', '100100', '0100011', '101110']",1,7,21,16,3,37,13.537784437784438,61,58
"['00', '1001', '11100']",1,3,6,5,0,11,1.9047619047619047,8,6
"['0', '1000', '01011', '010100']",1,4,10,6,0,16,2.790764790764791,19,18
"['10100', '100011', '011', '0111']",1,4,8,10,0,18,3.6137085137085134,16,19
"['00001', '1111', '0001100', '01010', '1011011']",1,5,14,14,4,28,5.062337662337662,35,21
"['010001', '0011', '1010', '10011', '1110']",1,5,11,12,3,23,5.827272727272727,24,27
"['01', '1', '1101100']",1,3,4,6,0,10,1.3611111111111112,12,6
"['1011', '0101', '1', '101101']",1,4,5,10,2,15,3.2357142857142858,17,23
"['00', '010', '1100', '10']",1,4,7,4,2,11,4.004761904761905,9,17
"['111', '1001', '10', '1011', '001011']",1,5,7,12,2,19,5.970634920634921,22,36
"['10001', '01000', '11']",1,3,7,5,2,12,1.657142857142857,9,4
"['110000', '001101', '00100', '100110', '00', '01001']",1,6,19,11,5,30,9.094372294372294,45,47
"['0', '01101', '10011', '01010', '001001', '11100']",1,6,14,13,4,27,8.146320346320346,49,32
"['111010', '00001', '0001', '100000', '110101']",1,5,16,11,3,27,5.576767676767677,28,33
"['01', '1001', '1111010', '11111', '1100011']",1,5,8,17,2,25,5.629870129870129,34,39
"['010100', '110110', '101', '0011', '110001', '010010', '0010100', '0111', '0011011', '111101']",1,10,26,29,9,55,28.295954045954044,134,128
"['001', '0110', '010110']",1,3,7,6,0,13,1.8158730158730159,7,12
"['0100001', '1010', '00001']",1,3,11,5,0,16,1.823232323232323,9,10
"['101000', '101', '01000', '11']",1,4,9,7,0,16,3.6614718614718615,16,16
"['1110111', '000110', '111', '100', '00', '010111']",1,6,11,16,4,27,7.252991452991453,52,49
"['00011', '100111', '000', '1111']",1,4,8,10,0,18,2.966161616161616,17,21
"['1011010', '101', '100', '0111', '000111']",1,5,10,13,2,23,5.7553557553557555,31,28
"['01', '0011010', '000']",1,3,8,4,0,12,1.4444444444444444,11,10
"['001101', '0111', '000010', '1011', '1001111']",1,5,12,15,4,27,6.301981351981352,30,24
"['0011', '11010', '00', '000001']",1,4,11,6,0,17,3.146176046176046,19,18
"['11110', '0010', '11', '00000', '101000', '001110', '01000']",1,7,20,13,5,33,10.537950937950937,60,75
"['10101', '10000', '01110']",1,3,8,7,3,15,1.4,9,5
"['110', '111010', '1', '001000']",1,4,8,8,2,16,2.6825396825396823,22,12
"['1101001', '111', '0011', '100011', '1100']",1,5,10,14,2,24,5.975413475413475,30,44
"['1011001', '11', '101', '1011101', '10101']",1,5,8,16,2,24,6.734126984126984,29,62
"['110011', '0100000', '00', '0111']",1,4,11,8,0,19,2.7029526029526028,24,15
"['011', '10101', '100101', '010110', '110101']",1,5,11,15,3,26,7.462121212121212,23,33
"['01', '111', '101101', '0000', '01000']",1,5,11,9,0,20,4.333549783549784,31,22
"['0', '1011010', '0110111', '001111', '00001', '0111', '0101', '1001011']",1,8,18,23,5,41,15.073903873903873,91,71
"['1110111', '01', '001111', '000011', '1100']",1,5,10,15,2,25,4.866822066822067,37,34
"['01', '0010', '000011', '11111', '1000', '0000', '0100']",1,7,18,11,4,29,10.466017316017316,59,66
"['0000111', '0010110', '010011', '011']",1,4,12,11,2,23,3.9655677655677657,18,18
"['101', '011', '0111']",1,3,3,7,2,10,2.095238095238095,5,9
"['111101', '1000101', '011', '01010']",1,4,9,12,0,21,3.621950271950272,19,14
"['0011', '1110110', '1']",1,3,4,8,0,12,1.1954545454545453,13,7
"['0111001', '1', '101110']",1,3,5,9,0,14,1.304945054945055,14,6
"['00010', '1001', '1']",1,3,6,4,0,10,1.4,9,4
"['11000', '00', '001', '11']",1,4,7,5,2,12,2.842857142857143,14,17
"['001101', '1101', '1100', '1111000']",1,4,9,12,2,21,3.8842657342657345,17,22
"['01101', '010', '001110', '0101100', '000', '0000111', '1110']",1,7,19,16,4,35,13.017032967032966,65,76
"['1010111', '100100', '01011']",1,3,8,10,0,18,1.9941724941724943,9,8
"['0101', '1001', '001001', '01011']",1,4,10,9,2,19,4.3828282828282825,11,20
"['10110', '001101', '1111']",1,3,5,10,0,15,1.7717171717171718,7,6
"['1000001', '11101', '010000']",1,3,11,7,0,18,1.632867132867133,11,5
"['1010111', '1011', '111', '0100']",1,4,6,12,2,18,3.22987012987013,18,21
"['1010', '1000', '0110', '001110']",1,4,10,8,3,18,3.35,15,20
"['11011', '101', '110001', '00', '1110']",1,5,8,12,0,20,5.501082251082251,27,27
"['11001', '010', '0011', '101', '1100000', '1000010']",1,6,17,12,4,29,8.825757575757576,49,38
"['001', '1000101', '011']",1,3,7,6,2,13,1.8666666666666667,9,7
"['0010', '10', '01010']",1,3,7,4,0,11,1.9047619047619047,6,12
"['100101', '1', '0111']",1,3,4,7,0,11,1.2857142857142856,11,8
"['010', '001011', '000001', '0001000']",1,4,16,6,2,22,3.441880341880342,18,21
"['110', '100', '010010', '1101110', '1100']",1,5,11,12,2,23,6.634720834720834,26,32
"['11110', '110001', '00']",1,3,6,7,0,13,1.331168831168831,11,5
"['01101', '1101111', '1']",1,3,3,10,0,13,1.25,13,8
"['1011101', '0010010', '1000', '01111']",1,4,11,12,2,23,3.3997113997114,21,12
"['00', '010', '0010']",1,3,7,2,0,9,2.3238095238095235,4,16
"['001111', '011', '0011001', '11000', '100', '000']",1,6,15,12,3,27,8.488422688422688,48,51
"['1000000', '110', '100001']",1,3,11,5,0,16,1.6136752136752137,11,10
"['011001', '101011', '010110', '10011', '0111']",1,5,11,16,3,27,7.03030303030303,23,27
"['01', '11', '0000001', '00', '1011011', '111001']",1,6,13,13,5,26,6.460927960927961,57,41
"['01101', '010001', '111', '100', '1111110', '111011', '0000', '111000']",1,8,17,23,5,40,14.608374958374958,90,86
"['01', '11011', '010001', '0111', '1100111', '0011011', '1001011']",1,7,15,23,3,38,13.504428904428904,64,81
"['011', '0010000', '101', '1001', '0010100', '100000', '0111']",1,7,21,13,6,34,11.578388278388278,69,58
"['01', '010', '01000']",1,3,7,3,0,10,2.1214285714285714,6,12
"['010', '100', '001', '111001']",1,4,8,7,3,15,3.7777777777777777,16,13
"['0', '1100', '00101', '0100110']",1,4,10,7,0,17,2.63989898989899,24,15
"['1110111', '101000', '110', '01110']",1,4,8,13,0,21,3.2862859362859362,20,14
"['0100110', '100', '1111001', '1000111', '10', '101110', '1111011']",1,7,15,24,4,39,12.581807081807082,78,63
"['010100', '11001', '010', '001101', '100111', '010111']",1,6,15,17,4,32,10.005050505050505,43,40
"['001', '1001101', '0111', '1100111', '0101001']",1,5,12,16,3,28,6.696103896103896,32,31
"['11001', '110010', '001111', '101', '10']",1,5,9,13,2,22,5.937085137085137,32,31
"['1001110', '01', '10111', '00', '10010']",1,5,10,11,4,21,5.655555555555555,30,24
"['110110', '1101011', '00', '10010', '111000']",1,5,12,14,2,26,6.188367188367188,32,28
"['0110101', '010000', '1', '00000', '010011', '000100', '1110']",1,7,22,13,3,35,9.513281163281164,72,63
"['0', '011101', '11111', '1100111', '0100101']",1,5,9,17,2,26,4.611888111888112,38,27
"['0100111', '11', '0001101', '10', '00010', '111101']",1,6,13,16,4,29,7.765956265956266,54,41
"['01', '100', '0000000', '0001010', '1110']",1,5,16,7,2,23,4.231168831168831,39,30
"['1110111', '110', '001111']",1,3,4,12,0,16,1.6598290598290597,11,13
"['0010110', '0001110', '001001', '0011110', '1010', '10011', '111000', '0001000', '1110']",1,9,29,24,8,53,22.813308913308912,110,132
"['011011', '10101', '1']",1,3,4,8,0,12,1.3463203463203464,12,8
"['1001', '00', '110111', '000010', '1011']",1,5,11,11,4,22,5.233333333333333,31,21
"['010', '100001', '011011', '101001', '111101', '1101010']",1,6,15,19,4,34,9.091452991452991,45,41
"['01', '1000', '0001', '111010']",1,4,9,7,2,16,3.25,18,15
"['0', '11001', '001', '0110', '1110100', '011110']",1,6,12,14,0,26,7.774547674547675,52,38
"['1001010', '1', '01000']",1,3,8,5,0,13,1.25,13,4
"['0011110', '0101', '001']",1,3,7,7,0,14,1.7168831168831167,9,9
"['1000100', '011', '101', '0001', '0000', '0100']",1,6,17,8,5,25,8.455627705627705,38,44
"['11110', '1010101', '110', '0011100']",1,4,9,13,2,22,3.1785714285714284,19,13
"['0111000', '110000', '0100000', '1000111', '111011', '0100100', '0110010']",1,7,27,20,7,47,13.521978021978022,63,65
"['100100', '0000001', '011']",1,3,11,5,0,16,1.305982905982906,12,7
"['1001111', '110010', '001011', '0110001']",1,4,12,14,4,26,3.8534798534798536,21,15
"['110110', '1011101', '110001', '00', '100111', '1110']",1,6,12,19,3,31,8.805050505050504,47,42
"['0000', '110101', '1110', '1111']",1,4,7,11,3,18,2.8,16,17
"['1101', '0101011', '10', '0000100']",1,4,11,9,2,20,3.0360750360750357,24,11
"['001011', '011', '110100', '0001100', '10', '101110', '011000']",1,7,19,17,4,36,12.17094017094017,70,63
"['011', '010101', '1000011', '01001', '1110']",1,5,12,13,0,25,5.833472083472083,30,29
"['11000', '01', '0111']",1,3,5,6,0,11,1.3968253968253967,10,8
"['011101', '11000', '1']",1,3,5,7,0,12,1.1645021645021645,12,6
"['01', '011', '111']",1,3,2,6,2,8,1.8666666666666667,4,9
"['11011', '0110111', '0001', '0110', '1100110']",1,5,11,16,4,27,6.212842712842713,30,30
"['00100', '1', '10']",1,3,5,3,0,8,1.5714285714285714,8,4
"['1', '01111', '0001111', '1011000', '01011']",1,5,10,15,4,25,4.8619047619047615,39,29
"['0101', '010', '100001', '1110']",1,4,9,8,2,17,3.173015873015873,17,14
"['1000', '01111', '1101100', '1001101']",1,4,10,13,2,23,3.233044733044733,19,16
"['01', '10001', '1100110']",1,3,7,7,0,14,1.6825396825396823,11,7
"['11001', '1000', '10011', '1110']",1,4,8,10,4,18,3.7444444444444445,13,19
"['01', '11000', '1000111', '0111', '1110110', '0100101', '0100']",1,7,17,19,5,36,12.238816738816737,73,60
"['001', '011', '000101', '10', '0100']",1,5,11,7,2,18,5.70952380952381,24,25
"['0111000', '11', '00100', '1000', '1101010']",1,5,14,11,2,25,5.6767676767676765,34,27
"['001', '10', '0100100']",1,3,8,4,0,12,1.4444444444444444,11,7
"['00001', '00100', '010010', '1000', '001001']",1,5,19,7,4,26,7.075757575757576,20,37
"['1000000', '11011', '010', '0110001']",1,4,13,9,2,22,3.071428571428571,24,11
"['11001', '11010', '11']",1,3,4,8,2,12,1.9428571428571428,8,14
"['010', '00101', '010110']",1,3,8,6,0,14,2.143939393939394,8,11
"['101', '10111', '000100', '0010100']",1,4,12,9,0,21,3.427311577311577,19,16
"['0111000', '010', '011100', '0001101', '1011', '110']",1,6,15,15,4,30,9.343656343656344,48,43
"['01', '01001', '1001011']",1,3,7,7,0,14,1.6825396825396823,11,8
"['101', '0100011', '0011010']",1,3,9,8,2,17,1.7714285714285714,12,4
"['111010', '00', '010110']",1,3,7,7,2,14,1.6666666666666665,11,9
"['101', '01', '0011010']",1,3,6,6,0,12,1.8444444444444446,10,5
"['0100111', '10', '11']",1,3,4,7,2,11,1.3888888888888888,11,8
"['11010', '00010', '1', '010010']",1,4,10,7,2,17,3.006926406926407,18,17
"['1100000', '1110101', '10', '0111', '1011']",1,5,10,14,4,24,5.2103174603174605,38,30
"['010', '111100', '0010111', '1001010', '1101011', '0010010', '001010', '1001001', '00010', '110']",1,10,31,27,9,58,27.843717393717395,136,149
"['1101000', '111111', '001010', '10', '1010000']",1,5,14,14,4,28,4.829365079365079,40,26
"['01', '010000', '001']",1,3,8,3,0,11,1.7444444444444445,9,9
"['000011', '11', '00100', '000101', '01010', '01000']",1,6,19,10,5,29,9.012554112554113,42,46
"['0110101', '1101', '00', '11001']",1,4,8,10,0,18,3.7987012987012987,17,16
"['011', '1100001', '1010101', '0010100', '1111', '00010', '01100']",1,7,20,18,5,38,11.814935064935066,69,50
"['100', '10011', '000', '1110110', '01110']",1,5,11,12,4,23,5.85,30,25
"['0001110', '11', '1111110', '0001100', '100011', '10', '01001']",1,7,17,19,5,36,11.406759906759907,79,54
"['0010110', '010', '00111', '101', '111000']",1,5,12,12,2,24,5.749728049728049,35,25
"['0001100', '00', '010101', '001110', '1010', '1010011']",1,6,18,14,4,32,9.378465978465979,51,42
"['0110100', '000011', '00111', '01111', '00', '10']",1,6,14,13,4,27,7.435059385059385,52,47
"['101100', '10100', '00101']",1,3,9,7,2,16,2.0545454545454547,6,12
"['11001', '00011', '00000', '110001', '1101110', '0001100', '1011']",1,7,21,18,5,39,12.423409923409924,64,70
"['1001110', '11011', '111', '1011000', '1110']",1,5,9,17,2,26,6.633116883116883,29,36
"['1111011', '01', '110', '00001']",1,4,7,10,0,17,2.5992063492063493,23,15
"['11110', '010', '001', '11', '0010100', '1110']",1,6,11,13,2,24,7.542207792207792,45,42
"['11010', '011', '00001', '0101011', '1000']",1,5,13,11,2,24,5.1645021645021645,31,27
"['1001', '110', '0011111', '111011']",1,4,6,14,0,20,3.245088245088245,21,20
"['01', '00', '0101111', '01011']",1,4,7,9,2,16,3.365079365079365,19,19
"['0', '10', '11001']",1,3,4,4,0,8,1.5714285714285714,8,4
"['101', '0010111', '111', '0111']",1,4,5,12,2,17,4.022510822510823,15,25
"['0110010', '1101', '1100', '1001101']",1,4,10,12,4,22,4.191558441558442,18,15
"['101000', '000111', '10', '0101111']",1,4,10,11,2,21,2.9252136752136755,25,17
"['1001001', '00', '10', '11']",1,4,7,6,3,13,2.333333333333333,19,11
"['11011', '111100', '00', '10', '01010']",1,5,9,11,4,20,5.1909090909090905,30,23
"['0', '110110', '0110', '1011111']",1,4,6,12,0,18,2.8965534465534466,23,14
"['001', '1111101', '0001010', '111000', '111001']",1,5,13,16,4,29,5.680708180708181,36,34
"['100', '100011', '1110', '00011']",1,4,9,9,0,18,3.4916305916305914,17,21
"['00011', '11100', '000', '011001', '110']",1,5,12,10,4,22,5.798989898989899,29,30
"['11', '10110', '0110', '0000101', '1000000', '10', '10011']",1,7,18,14,6,32,11.82020202020202,71,57
"['00100', '01', '1001']",1,3,7,4,0,11,1.9047619047619047,8,5
"['010', '000001', '01110']",1,3,9,5,0,14,1.558080808080808,10,10
"['00101', '111', '10111', '00', '011001', '00010']",1,6,13,13,3,26,7.895238095238096,44,36
"['1011', '00', '01011', '100110']",1,4,8,9,0,17,3.820923520923521,16,14
"['0101', '10', '001011']",1,3,6,6,0,12,1.9666666666666668,8,6
"['011101', '101011', '1']",1,3,4,9,2,13,1.0714285714285714,13,8
"['11110', '1010110', '0001', '110011', '0000110']",1,5,14,15,2,29,5.890820290820291,31,29
"['00', '100', '110111']",1,3,5,6,0,11,1.4944444444444445,10,6
"['00111', '11010', '1100110', '0']",1,4,8,10,2,18,2.8166666666666664,23,17
"['11000', '1101', '001', '101111']",1,4,7,11,0,18,3.146176046176046,18,20
"['1110010', '0001110', '10100', '10', '1011', '010011', '101001']",1,7,18,19,4,37,13.113098013098012,68,59
"['011', '100011', '10000']",1,3,8,6,0,14,1.643939393939394,9,11
"['0001', '1', '0110']",1,3,5,4,2,9,1.3,9,4
"['10110', '1010', '00', '0100001', '110', '001011']",1,6,15,12,0,27,8.625413475413476,46,39
"['00', '100', '100101', '0111011']",1,4,9,9,0,18,3.4264957264957268,22,14
"['110', '0110110', '0100']",1,3,7,7,0,14,1.8987012987012988,9,11
"['110010', '0100111', '1', '10', '01000']",1,5,11,10,0,21,5.060911310911311,36,23
"['1010001', '1001', '0100', '11']",1,4,9,8,2,17,3.648989898989899,18,15
"['00111', '0101010', '0011111']",1,3,8,11,2,19,2.071428571428571,9,12
"['111', '10001', '000', '001100', '1110']",1,5,11,10,2,21,5.093867243867244,29,24
"['0', '1101', '010011']",1,3,5,6,0,11,1.0857142857142859,11,5
"['101000', '0101110', '011']",1,3,8,8,0,16,1.6598290598290597,11,7
"['0001100', '111110', '0100110', '111011']",1,4,11,15,4,26,3.677655677655678,19,15
"['0010001', '001110', '000', '0101', '101110', '110101']",1,6,17,15,3,32,9.146564546564546,46,43
"['010', '0001110', '011', '001101', '0011011']",1,5,13,13,4,26,6.806593406593406,30,33
"['11011', '100110', '00', '1100110', '000111', '1101010']",1,6,15,18,4,33,8.917526917526917,45,50
"['1110011', '10', '101101']",1,3,5,10,0,15,1.7136752136752138,12,9
"['010', '1', '1001', '001001', '110']",1,5,9,8,2,17,5.406349206349207,27,22
"['011011', '0011', '01101', '11101']",1,4,7,13,2,20,4.147474747474748,11,23
"['01', '10010', '11']",1,3,4,5,2,9,1.6428571428571428,7,6
"['011', '101', '1111', '1110101', '00110', '00', '010111', '0111100']",1,8,14,23,4,37,15.691158841158842,88,75
"['0101000', '001111', '00000', '1010101', '100110', '11101', '010110', '1101', '01011', '0100101']",1,10,29,29,9,58,27.742113442113443,129,132
"['0', '10001', '011010', '010011']",1,4,10,8,2,18,2.6774891774891776,22,11
"['0110101', '110001', '000']",1,3,9,7,0,16,2.0358974358974358,9,5
"['0', '11110', '1001', '101110']",1,4,6,10,0,16,2.9725829725829724,19,14
"['010100', '01', '011', '1101', '110']",1,5,8,10,2,18,6.173015873015872,23,26
"['1000110', '01', '111010', '0100']",1,4,10,9,0,19,3.371950271950272,21,14
"['00011', '11', '00001', '10', '01001']",1,5,11,8,5,19,5.4714285714285715,26,26
"['11011', '0101111', '1001', '01111', '0100001', '11100', '0110110']",1,7,16,24,6,40,12.904617604617604,65,64
"['0000100', '11', '1000000', '00110', '0001100', '1011']",1,6,21,11,3,32,8.042568542568542,53,47
"['010', '101001', '1000110', '000', '0001000']",1,5,18,8,4,26,5.97997557997558,32,30
"['001', '1', '11101', '001110', '011010']",1,5,9,12,2,21,5.303751803751804,32,20
"['0', '100110', '00111']",1,3,6,6,0,12,1.3463203463203464,11,6
"['001', '0011', '10111', '101', '0000001', '10', '111000']",1,7,16,14,2,30,11.013558663558664,69,64
"['1011', '01', '001']",1,3,4,5,0,9,2.038095238095238,5,7
"['00111', '0001110', '01000', '11']",1,4,10,9,2,19,3.034920634920635,22,16
"['110', '10', '000', '0100']",1,4,8,4,2,12,3.342857142857143,10,17
"['0100001', '00110', '0110011']",1,3,11,8,2,19,1.880952380952381,10,7
"['1000', '1110100', '1011', '001001', '110']",1,5,12,12,2,24,5.5935952935952935,31,27
"['000110', '01000', '11']",1,3,8,5,0,13,1.331168831168831,11,6
"['01101', '111', '0100']",1,3,5,7,0,12,1.7023809523809523,7,5
"['11010', '00101', '11']",1,3,5,7,2,12,1.7428571428571429,9,8
"['110110', '111', '10110', '010011', '0101']",1,5,9,15,2,24,6.552236652236652,25,31
"['01001', '10', '000', '11111']",1,4,7,8,2,15,2.157142857142857,19,10
"['1011', '0010', '110001', '00']",1,4,9,7,2,16,3.1999999999999997,18,11
"['0001110', '10110', '1111', '00', '10']",1,5,9,11,2,20,4.521645021645021,33,25
"['0', '10001', '0101', '0110110']",1,4,9,8,0,17,2.8772727272727274,22,12
"['010011', '1001', '111', '1110']",1,4,6,11,2,17,3.5730158730158728,15,21
"['0010', '101', '00', '000001', '11100']",1,5,13,7,0,20,5.062049062049062,30,28
"['1001100', '01', '10']",1,3,6,5,2,11,1.3888888888888888,12,7
"['011', '01111', '10100', '0000110', '110', '101111']",1,6,12,17,4,29,8.377195027195027,47,44
"['110110', '001', '01111', '00', '1110001', '1001111']",1,6,12,18,2,30,8.466699966699966,55,43
"['0010110', '0', '001', '0011', '10111', '111101']",1,6,11,15,0,26,7.6382339882339885,50,37
"['0', '010', '011010', '100111']",1,4,8,8,2,16,2.849206349206349,23,15
"['00101', '0001', '1111000', '0000101', '0011111']",1,5,16,14,3,30,6.0562770562770565,37,43
"['00010', '1110110', '010']",1,3,8,7,0,15,1.65,10,12
"['0', '101', '1011100', '111']",1,4,5,9,2,14,2.6166666666666667,20,12
"['001', '011', '000101', '1101100', '00110', '10100', '0101']",1,7,18,15,4,33,13.241625041625042,55,61
"['1100010', '10101', '100', '1111']",1,4,8,11,0,19,3.514502164502164,18,17
"['0010', '1', '0110', '00110', '100011', '01000']",1,6,15,10,4,25,8.868037518037518,42,38
"['0101010', '0101', '011']",1,3,7,7,0,14,2.1844155844155844,8,11
"['0', '1111001', '0100001', '0100101', '01100']",1,5,15,12,3,27,5.083333333333333,39,27
"['010011', '1', '0100100']",1,3,8,6,0,14,1.304945054945055,13,8
"['01', '000', '1110']",1,3,5,4,0,9,1.019047619047619,8,6
"['001', '011', '000011', '10', '000010', '00010']",1,6,17,8,4,25,8.952236652236651,39,51
"['0000', '11001', '11']",1,3,6,5,0,11,1.0158730158730158,10,6
"['01', '001', '1110000', '00001', '1000', '011010']",1,6,17,10,0,27,8.232484182484182,47,45
"['0100101', '1001', '1', '01010']",1,4,9,8,0,17,3.043939393939394,21,13
"['10001', '1010100', '1']",1,3,7,6,0,13,1.0833333333333333,13,9
"['0011', '110', '000']",1,3,6,4,2,10,1.476190476190476,7,9
"['0', '0101110', '011011', '00111', '0100101']",1,5,12,14,2,26,5.4562104562104565,36,27
"['00', '010111', '000001']",1,3,9,5,2,14,1.3333333333333333,11,8
"['00000', '1011101', '01111', '1000', '011001', '1101', '001001', '01000']",1,8,23,19,7,42,16.164413364413363,75,83
"['01', '101', '111011', '00110', '100111', '01110']",1,6,10,17,4,27,9.303463203463203,43,34
"['1000011', '00', '01001', '111001']",1,4,11,9,0,20,3.5251970251970253,20,14
"['110110', '0101111', '101101', '101000', '10001']",1,5,13,17,3,30,6.346153846153846,27,28
"['0001', '001110', '000']",1,3,9,4,0,13,2.123809523809524,7,15
"['01', '1101011', '0010011']",1,3,7,9,2,16,1.6031746031746033,13,9
"['1100001', '00', '111101']",1,3,7,8,0,15,1.3098290598290598,13,6
"['11010', '00', '111000']",1,3,7,6,0,13,1.7987012987012987,9,9
"['0', '0101', '001']",1,3,5,3,0,8,1.4714285714285715,6,7
"['1011', '000100', '0100']",1,3,9,5,2,14,1.7000000000000002,9,8
"['0110010', '1101', '110']",1,3,6,8,0,14,2.1844155844155844,8,7
"['1000100', '00', '10101', '01100']",1,4,12,7,2,19,3.3539682539682536,20,17
"['00110', '1', '0100100']",1,3,8,5,0,13,1.25,13,5
"['1000', '010001', '01010']",1,3,10,5,0,15,2.193939393939394,6,8
"['01101', '1011010', '00', '0011']",1,4,9,9,0,18,3.7279942279942277,18,14
"['11', '100100', '00', '0111111', '1010', '1011011', '0100']",1,7,14,18,6,32,10.876251526251526,74,55
"['1111100', '10', '011', '1111101']",1,4,5,14,2,19,2.9460317460317462,23,19
"['1111010', '00000', '11']",1,3,7,7,0,14,0.7777777777777777,15,6
"['0001', '01001', '1']",1,3,6,4,0,10,1.6222222222222222,8,8
"['111110', '1', '01100', '00000']",1,4,9,8,2,17,1.7463203463203463,24,12
"['0', '1000000', '01011', '011001']",1,4,12,7,0,19,2.209373959373959,26,13
"['0100101', '1', '000', '1101']",1,4,8,7,0,15,2.262987012987013,22,12
"['1010010', '000100', '001', '000']",1,4,14,5,2,19,3.815384615384615,18,24
"['011110', '1101', '000', '01010']",1,4,9,9,0,18,3.474098124098124,16,14
"['0000111', '1001100', '0']",1,3,9,6,2,15,1.0714285714285714,16,7
"['01', '01101', '111110', '000', '000100']",1,5,12,10,2,22,4.534559884559885,35,30
"['011011', '11100', '0010000', '111100']",1,4,12,12,2,24,3.3776223776223775,20,24
"['0101101', '01', '0000100', '000011']",1,4,14,8,2,22,3.344932844932845,22,19
"['1000', '010101', '100', '1']",1,4,8,6,0,14,3.3095238095238093,17,15
"['001', '00101', '11', '101', '0001', '1110001']",1,6,12,12,2,24,9.238383838383838,38,57
"['11110', '0101111', '1']",1,3,3,10,0,13,1.25,13,9
"['01', '00', '10011', '11']",1,4,5,6,3,11,2.7142857142857144,13,12
"['101011', '0011101', '1', '1001']",1,4,7,11,0,18,2.742707292707293,23,20
"['11001', '0101', '1110']",1,3,5,8,2,13,1.8333333333333333,7,8
"['00001', '1011110', '1010', '000010', '1100111', '1011', '01100']",1,7,19,19,6,38,12.022405372405371,67,57
"['00001', '101', '1000010', '11101', '10010', '0000011']",1,6,19,13,5,32,9.147619047619047,46,47
"['1010110', '0101000', '0110', '00001']",1,4,14,9,2,23,3.4466089466089467,19,20
"['101', '01101', '00101']",1,3,6,7,2,13,2.3,5,12
"['11110', '100100', '10000']",1,3,9,7,2,16,1.6727272727272728,7,9
"['0001101', '1100001', '1010110', '11']",1,4,11,12,3,23,3.0476190476190474,26,17
"['0100011', '01111', '10', '11']",1,4,6,10,2,16,2.746031746031746,21,18
"['1010111', '0101010', '00', '001']",1,4,10,9,2,19,3.2031746031746033,22,12
"['1010110', '010', '1', '00001', '1110', '0111100']",1,6,13,14,2,27,6.919624819624819,56,34
"['01', '0101111', '1111']",1,3,3,10,0,13,1.505050505050505,11,13
"['010', '00011', '000001', '1001001', '01110', '1011111']",1,6,17,16,4,33,7.892679542679542,51,34
"['101000', '1', '1111110', '101011']",1,4,7,13,2,20,2.1034798534798536,25,18
"['011', '0110', '10011', '0011111', '00010', '0111100']",1,6,14,17,4,31,9.227489177489177,48,44
"['001', '111', '00011', '101000', '0111', '1010011', '110']",1,7,14,17,3,31,11.576806526806527,60,70
"['0111000', '001111', '00', '001001', '110']",1,5,13,11,2,24,5.230769230769231,36,33
"['10010', '001111', '110']",1,3,6,8,0,14,1.4898989898989898,10,8
"['0111', '11110', '01100']",1,3,5,9,2,14,1.9333333333333331,6,10
"['0010', '1100110', '101001']",1,3,9,8,0,17,2.0965034965034963,9,5
"['1100', '1111110', '11']",1,3,3,10,0,13,1.6565656565656566,11,11
"['0111', '0010', '1001011']",1,3,7,8,2,15,1.7727272727272727,8,5
"['101', '0100000', '100']",1,3,9,4,2,13,1.6666666666666665,10,6
"['11010', '0000100', '11', '1101101', '00', '000001', '01100']",1,7,20,14,6,34,10.29070374070374,75,62
"['01', '00', '1110']",1,3,4,4,2,8,1.1666666666666665,7,6
"['111010', '10011', '1110']",1,3,5,10,0,15,1.6080808080808082,8,12
"['101', '100', '000101']",1,3,7,5,2,12,1.7777777777777777,8,10
"['0101000', '1001', '0101010', '00', '110', '1001011']",1,6,17,13,3,30,8.314285714285715,51,37
"['001', '011', '100', '010010', '0010011']",1,5,13,9,3,22,6.235897435897436,29,27
"['101100', '0101', '10010']",1,3,8,7,0,15,1.812121212121212,8,7
"['10101', '01001', '0001', '1']",1,4,8,7,2,15,3.2,16,18
"['010001', '11', '101', '0101011', '0000001', '000', '1001100', '1011011', '0000110']",1,9,28,21,7,49,19.397191697191698,132,101
"['101011', '01', '000001', '0111100']",1,4,11,10,2,21,2.547008547008547,25,13
"['0010', '011', '0001', '0101', '110', '01011']",1,6,12,11,5,23,9.345238095238095,29,42
"['1110101', '1110001', '001', '10']",1,4,8,11,2,19,3.146031746031746,21,21
"['1110111', '00', '000111', '111']",1,4,6,12,0,18,2.6042735042735043,23,29
"['1100011', '100101', '1', '0001000']",1,4,12,9,2,21,2.741758241758242,28,12
"['1000', '100', '110', '11111']",1,4,6,9,2,15,3.067460317460317,15,17
"['1000', '001', '001110', '101110']",1,4,10,9,2,19,3.515873015873016,17,21
"['11010', '1111101', '10', '111100']",1,4,6,14,0,20,3.679043179043179,19,18
"['100110', '00', '0101', '1']",1,4,7,6,0,13,2.4523809523809526,20,10
"['01', '11010', '100']",1,3,5,5,0,10,1.7214285714285715,7,6
"['0100110', '10111', '100', '1110001', '0101', '110']",1,6,13,16,4,29,8.887012987012987,47,38
"['0', '0101110', '0111', '01100', '0110011']",1,5,11,13,2,24,5.425974025974026,35,38
"['1101001', '110110', '111', '1001100', '1110']",1,5,10,17,2,27,6.506426906426906,27,37
"['0011101', '110', '00101', '10011']",1,4,9,11,2,20,3.9,18,17
"['00110', '01', '11011']",1,3,5,7,2,12,1.7428571428571429,9,4
"['0', '11110', '100']",1,3,4,5,0,9,1.3333333333333333,9,6
"['0000101', '00', '001111']",1,3,9,6,0,15,1.5598290598290598,12,11
"['101100', '0110', '111101']",1,3,6,10,2,16,1.9,7,4
"['010', '111100', '0011', '00', '11100', '01011']",1,6,12,13,2,25,8.781457431457431,42,54
"['0', '010', '10011', '0111011']",1,4,7,9,0,16,2.683333333333333,22,13
"['00', '000001', '11']",1,3,7,3,2,10,0.75,11,6
"['101', '001', '1001000', '10']",1,4,9,6,2,15,3.511111111111111,17,17
"['0010110', '101011', '01001']",1,3,9,9,0,18,1.9965034965034967,7,4
"['010', '11011', '111', '0110', '0100']",1,5,8,11,4,19,6.015873015873016,21,25
"['11110', '0111011', '00001', '0000001', '1000', '1100111', '0011011', '01100', '111001']",1,9,26,27,7,53,19.476545676545676,119,114
"['101', '010101', '1']",1,3,4,6,0,10,1.4523809523809523,10,10
"['0011', '110', '100000', '1']",1,4,8,6,0,14,2.6015873015873017,21,14
"['1101001', '111100', '1', '001000', '00000']",1,5,15,10,2,25,3.7946220446220447,38,27
"['0011110', '011001', '1101', '1001011', '0100']",1,5,13,15,4,28,6.073026973026973,31,20
"['000110', '1', '01110']",1,3,6,6,0,12,1.3463203463203464,11,6
"['1000', '10110', '011100']",1,3,8,7,0,15,1.993939393939394,8,8
"['100', '010000', '00101', '1110']",1,4,11,7,0,18,3.127994227994228,18,15
"['010100', '0101111', '0011110', '010111', '10', '01011']",1,6,14,19,4,33,10.043567543567544,43,60
"['001111', '00101', '11', '10101', '111001']",1,5,9,15,4,24,5.988311688311688,29,39
"['110000', '10101', '1110', '1111']",1,4,7,12,2,19,3.4065656565656566,15,21
"['1010', '11011', '001', '0101011']",1,4,8,11,0,19,3.6987012987012986,16,16
"['0', '00101', '1100100', '0010000']",1,4,14,6,2,20,2.880952380952381,25,21
"['1111100', '0110111', '1000110', '011101', '0000']",1,5,14,17,3,31,5.425974025974026,38,26
"['0010', '001', '111', '1011', '011000']",1,5,10,10,4,20,5.207936507936508,26,22
"['001001', '10110', '01011']",1,3,8,8,2,16,2.0727272727272728,7,6
"['0', '0110100', '00001', '1100000', '0111100']",1,5,17,10,3,27,4.559523809523809,42,37
"['1011', '00', '110001']",1,3,6,6,0,12,1.4333333333333333,10,5
"['010100', '10110', '000', '01010']",1,4,12,7,2,19,4.130808080808081,13,25
"['0', '01', '1011000']",1,3,6,4,0,10,1.3611111111111112,12,6
"['01', '111010', '00101', '101', '100', '1011100']",1,6,12,14,2,26,8.980558330558331,45,42
"['0', '10111', '0100']",1,3,5,5,0,10,1.1777777777777778,10,4
"['00111', '00', '10011']",1,3,6,6,2,12,1.9428571428571428,8,7
"['1010', '01', '00101']",1,3,6,5,0,11,1.9047619047619047,7,7
"['10111', '1', '01011', '1100100']",1,4,7,11,2,18,2.716666666666667,24,17
"['100110', '100000', '1101100']",1,3,11,8,2,19,1.8974358974358974,7,9
"['101', '10100', '000']",1,3,7,4,2,11,1.5833333333333333,6,8
"['0010', '0101010', '100000', '11111', '110']",1,5,13,12,0,25,4.580752580752581,35,25
"['0101110', '10110', '10', '0100']",1,4,9,9,0,18,3.90981240981241,17,21
"['1', '010010', '100000', '000', '0011011']",1,5,15,8,2,23,4.344505494505494,40,25
"['1', '010101', '000', '0100001', '01110']",1,5,13,9,0,22,4.632217782217782,36,23
"['1', '000001', '0101001', '01110']",1,4,11,8,0,19,2.6685814185814185,24,13
"['0010110', '01', '1', '1001010', '00110']",1,5,12,10,2,22,5.484126984126984,36,25
"['0011001', '10101', '001', '101001']",1,4,11,10,0,21,4.111655011655012,15,29
"['0101000', '111', '00111', '0011', '0010011', '100010', '100101', '0000', '1011', '0111110']",1,10,27,26,8,53,26.06114441114441,137,130
"['1001110', '101', '0101']",1,3,6,8,0,14,2.0025974025974023,9,9
"['001100', '0001', '010', '1']",1,4,9,5,0,14,3.0238095238095237,18,12
"['0111000', '01', '1001']",1,3,7,6,0,13,1.6565656565656566,11,6
"['01', '10001', '0011010', '0000', '01000']",1,5,16,7,2,23,5.781240981240981,29,29
"['00100', '1', '011']",1,3,5,4,0,9,1.3333333333333333,9,4
"['101', '0001', '100', '0111', '001100', '0100']",1,6,14,10,5,24,8.706349206349206,34,43
"['0111101', '000001', '11']",1,3,7,8,0,15,1.0021367521367521,14,7
"['110000', '01', '010001', '001000', '0101011', '1111001', '111111']",1,7,19,21,6,40,10.136141636141636,75,64
"['000110', '0010', '0101111', '0101101', '011001', '1010000']",1,6,20,17,5,37,9.56017316017316,47,44
"['011', '00101', '001011']",1,3,7,7,0,14,2.3257575757575757,6,12
"['0', '1101111', '011001']",1,3,5,9,0,14,1.151098901098901,15,4
"['0', '100', '111', '1010101']",1,4,6,8,2,14,2.283333333333333,21,11
"['0001', '1000', '1100']",1,3,8,4,3,12,2.0,6,10
"['00', '010111', '110100']",1,3,7,7,2,14,1.5,11,9
"['011111', '1111101', '0']",1,3,3,11,0,14,1.304945054945055,13,8
"['0111000', '1110', '11']",1,3,5,8,0,13,1.8383838383838382,10,6
"['01', '100', '1001']",1,3,5,4,0,9,1.9238095238095236,5,9
"['0001110', '11', '100010', '1010', '1101', '1001111']",1,6,13,17,4,30,9.152941502941502,50,43
"['0110111', '00101', '1001000', '10000', '1111', '00', '01110']",1,7,18,17,5,35,10.207503607503607,75,58
"['0011110', '010', '1001', '1100']",1,4,9,9,2,18,3.5837662337662337,20,12
"['0011', '1010001', '111']",1,3,6,8,0,14,1.7168831168831167,10,10
"['1', '00000', '1010', '00110', '01000']",1,5,14,6,3,20,4.4222222222222225,29,28
"['011011', '0101', '0111110']",1,3,6,11,0,17,2.114685314685315,8,10
"['00111', '11100', '01110']",1,3,6,9,3,15,2.2,8,9
"['011100', '11011', '1110']",1,3,5,10,0,15,2.012121212121212,8,6
"['010100', '0010', '11000', '1101', '01001']",1,5,14,10,4,24,6.421212121212121,24,26
"['0110100', '00011', '11', '101', '1001', '1111001', '0000000']",1,7,19,16,3,35,10.63001443001443,79,58
"['01', '011', '001000', '0001', '001110', '0001000']",1,6,19,9,2,28,9.126051726051726,45,61
"['001', '0110', '000', '01010', '1110']",1,5,11,8,4,19,5.714285714285714,19,33
"['0', '110', '1010011']",1,3,5,6,0,11,1.15,12,5
"['101', '1001', '110', '0000']",1,4,8,6,4,14,3.1666666666666665,13,12
"['0010110', '1', '10']",1,3,5,5,0,10,1.3611111111111112,12,5
"['110', '110111', '0100', '0000']",1,4,9,8,2,17,2.623809523809524,18,15
"['0', '00110', '1011001']",1,3,7,6,0,13,1.25,13,4
"['101', '10', '0000']",1,3,6,3,0,9,1.4190476190476191,7,5
"['1000110', '0001', '111101']",1,3,8,9,0,17,1.7426573426573428,11,7
"['110000', '111010', '011', '0000101', '00']",1,5,14,10,2,24,5.076923076923077,38,30
"['0011101', '011', '0010000', '101', '1101']",1,5,12,12,4,24,5.757575757575758,34,29
"['1001110', '0001', '001010', '111001']",1,4,12,11,2,23,3.63006993006993,19,14
"['11', '1100', '110', '00001']",1,4,7,7,0,14,3.3039682539682538,15,19
"['00010', '10011', '0101100']",1,3,10,7,2,17,1.6,9,5
"['010', '0010111', '11', '00001', '10111', '0001', '1110101', '0000', '001011']",1,9,22,21,6,43,19.317465867465867,108,117
"['0001010', '00', '11100', '0110110']",1,4,12,9,2,21,3.1746031746031744,23,24
"['1000', '100101', '01000']",1,3,10,5,0,15,2.416161616161616,6,9
"['11000', '0000101', '00', '1011', '01110']",1,5,13,10,2,23,5.177200577200577,35,25
"['010', '0100110', '111111', '01010', '1101']",1,5,10,15,0,25,5.46043401043401,32,28
"['1011010', '010', '00001', '1011110', '00000', '110011', '001100', '0101', '110', '0100']",1,10,28,22,10,50,25.79886224886225,133,133
"['01', '111010', '00001', '1001', '100']",1,5,11,9,0,20,5.792207792207792,27,27
"['010000', '001', '101101', '0100100', '0100']",1,5,17,9,2,26,6.226051726051726,29,38
"['101', '00', '1000']",1,3,6,3,0,9,1.638095238095238,6,7
"['01', '0100110', '0000']",1,3,9,4,0,13,1.323232323232323,11,9
"['0001001', '010010', '1001101', '00110', '000001']",1,5,20,11,4,31,6.6262071262071265,25,27
"['11', '00001', '0111', '0000', '01010']",1,5,12,8,4,20,4.84047619047619,27,27
"['010111', '011110', '11111']",1,3,4,13,2,17,1.9393939393939394,6,9
"['0', '10010', '100011', '000001']",1,4,12,6,2,18,2.844155844155844,21,12
"['100', '010', '111100']",1,3,6,6,2,12,1.7777777777777777,9,8
"['100001', '011', '0011', '1001', '1000000', '0000111', '1011', '1101', '1111111']",1,9,21,25,7,46,19.795143745143744,123,137
"['00', '10110', '0000010']",1,3,10,4,0,14,1.349206349206349,12,11
"['1010', '011010', '1111011']",1,3,6,11,0,17,1.9608391608391609,9,7
"['1001001', '01', '10', '11']",1,4,6,7,3,13,2.833333333333333,19,16
"['11001', '1111100', '011', '1110011', '1100101', '010111', '01001']",1,7,15,25,5,40,13.437379287379287,65,84
"['111010', '011011', '10111', '00100', '00']",1,5,11,13,4,24,5.287445887445887,32,26
"['101011', '01001', '1', '1110']",1,4,6,10,0,16,2.5907647907647906,20,15
"['0011', '11000', '01111', '0010101', '10']",1,5,11,12,2,23,5.03997113997114,35,27
"['001', '1100100', '1111', '100110', '100101', '01001', '0110001']",1,7,19,19,4,38,13.52964257964258,63,60
"['010', '1101111', '0001', '1110001', '000010']",1,5,14,13,2,27,5.423509823509823,38,26
"['0010', '010001', '1010', '00', '011000']",1,5,15,7,4,22,6.316666666666666,27,34
"['0011', '1010110', '010', '001110']",1,4,10,10,0,20,4.134598734598734,16,21
"['101010', '010', '110']",1,3,6,6,2,12,1.7777777777777777,7,10
"['00111', '110001', '0000011', '0000', '11100']",1,5,16,11,2,27,5.704273504273504,33,38
"['0', '000110', '0100000']",1,3,11,3,0,14,1.151098901098901,14,14
"['101100', '1011010', '00', '0101', '01110', '011000']",1,6,16,14,2,30,9.908180708180709,40,50
"['00', '111000', '01000']",1,3,9,4,0,13,1.7987012987012987,9,15
"['110000', '10', '000', '101110', '01100']",1,5,13,9,2,22,5.537085137085137,31,31
"['00001', '1100010', '1000110', '11']",1,4,12,9,2,21,3.3650793650793647,22,15
"['00', '10', '10011', '1100111', '01001']",1,5,10,11,4,21,5.974603174603175,30,21
"['010', '0000110', '1111']",1,3,7,7,0,14,1.2493506493506494,12,5
"['01', '1010100', '01111', '10000', '110']",1,5,11,11,2,22,4.301587301587301,35,24
"['10101', '110010', '11101', '1']",1,4,6,11,2,17,3.006926406926407,19,21
"['011011', '101', '0110', '011010', '1110']",1,5,9,14,4,23,6.859523809523809,22,33
"['111101', '100', '10110', '01000']",1,4,9,10,2,19,3.635353535353535,17,12
"['0110101', '1110010', '011011', '00', '1010', '0111', '1110110', '110']",1,8,16,24,5,40,17.193406593406593,85,86
"['1000', '010000', '01100']",1,3,11,4,0,15,2.193939393939394,6,13
"['110001', '111', '01100']",1,3,6,8,0,14,1.893939393939394,9,6
"['00011', '1001000', '11']",1,3,8,6,0,14,1.5158730158730158,12,10
"['11001', '0011', '10100']",1,3,7,7,2,14,1.911111111111111,8,8
"['011101', '001', '0000001', '01011']",1,4,12,9,0,21,2.7309246309246307,19,18
"['000001', '0111101', '10']",1,3,8,7,0,15,1.0021367521367521,14,7
"['00011', '100', '011000']",1,3,9,5,0,14,1.712121212121212,10,10
"['01', '1000', '0110101', '11']",1,4,7,8,2,15,2.6010101010101008,21,14
"['00110', '00010', '000001']",1,3,12,4,2,16,2.0727272727272728,6,13
"['1100010', '0010100', '10', '10011', '011010']",1,5,15,12,2,27,5.948995448995449,36,24
"['0001110', '1110000', '1000', '1100110', '0101', '1100']",1,6,18,15,6,33,9.204545454545455,51,46
"['011', '111', '00000', '10100', '010011', '01110']",1,6,14,13,5,27,7.3641414141414145,43,40
"['11001', '11101', '001']",1,3,5,8,2,13,2.05,6,13
"['01', '0011', '010010', '000', '011001', '110']",1,6,14,10,4,24,8.198412698412698,41,40
"['0', '0010', '0100110', '1101000', '0111100']",1,5,15,11,3,26,4.643506493506494,42,37
"['01111', '1001111', '11111']",1,3,3,14,2,17,2.3,5,24
"['11001', '01', '00100', '1000110', '1001', '000010', '001100', '101110']",1,8,24,17,5,41,17.744488844488846,82,75
"['0001011', '1010001', '00']",1,3,10,6,2,16,1.4603174603174602,14,6
"['0', '1011', '101111']",1,3,3,8,0,11,1.4857142857142858,10,8
"['101', '1100100', '011110', '0000']",1,4,11,9,0,20,2.918969918969919,22,12
"['00111', '101', '1101000', '110100', '1000', '10010', '11111', '01011']",1,8,18,22,4,40,16.17026307026307,80,90
"['0', '1001', '110011', '0111111', '010101', '010111']",1,6,11,19,3,30,7.92975357975358,50,40
"['00111', '001', '10', '0000']",1,4,9,5,0,14,2.784920634920635,16,18
"['11', '101010', '0000001', '1010111', '000010', '110']",1,6,17,14,4,31,6.798962148962149,56,44
"['10111', '0011', '10', '00000']",1,4,9,7,2,16,2.5015873015873016,19,14
"['0110100', '111', '011100', '0010101', '110']",1,5,12,14,4,26,6.452747252747253,29,26
"['1000', '10', '01000']",1,3,8,3,0,11,2.126984126984127,6,10
"['100', '0110100', '000', '11']",1,4,9,6,2,15,2.511111111111111,19,16
"['01', '10001', '010000', '0111010']",1,4,12,8,0,20,3.2046842046842046,21,14
"['1010100', '001111', '110001']",1,3,9,10,2,19,1.576923076923077,12,8
"['1101', '000', '01110']",1,3,6,6,0,12,1.4523809523809523,9,4
"['101100', '1001', '10']",1,3,6,6,0,12,1.7666666666666666,9,9
"['100001', '1111', '1000', '100011', '1001100', '01001', '110']",1,7,18,17,4,35,12.476773226773227,61,71
"['1011', '00', '1100', '0000110']",1,4,10,7,2,17,3.035353535353535,22,16
"['1000000', '010', '001', '00101']",1,4,13,5,2,18,3.3,20,17
"['1101', '0010', '111001']",1,3,6,8,2,14,1.9,9,6
"['0111111', '001', '01011', '011110']",1,4,7,14,0,21,3.159129759129759,18,19
"['0111111', '001111', '101111']",1,3,4,15,2,19,2.371794871794872,5,16
"['0000101', '001', '011', '11']",1,4,8,7,2,15,3.511111111111111,17,16
"['1010110', '01101', '001000', '001001', '111101']",1,5,15,15,3,30,5.8589743589743595,28,28
"['0', '10111', '1101101', '10000', '0001101', '001010', '1100110']",1,7,19,19,5,38,11.466183816183817,76,52
"['0', '1000', '111', '11010']",1,4,6,7,0,13,2.4357142857142855,17,12
"['01', '1100010', '100', '10011', '11111', '0101001', '1110']",1,7,14,19,4,33,10.718614718614718,69,60
"['11100', '10010', '1']",1,3,5,6,2,11,1.2666666666666666,11,6
"['1100', '000', '11']",1,3,5,4,0,9,1.2380952380952381,7,8
"['101', '110101', '00001']",1,3,7,7,0,14,1.5303030303030303,9,12
"['11001', '10100', '10', '0001011', '01110']",1,5,12,12,3,24,5.458730158730159,34,22
"['0111001', '100', '010000', '0101001']",1,4,14,9,2,23,3.9545787545787547,17,20
"['00110', '1000', '01011']",1,3,8,6,2,14,1.911111111111111,8,7
"['010100', '001101', '011110', '0']",1,4,10,9,3,19,2.8571428571428568,23,20
"['101', '10', '000', '1100011', '001011']",1,5,11,10,2,21,5.626495726495726,31,24
"['010100', '0001001', '11010', '0011000', '0110', '1110001', '0111', '1101']",1,8,23,21,6,44,17.741869241869242,83,76
"['0', '0010110', '01']",1,3,6,4,0,10,1.3611111111111112,12,8
"['0110101', '001', '00', '1010', '0011111', '0101001']",1,6,15,15,3,30,8.78961038961039,52,41
"['11', '10001', '100', '0010100', '0001111']",1,5,13,11,2,24,5.348412698412698,38,28
"['101', '1001', '10', '1110']",1,4,5,8,2,13,4.061904761904762,11,19
"['100010', '01001', '000', '1101', '1011011']",1,5,13,12,0,25,5.633422133422133,30,21
"['101', '001', '0100']",1,3,6,4,2,10,1.8095238095238093,5,6
"['1010', '100', '00', '1101']",1,4,7,6,2,13,3.9785714285714286,11,13
"['0011', '00110', '10']",1,3,6,5,0,11,1.7936507936507935,7,10
"['0110101', '0101', '11011', '101000', '100', '111000']",1,6,15,16,2,31,9.387046287046287,43,42
"['101011', '00', '10010', '10']",1,4,8,7,2,15,3.37012987012987,17,14
"['11110', '1001', '0110', '100', '0000101', '0000', '1000011', '1011']",1,8,21,17,6,38,15.713924963924963,84,77
"['0', '0110000', '001', '1110']",1,4,9,6,0,15,2.3811688311688313,23,15
"['11', '0000011', '000', '01110', '1100111', '01000']",1,6,16,13,4,29,7.334126984126984,55,45
"['111', '100', '010101', '01010', '110']",1,5,9,11,3,20,6.103535353535353,21,25
"['101', '011', '000000']",1,3,8,4,2,12,1.1111111111111112,12,4
"['110', '1101111', '001', '0000010', '000', '0000111', '11100', '0100']",1,8,22,17,6,39,14.041774891774892,101,97
"['1111100', '01', '0010111', '101101', '100', '0101011', '1001000', '010011']",1,8,21,24,6,45,15.529181929181929,104,80
"['0101111', '011', '000001', '001001', '110101']",1,5,14,14,3,28,5.4162393162393165,31,29
"['11010', '0101111', '0000011', '01000']",1,4,13,11,4,24,3.0047619047619047,21,19
"['0', '110110', '000110', '010', '0010011']",1,5,13,10,2,23,5.0838217338217335,37,33
"['011011', '10111', '100000', '11']",1,4,8,11,2,19,2.7456709956709955,24,20
"['010', '0111001', '111100', '1']",1,4,7,10,0,17,2.8493894993894995,23,11
"['01', '111100', '0100000']",1,3,9,6,0,15,1.1559829059829059,14,8
"['0100000', '110001', '100', '0111', '1011', '101111']",1,6,14,16,4,30,8.06860361860362,51,44
"['0011110', '011110', '111001']",1,3,7,12,2,19,2.2051282051282053,8,9
"['0101', '100', '0000']",1,3,8,3,2,11,1.6428571428571428,6,8
"['110110', '01', '0010011', '0000101', '1110001']",1,5,15,14,3,29,5.23992673992674,40,27
"['100', '010', '111000', '100111']",1,4,9,9,4,18,3.388888888888889,21,15
"['1000', '110', '11']",1,3,4,5,0,9,1.7047619047619047,6,8
"['11010', '001', '01100']",1,3,7,6,2,13,1.8,8,7
"['0', '001', '0111001', '1010', '1100011', '0000110']",1,6,16,13,3,29,7.4759740259740255,60,32
"['01', '111110', '1100']",1,3,4,8,0,12,1.1833333333333333,11,7
"['10100', '111111', '00', '1110']",1,4,6,11,0,17,2.3128427128427127,21,16
"['111100', '00101', '0011000', '1001', '01010']",1,5,15,12,2,27,6.136596736596736,31,25
"['1110010', '00000', '0001', '1001', '11101', '10010']",1,6,17,13,5,30,9.367171717171717,38,46
"['010', '001', '0110']",1,3,6,4,2,10,2.095238095238095,5,10
"['101', '01101', '110100']",1,3,6,8,0,14,2.143939393939394,8,8
"['110110', '010', '0101']",1,3,6,7,0,13,1.9015873015873015,7,9
"['101100', '010', '001010', '110111']",1,4,10,11,3,21,3.388888888888889,20,13
"['1101001', '01011', '1100', '10']",1,4,8,10,0,18,3.520923520923521,19,16
"['0011001', '0101011', '1']",1,3,7,8,2,15,1.0714285714285714,15,6
"['0111001', '111001', '111110']",1,3,6,13,2,19,2.2051282051282053,7,13
"['010', '101', '100', '00', '01100']",1,5,10,6,3,16,6.571428571428571,19,28
"['00010', '001', '11101', '10011']",1,4,9,9,3,18,3.4,16,13
"['000110', '10101', '10', '00101']",1,4,10,8,2,18,3.7155844155844155,18,16
"['000100', '000110', '11101', '111110', '10', '1011011', '1110']",1,7,15,21,3,36,12.427372627372627,66,63
"['010100', '010000', '111', '0010101', '11101', '000', '0101', '1001011']",1,8,22,19,6,41,15.702952602952603,86,82
"['01', '110001', '0011100']",1,3,8,7,0,15,1.5598290598290598,13,5
"['0', '1000', '101110', '111']",1,4,6,8,0,14,2.238095238095238,20,11
"['100', '1', '0110110', '1101110']",1,4,7,11,2,18,3.057142857142857,24,12
"['00110', '001', '110100', '11']",1,4,8,8,0,16,3.211327561327561,18,16
"['00001', '11000', '10', '110', '101111']",1,5,10,11,2,21,4.928860028860029,33,28
"['0', '111100', '111010', '1110001', '10']",1,5,9,13,2,22,5.304334554334554,36,26
"['110010', '010', '001101', '011', '00']",1,5,11,9,4,20,5.977777777777778,29,28
"['01', '1100001', '1010100', '1010', '0000010', '1101', '111000']",1,7,21,16,5,37,12.035497835497836,72,56
"['0', '0010', '1110111']",1,3,5,7,0,12,1.0136363636363637,14,4
"['110', '1001010', '10011', '000', '0000111', '001001', '1100']",1,7,20,15,4,35,12.078243978243979,67,62
"['11100', '10', '1100100', '1111']",1,4,7,11,0,18,3.2279942279942277,19,21
"['0101101', '1110010', '00101', '00011']",1,4,12,12,4,24,3.7285714285714286,19,16
"['1010000', '11101', '1000111']",1,3,9,10,2,19,1.5714285714285714,12,11
"['101100', '001101', '0101', '110', '1001011']",1,5,12,14,2,26,6.4833166833166835,28,25
"['1011100', '101111', '11']",1,3,4,11,0,15,1.7136752136752138,11,14
"['010100', '11110', '0101']",1,3,7,8,0,15,1.6080808080808082,8,9
"['001', '011000', '11']",1,3,6,5,0,11,1.3444444444444446,10,5
"['0', '0111010', '100100', '0001000', '1101010']",1,5,17,11,3,28,5.0467032967032965,39,31
"['001', '1100010', '101', '000', '110']",1,5,11,8,4,19,5.3999999999999995,27,24
"['0110000', '0011100', '011', '1100100']",1,4,14,10,3,24,3.742857142857143,22,23
"['1000001', '1', '0111']",1,3,6,6,0,12,1.0136363636363637,14,8
"['00', '0101111', '01111', '0111']",1,4,6,12,0,18,3.512987012987013,18,25
"['00', '010', '0101110', '011']",1,4,8,7,2,15,3.511111111111111,17,23
"['0001001', '10101', '00', '111']",1,4,9,8,0,17,2.8325396825396822,21,13
"['1000101', '00111', '01111', '0110000', '10', '1011']",1,6,14,16,4,30,8.232178932178932,53,38
"['00110', '1010010', '001111', '1']",1,4,9,10,0,19,2.7245254745254743,24,14
"['110010', '001', '111', '1001', '0111', '01000']",1,6,12,13,4,25,9.012193362193361,37,39
"['001001', '100111', '10', '1110']",1,4,8,10,2,18,3.333333333333333,20,16
"['11011', '00000', '11', '010111', '100011', '0110010', '0011100', '0110011']",1,8,22,23,7,45,15.624075924075925,94,84
"['010100', '0', '1101011', '11111', '010011', '101111']",1,6,11,20,3,31,7.061688311688312,53,46
"['101000', '100', '1111', '1101', '111001']",1,5,9,14,4,23,6.207142857142857,25,36
"['011100', '100', '1110', '1111']",1,4,6,11,2,17,3.6738095238095236,14,16
"['01', '001', '101', '0001', '100', '01111', '1100101']",1,7,13,14,3,27,12.222438672438672,55,62
"['0111010', '00101', '0011', '1000', '0000', '00010', '101110']",1,7,21,14,5,35,13.424281274281274,56,73
"['1001', '000', '0111011', '111001']",1,4,9,11,0,20,3.5305583305583306,19,14
"['0001', '100', '10110', '010']",1,4,9,6,2,15,3.503968253968254,13,15
"['1011010', '001111', '0011', '10', '010011', '0111100']",1,6,14,18,4,32,8.65946830946831,53,43
"['0', '01', '1110111', '011111']",1,4,4,12,0,16,2.762210012210012,23,15
"['1000', '001', '011', '10']",1,4,7,5,2,12,2.9904761904761905,12,14
"['0', '101', '100', '11100']",1,4,6,6,2,12,3.25,14,13
"['1', '00', '0110', '101001']",1,4,7,6,0,13,2.4523809523809526,19,8
"['1011', '10111', '10']",1,3,3,8,0,11,2.126984126984127,6,14
"['0000', '000001', '01110', '11']",1,4,11,6,0,17,2.4295093795093794,21,16
"['11101', '1001000', '1001']",1,3,8,8,0,16,1.893939393939394,9,12
"['1001000', '00', '110', '10']",1,4,9,5,2,14,2.988888888888889,18,16
"['1011', '11000', '111']",1,3,4,8,0,12,1.5158730158730158,7,13
"['0011', '1000110', '1100001', '11101', '011001']",1,5,14,15,2,29,6.476678876678877,32,29
"['0', '11101', '011', '1001']",1,4,5,8,0,13,2.9714285714285715,16,12
"['00010', '111110', '0001']",1,3,8,7,0,15,1.4525252525252526,10,10
"['1000100', '011010', '0000100']",1,3,14,6,2,20,2.087912087912088,8,14
"['0111010', '1', '00101', '0000', '1100111', '1110']",1,6,13,15,4,28,6.681024531024531,57,32
"['110110', '001000', '011001']",1,3,10,8,3,18,1.6666666666666665,9,6
"['0110101', '1010000', '1']",1,3,8,7,2,15,1.0714285714285714,16,6
"['01', '1001', '1000000', '011010', '110', '1111111']",1,6,13,16,2,29,6.624231324231324,61,35
"['1111101', '1000101', '01000', '00011']",1,4,12,12,4,24,3.338095238095238,22,15
"['00100', '011', '0100']",1,3,8,4,0,12,1.9603174603174602,6,13
"['011', '11000', '000101', '10100', '1000']",1,5,14,9,2,23,5.998845598845598,27,32
"['101000', '10100', '01001']",1,3,10,6,2,16,2.4363636363636365,5,11
"['01', '100', '1', '00001']",1,4,7,4,0,11,2.9714285714285715,15,14
"['11', '0101101', '00', '1000011', '110', '101001']",1,6,13,14,4,27,7.378266178266179,53,37
"['0110100', '10111', '10101', '0100100', '101001', '0100']",1,6,18,16,4,34,10.411910311910312,38,46
"['0100110', '001101', '10000', '10', '0111', '111001']",1,6,15,15,2,30,8.15907425907426,51,35
"['1000100', '00', '0100110', '1011000']",1,4,15,8,3,23,3.1904761904761902,25,20
"['1101', '000000', '000010', '1100111', '0010010']",1,5,19,11,4,30,5.431335331335331,33,31
"['11011', '010', '0110']",1,3,5,7,0,12,2.0238095238095237,7,6
"['001', '1', '010101', '00001']",1,4,9,6,0,15,2.677128427128427,18,17
"['000100', '1001', '1011111']",1,3,8,9,0,17,1.453146853146853,12,5
"['01', '101101', '100', '10', '0111101']",1,5,8,12,2,20,5.424786324786325,33,29
"['001', '10111', '00', '100111', '1011', '01000']",1,6,12,13,2,25,8.716450216450216,41,41
"['11110', '1110001', '1010', '00', '0111', '1101']",1,6,10,16,3,26,8.076118326118326,44,39
"['101011', '011', '10', '00011']",1,4,7,9,0,16,3.3296536796536795,17,19
"['1001000', '100010', '00', '11101', '010111', '1011']",1,6,15,15,2,30,7.997291597291597,52,38
"['01', '111', '00100', '101011', '10']",1,5,8,10,2,18,4.682756132756133,30,21
"['01', '11011', '101000', '10011', '000', '0001011']",1,6,15,13,2,28,8.18974913974914,48,48
"['00110', '010101', '0001', '0110110']",1,4,12,10,0,22,3.5934731934731934,16,20
"['010011', '0101', '110']",1,3,6,7,0,13,1.8158730158730159,8,9
"['110011', '0111101', '100101', '1111011']",1,4,8,18,4,26,4.305860805860806,16,25
"['011100', '0111101', '000']",1,3,8,8,0,16,1.6136752136752137,10,13
"['1001010', '0000010', '000', '1011', '101111']",1,5,15,12,2,27,4.757686757686757,36,28
"['0010', '11110', '00011', '100', '1101100']",1,5,12,12,2,24,5.046176046176046,31,31
"['0011', '0101111', '10']",1,3,5,8,0,13,1.505050505050505,11,7
"['01', '111', '1110', '0100']",1,4,5,8,2,13,3.0428571428571427,13,15
"['01', '00100', '100100', '0001000', '110101']",1,5,17,9,2,26,6.201187701187701,30,30
"['011011', '100', '1010', '1000', '00010']",1,5,13,9,2,22,6.287518037518037,24,30
"['0', '1000', '110']",1,3,5,3,0,8,1.4714285714285715,7,6
"['0011001', '010', '10011', '0']",1,4,9,7,0,16,2.85,23,10
"['0', '00110', '001010', '0000010', '0100101']",1,5,18,8,2,26,5.46037296037296,36,40
"['101', '00', '0110']",1,3,5,4,0,9,1.638095238095238,7,4
"['100110', '1010101', '01011']",1,3,8,10,0,18,2.3298368298368297,8,7
"['101100', '1001', '0110', '1010', '0000111', '1101']",1,6,14,15,4,29,9.329720279720279,45,36
"['1001110', '110010', '0010000', '101010', '10111', '10101', '10100', '1110100']",1,8,24,24,8,48,18.934099234099236,74,90
"['100100', '0100', '11']",1,3,7,5,0,12,1.6333333333333333,9,7
"['01', '010000', '1', '100', '110100']",1,5,11,7,2,18,5.138095238095238,31,23
"['0011', '11110', '011']",1,3,4,8,0,12,1.8015873015873014,7,10
"['01101', '010', '1', '000100']",1,4,9,6,0,15,3.081168831168831,19,11
"['0100111', '11', '10111', '100100', '0010101', '1000111', '110', '011000']",1,8,20,23,5,43,16.584804084804084,96,85
"['0100001', '01', '011', '011001']",1,4,10,8,0,18,3.7803418803418802,19,23
"['01', '1000101', '1101', '001110', '010011']",1,5,12,13,2,25,5.889665889665889,35,24
"['1', '10101', '1001000', '00', '011000']",1,5,13,8,0,21,4.366272616272616,38,24
"['0011', '1010', '000010']",1,3,9,5,2,14,1.7,8,9
"['000100', '01010', '000', '1001']",1,4,13,5,0,18,3.75981240981241,15,18
"['010101', '110', '0011100']",1,3,8,8,0,16,1.6598290598290597,10,6
"['10100', '110', '0010', '11010']",1,4,9,8,2,17,3.954761904761905,12,19
"['0', '00011', '0101101', '1111']",1,4,7,10,0,17,2.2398989898989896,23,12
"['1001110', '1101', '000100', '111']",1,4,9,11,0,20,3.086358086358086,21,12
"['001', '000', '00011']",1,3,8,3,2,11,2.1666666666666665,5,13
"['01', '011101', '00', '00010', '110']",1,5,10,8,2,18,5.154978354978355,28,27
"['101010', '0011011', '010001', '101']",1,4,11,11,2,22,3.454700854700855,19,15
"['101', '0001', '10010', '111']",1,4,7,8,2,15,3.4404761904761902,13,16
"['11110', '0110111', '10001', '10', '1001011']",1,5,10,16,4,26,5.1460317460317455,36,31
"['1000101', '00011', '100010', '100101', '010111', '010110']",1,6,19,17,4,36,10.819347319347319,35,47
"['101', '110', '10000', '0000']",1,4,10,5,2,15,3.126984126984127,15,17
"['0111', '0001101', '01000', '11']",1,4,9,9,0,18,3.0685425685425685,21,15
"['101000', '0101', '100011', '1001011']",1,4,12,11,2,23,3.978554778554779,16,20
"['00', '100', '011', '1001011']",1,4,8,7,2,15,3.1777777777777776,19,16
"['0001', '000101', '10', '00011']",1,4,11,6,0,17,3.717027417027417,15,22
"['100', '10011', '0010101']",1,3,8,7,0,15,2.0166666666666666,9,9
"['00111', '101', '1011', '0000011']",1,4,9,10,0,19,3.635930735930736,18,21
"['010', '001', '100', '0000110', '1100', '1110']",1,6,14,10,5,24,8.869480519480518,42,44
"['00001', '000111', '1111']",1,3,7,8,0,15,1.5494949494949495,9,12
"['010', '0110', '000010', '01011', '111001']",1,5,13,11,2,24,5.994011544011544,28,29
"['01', '01101', '01110', '010']",1,4,7,8,2,15,4.242857142857143,13,23
"['11100', '10', '111']",1,3,3,7,0,10,1.7214285714285715,7,10
"['101', '001', '000101', '11']",1,4,7,7,2,14,3.7,14,19
"['11001', '1101011', '111']",1,3,4,11,0,15,2.1833333333333336,8,21
"['00111', '101', '101111', '0']",1,4,5,10,0,15,3.012987012987013,19,14
"['01101', '00', '00010', '10']",1,4,9,5,4,14,3.3857142857142857,16,17
"['011101', '1000', '0101111', '1001']",1,4,9,12,2,21,3.0465034965034965,19,16
"['010101', '100001', '1111000']",1,3,10,9,2,19,1.4102564102564104,11,7
"['00010', '011', '000']",1,3,8,3,2,11,1.5833333333333333,7,12
"['0', '1011', '011001']",1,3,5,6,0,11,1.2857142857142856,11,4
"['001101', '00011', '11', '1001', '10', '0101']",1,6,11,12,4,23,9.234415584415585,37,40
"['0010', '11', '1101101', '00', '110', '111001']",1,6,10,14,2,24,7.841669441669442,47,40
"['0011', '1001', '01111']",1,3,5,8,2,13,1.8611111111111112,7,7
"['01101', '001111', '100', '1010', '100111', '1011', '1110']",1,7,12,20,5,32,13.2489898989899,53,63
"['1010', '010011', '001', '0101']",1,4,9,8,2,17,3.9595238095238097,13,15
"['010100', '010000', '1']",1,3,9,4,2,13,1.2380952380952381,11,7
"['11000', '00', '1', '0110100']",1,4,9,6,0,15,2.4325396825396823,22,15
"['10111', '0001010', '1110110']",1,3,8,11,2,19,1.7380952380952381,11,7
"['1001110', '10111', '010101', '0']",1,4,8,11,0,19,3.045038295038295,23,11
"['10101', '11011', '001111']",1,3,5,11,2,16,1.8909090909090909,8,10
"['111110', '1101111', '000', '11']",1,4,5,13,0,18,1.9820512820512821,25,20
"['00100', '001', '11']",1,3,6,4,0,10,1.4357142857142857,8,7
"['001101', '00', '0110100', '0111011']",1,4,11,11,2,22,3.6416361416361416,22,21
"['0', '1111000', '1001100', '1101', '1110']",1,5,10,13,4,23,5.30974025974026,37,23
"['1010100', '000', '110100']",1,3,10,6,0,16,1.7675213675213675,8,14
"['101000', '1111010', '00010']",1,3,10,8,0,18,1.6608391608391608,10,10
"['0011', '11101', '011']",1,3,4,8,0,12,1.8015873015873014,7,10
"['1101111', '1001', '0110', '10011', '01010', '000111']",1,6,13,18,4,31,9.556798756798756,43,37
"['0', '010', '0011', '1010', '1011']",1,5,8,8,3,16,5.7,20,24
"['11010', '11110', '11', '11000', '0001', '1100100', '00110', '10011', '01110']",1,9,20,23,6,43,21.096248196248197,97,109
"['00111', '001100', '1010', '100111']",1,4,10,11,2,21,3.9474747474747476,15,19
"['100101', '00', '1', '001010']",1,4,9,6,2,15,2.4047619047619047,22,10
"['010100', '01', '10', '1100111']",1,4,8,9,2,17,3.0042735042735043,24,11
"['1101000', '1010010', '00', '1100111', '000111', '01100']",1,6,18,16,3,34,8.93922743922744,56,47
"['1111', '1100010', '011000']",1,3,8,9,0,17,1.7146853146853147,11,6
"['100110', '011100', '1101110']",1,3,8,11,2,19,2.0384615384615383,8,8
"['1011', '100', '01110', '111001']",1,4,7,11,0,18,3.732034632034632,17,12
"['11011', '100001', '1001010', '11', '0000101', '00', '01011']",1,7,18,16,6,34,11.421434121434121,70,57
"['0000111', '001', '011', '1110000']",1,4,11,9,4,20,3.238095238095238,25,21
"['0', '001100', '0110110']",1,3,8,6,0,14,1.304945054945055,14,12
"['101', '0001', '0011010', '00', '0100001']",1,5,15,8,2,23,5.428282828282828,34,28
"['01101', '0110001', '0011', '1001', '01000']",1,5,14,11,4,25,6.511616161616161,24,28
"['1100', '100110', '100', '010111']",1,4,9,10,2,19,3.634920634920635,18,17
"['000110', '10', '111']",1,3,5,6,0,11,1.3444444444444446,10,5
"['0011', '1101', '10101']",1,3,5,8,2,13,1.8333333333333333,6,11
"['100', '1001111', '0100']",1,3,7,7,0,14,2.0025974025974023,10,8
"['01', '001', '000011', '0100010', '1101101', '111011', '10010']",1,7,18,18,4,36,12.245304695304695,70,54
"['01101', '0101', '1', '111101']",1,4,5,11,0,16,3.235209235209235,18,22
"['1101', '0111101', '10']",1,3,4,9,0,13,1.8383838383838382,10,9
"['1110010', '1000', '11101', '0011100', '1110']",1,5,12,15,4,27,6.774891774891775,28,30
"['1111010', '010101', '1111']",1,3,5,12,0,17,1.9426573426573426,9,12
"['10111', '010011', '1011', '11']",1,4,5,12,0,17,4.154256854256854,14,31
"['11', '0001', '00000', '00011']",1,4,11,5,2,16,3.06031746031746,16,23
"['1111101', '111010', '111', '1011101', '01111', '00']",1,6,8,22,2,30,8.691924741924742,49,53
"['100001', '001101', '11', '00110', '011110']",1,5,12,13,3,25,5.753246753246753,33,23
"['1101001', '011011', '00', '10', '0111']",1,5,9,12,2,21,5.17024087024087,34,23
"['0', '11011', '10001', '011001', '01110']",1,5,10,12,3,22,5.067532467532468,32,20
"['1000100', '100110', '110111', '111']",1,4,9,13,2,22,3.4085470085470084,19,22
"['110110', '01', '10001', '100100', '011010', '1110']",1,6,14,15,3,29,8.434054834054834,44,37
"['1011101', '1000', '011', '0001000']",1,4,12,9,2,21,2.987012987012987,23,16
"['1100', '110', '000101', '1']",1,4,7,7,0,14,2.8873015873015873,19,15
"['101', '0100000', '10110']",1,3,9,6,0,15,1.65,11,6
"['01', '0011101', '0001']",1,3,7,6,0,13,1.6565656565656566,10,10
"['11110', '00101', '001101', '00011', '1100000', '0000101', '10', '110101']",1,8,23,20,7,43,16.25995115995116,92,95
"['110110', '11011', '100001', '001111', '10000', '1110']",1,6,14,18,5,32,8.429292929292929,45,52
"['01101', '010', '0101110', '11', '0011111']",1,5,9,15,2,24,5.657936507936508,35,25
"['10001', '110', '010110', '1']",1,4,7,8,0,15,2.831168831168831,21,12
"['11010', '0001', '0000001', '0111111', '011110']",1,5,14,15,2,29,4.676778776778777,38,31
"['1010', '00', '1100', '0100']",1,4,9,5,3,14,4.25,11,20
"['110000', '111', '1101000', '10', '010110']",1,5,12,12,2,24,5.064102564102564,33,27
"['101', '10001', '111011', '1011', '1110110']",1,5,8,17,0,25,7.036280386280386,25,48
"['0', '11000', '0001']",1,3,7,3,0,10,1.4,10,8
"['1100101', '10', '000000']",1,3,10,5,0,15,1.1559829059829059,14,4
"['000110', '0010', '010000', '1111101', '11', '0101']",1,6,15,14,4,29,7.88943278943279,53,37
"['00', '0110', '1110']",1,3,5,5,2,10,1.75,6,10
"['11', '100100', '10010', '010011', '01000']",1,5,14,10,4,24,6.414718614718614,28,28
"['110110', '010', '00111', '0111', '1100']",1,5,9,13,2,22,5.866089466089466,26,32
"['100', '10', '011', '1111111']",1,4,4,11,2,15,2.3555555555555556,23,15
"['0', '10000', '00011']",1,3,8,3,2,11,1.2666666666666666,11,8
"['0110101', '0010', '100', '00', '001010', '101111']",1,6,15,13,2,28,8.909385059385059,47,44
"['0110101', '001', '1101111', '10010']",1,4,9,13,2,22,3.430952380952381,21,13
"['1001110', '01', '10010', '11111', '111001']",1,5,9,16,2,25,5.604850704850705,33,31
"['010', '001', '10', '1111111']",1,4,5,10,2,15,2.488888888888889,23,11
"['101', '00110', '1111']",1,3,4,8,0,12,1.5158730158730158,8,4
"['110110', '1001010', '101', '0000111', '101111']",1,5,12,17,4,29,5.8791208791208796,34,31
"['0', '1101', '1110001']",1,3,5,7,0,12,1.3772727272727274,12,6
"['11011', '101101', '101001', '10111', '0011', '00', '01000']",1,7,15,18,5,33,12.584271284271285,57,59
"['1100011', '1010', '00010', '1']",1,4,9,8,0,17,2.862121212121212,22,12
"['1', '10', '000000', '1100', '101001']",1,5,12,7,2,19,4.302380952380952,35,21
"['0101', '10010', '11']",1,3,5,6,0,11,1.9047619047619047,8,6
"['00', '1100', '110', '111']",1,4,5,7,2,12,3.1619047619047618,11,18
"['110011', '001000', '0101101', '0000']",1,4,14,9,2,23,3.2762237762237763,20,16
"['0001', '100', '110', '111']",1,4,6,7,3,13,2.8095238095238093,12,15
"['1111101', '101', '0001', '100', '0011100']",1,5,11,13,4,24,5.29004329004329,35,29
"['1001', '1100100', '00', '0000111', '110']",1,5,13,10,2,23,5.228282828282828,36,27
"['001111', '111', '000', '0001011', '00010', '1110']",1,6,14,14,2,28,7.81006771006771,46,59
"['0000111', '10', '11001']",1,3,7,7,0,14,1.2936507936507935,13,7
"['0', '1101', '11011', '001']",1,4,5,8,0,13,3.1936507936507934,15,15
"['1011', '1', '110101']",1,3,3,8,0,11,1.4857142857142858,10,13
"['00', '100', '010011']",1,3,7,4,0,11,1.9666666666666668,8,8
"['101010', '0001011', '011111', '110101', '1101010']",1,5,13,19,5,32,6.404761904761905,27,35
"['01', '110', '10', '00001']",1,4,7,5,2,12,2.807142857142857,16,14
"['100', '0000000', '101111', '101101']",1,4,12,10,2,22,2.805982905982906,24,17
"['010100', '11100', '11']",1,3,6,7,0,13,1.7987012987012987,9,8
"['0111000', '0010001', '001101', '10000', '0010011', '1000', '110']",1,7,24,15,3,39,13.005772005772005,66,71
"['1', '101101', '1100101', '0000', '11100', '01011']",1,6,13,15,2,28,6.686141636141636,54,37
"['010', '11011', '00101', '1001', '01111', '10000', '110111', '110']",1,8,15,21,6,36,16.01053391053391,75,81
"['111100', '00101', '11', '1100010', '0001', '0110000', '10010']",1,7,20,16,4,36,12.334809634809634,68,56
"['001', '0101111', '111', '100', '000101']",1,5,10,12,3,22,4.904273504273505,33,28
"['011101', '0', '1010011']",1,3,6,8,0,14,0.9972527472527473,15,4
"['01101', '111', '101', '1101100', '00', '0111', '011001']",1,7,12,18,2,30,12.957109557109558,56,60
"['010100', '1100001', '1111', '000', '0111', '1100011', '110']",1,7,16,18,6,34,11.252342102342102,67,67
"['1111100', '11', '001000', '111110', '000', '1010011', '110', '01100']",1,8,18,21,6,39,14.212165612165611,97,89
"['0010110', '1000', '1100', '1']",1,4,9,7,2,16,2.8909090909090907,21,13
"['1', '001101', '00111', '011011', '000101', '100000']",1,6,16,14,4,30,8.036796536796537,51,42
"['10001', '100111', '111']",1,3,5,9,0,14,1.893939393939394,8,18
"['101', '100', '1100']",1,3,5,5,2,10,2.095238095238095,4,9
"['11001', '001', '0101110', '000011', '10', '0111']",1,6,13,14,0,27,8.042080142080142,48,36
"['110001', '1', '1111110']",1,3,4,10,0,14,0.9972527472527473,15,9
"['0111', '0010', '1110']",1,3,5,7,3,12,1.75,6,9
"['001101', '111', '10', '0011011', '1011']",1,5,8,14,0,22,6.099555999555999,28,35
"['00', '010', '100']",1,3,6,2,2,8,2.2666666666666666,4,10
"['11000', '100111', '10', '11111', '0011100']",1,5,10,15,2,25,5.228393828393829,35,28
"['0001', '0010100', '0000111', '1101', '1001011']",1,5,16,13,5,29,5.954545454545454,32,28
"['001', '10000', '110011', '10', '111000']",1,5,12,10,2,22,5.521933621933622,31,27
"['110000', '00000', '111011', '10010', '1100']",1,5,15,11,4,26,5.792929292929293,27,34
"['0', '001100', '10']",1,3,6,3,0,9,1.4523809523809523,10,8
"['100001', '00101', '10001', '011110', '11111', '0001010', '1011']",1,7,18,20,5,38,11.775213675213674,62,54
"['111', '01100', '01111', '00', '100011', '01110', '111101']",1,7,12,20,5,32,11.626046176046176,61,60
"['111', '011100', '00100', '101', '10000', '10011', '1100', '01011']",1,8,18,18,6,36,16.12871572871573,74,80
"['10101', '1001', '10', '10011']",1,4,7,9,2,16,4.387301587301587,12,27
"['1011010', '0111100', '11111']",1,3,6,13,2,19,1.880952380952381,9,4
"['101', '10101', '0111111', '0001']",1,4,7,12,0,19,3.0295093795093795,20,20
"['10001', '001', '000', '01000']",1,4,12,4,4,16,4.216666666666667,12,19
"['1100', '011', '1111']",1,3,3,8,2,11,1.6428571428571428,7,11
"['001101', '11', '101', '0000001', '1100111', '1001001', '000100']",1,7,21,17,5,38,11.456471306471306,73,65
"['1110111', '0001', '1001', '0']",1,4,7,9,2,16,2.709090909090909,22,12
"['111000', '1', '001011', '110']",1,4,7,9,2,16,2.515873015873016,23,16
"['0010', '011', '1010', '00010', '01011', '01000']",1,6,16,10,5,26,9.665079365079364,30,53
"['0000101', '1010', '1000', '01100']",1,4,13,7,2,20,3.5075757575757573,18,17
"['001111', '1110000', '01010']",1,3,9,9,0,18,1.506993006993007,13,9
"['0010', '01101', '01', '0100010', '0111101']",1,5,13,12,2,25,6.137806637806637,33,37
"['00110', '1101', '10110']",1,3,6,8,2,14,2.1333333333333333,7,7
"['0001001', '010', '011', '0001', '10110', '10000', '01100']",1,7,20,12,5,32,12.875685425685425,56,62
"['0', '1000100', '000110', '001110']",1,4,13,7,2,20,3.0393772893772892,22,23
"['1000100', '11110', '010000', '00110', '0111', '000', '1101']",1,7,19,15,4,34,10.992174492174492,66,60
"['1010001', '010', '0111110', '1101010']",1,4,11,13,3,24,3.2285714285714286,23,15
"['0101', '101', '1001', '011110', '000100']",1,5,12,11,4,23,5.803174603174603,28,22
"['001', '0011101', '0110', '0100']",1,4,10,8,2,18,3.5837662337662337,16,20
"['01', '011010', '1111', '01010', '000100']",1,5,12,11,2,23,5.452236652236652,31,26
"['1100', '110', '1']",1,3,3,5,0,8,1.7571428571428571,6,8
"['0011', '110101', '0100']",1,3,7,7,2,14,1.7,9,6
"['101', '10', '111', '01100']",1,4,5,8,2,13,3.4380952380952383,13,11
"['11011', '0110111', '00011', '0101011', '0101']",1,5,11,17,4,28,7.245021645021645,23,38
"['11011', '00001', '0011', '00100', '01000', '01100']",1,6,18,11,5,29,8.911111111111111,36,51
"['1110111', '010', '011', '0011', '100']",1,5,8,12,3,20,5.612121212121212,30,26
"['100101', '0000100', '1010011']",1,3,12,8,2,20,1.9560439560439562,10,5
"['0011', '110', '1']",1,3,3,5,0,8,1.4714285714285715,8,7
"['100100', '0111', '00001']",1,3,9,6,0,15,1.38989898989899,10,7
"['0', '1000', '10011']",1,3,6,4,0,10,1.4,9,6
"['10111', '01001', '1']",1,3,4,7,2,11,1.2666666666666666,11,8
"['0010001', '00000', '011011', '0111111', '001010']",1,5,17,14,4,31,5.4681984681984686,31,32
"['0', '110001', '0101110', '0111']",1,4,8,10,0,18,2.7245254745254748,25,12
"['1000001', '011', '11', '101010', '101', '0001']",1,6,13,12,2,25,8.763292263292263,44,47
"['10111', '11000', '100', '001']",1,4,8,8,4,16,3.3166666666666664,17,17
"['101', '0110100', '101110', '11']",1,4,7,11,0,18,3.7803418803418802,20,12
"['11110', '0100000', '000100', '10']",1,4,13,7,0,20,2.828227328227328,23,18
"['0010', '11011', '111', '1110011', '10011', '1100', '0111110']",1,7,12,23,6,35,12.653318903318903,61,75
"['0001001', '10110', '0100100', '1111']",1,4,12,11,2,23,3.1955266955266954,21,11
"['0100010', '0010', '011000']",1,3,12,5,0,17,2.0965034965034963,8,17
"['1001001', '0001110', '101000']",1,3,12,8,2,20,1.8021978021978022,10,7
"['0', '111110', '01101', '1001']",1,4,6,10,0,16,2.408946608946609,21,11
"['0111', '0100', '001000']",1,3,9,5,2,14,1.7000000000000002,8,11
"['1000100', '111111', '10', '0101', '0000110']",1,5,13,13,2,26,4.626134976134976,41,21
"['0101110', '111', '10001', '110011', '00', '00010']",1,6,14,14,2,28,7.625413475413476,49,31
"['1011101', '1', '0100', '00011']",1,4,8,9,0,17,2.473232323232323,24,11
"['0011011', '11111', '000', '00011']",1,4,9,11,2,20,3.083333333333333,19,23
"['0010000', '100100', '1000111', '100010', '00', '11101']",1,6,20,13,4,33,8.272838272838273,55,44
"['101', '00', '0101']",1,3,5,4,0,9,1.9238095238095236,5,6
"['11010', '101', '1000110', '10001', '0000', '001100']",1,6,18,12,2,30,9.443833943833944,43,38
"['1000', '10001', '010', '11']",1,4,8,6,0,14,3.265079365079365,14,13
"['0100110', '10', '000000', '011000']",1,4,15,6,2,21,2.7713675213675213,22,24
"['00101', '00111', '11111', '1110110', '110']",1,5,8,17,3,25,5.733333333333333,29,38
"['100001', '001000', '0010011', '0111', '00010']",1,5,18,10,2,28,5.9623931623931625,30,28
"['111000', '1', '1100101']",1,3,6,8,0,14,1.304945054945055,14,9
"['011010', '110', '000', '1101010']",1,4,10,9,2,19,3.635897435897436,18,21
"['0111001', '10110', '10000', '1000', '111110', '010111', '000', '110', '011000']",1,9,23,22,7,45,20.977056277056278,107,112
"['00000', '1001', '0000101', '10100', '110']",1,5,16,8,2,24,5.1113275613275615,30,29
"['01', '10001', '010000', '111']",1,4,9,7,0,16,2.920923520923521,19,12
"['0010001', '01', '101001']",1,3,9,6,0,15,1.7136752136752138,11,10
"['010000', '10001', '100110', '0100100', '1001001', '110']",1,6,21,13,4,34,9.966389166389167,40,41
"['110110', '001', '0100111', '000101', '10000']",1,5,15,12,2,27,5.714607614607615,33,26
"['0', '11010', '0111001', '1001', '0111100']",1,5,11,13,2,24,5.363203463203463,38,24
"['0', '1101', '001010']",1,3,6,5,0,11,1.2857142857142856,11,4
"['111100', '00', '01001', '0101', '111001']",1,5,11,12,2,23,6.033044733044733,29,29
"['01', '001', '1010', '000000', '01000']",1,5,15,5,0,20,5.416089466089466,28,31
"['00111', '0011', '010110']",1,3,7,8,0,15,2.416161616161616,5,10
"['011', '11', '100', '000001', '000010', '0100']",1,6,16,8,4,24,7.406349206349207,46,40
"['1001000', '1010001', '000110', '101']",1,4,14,9,2,23,3.7323565323565324,21,17
"['01', '1010110', '0001110', '1111110', '000', '1100011', '01011']",1,7,17,21,4,38,11.384126984126985,78,58
"['10111', '10010', '0100110', '01000']",1,4,12,10,3,22,4.133333333333334,15,15
"['1000100', '111', '000000']",1,3,11,5,0,16,1.1692307692307693,13,6
"['11010', '101101', '11000', '1010100', '010010', '011101', '0111']",1,7,18,21,5,39,13.82090132090132,55,57
"['11001', '110110', '0010111', '0011010', '00', '00110', '011001', '01001']",1,8,22,21,7,43,17.811632811632812,84,90
"['1', '00111', '0010011', '10', '1001100']",1,5,11,11,2,22,4.722222222222222,40,26
"['101100', '1010110', '0100010', '1001', '01111', '100010', '00', '0110110']",1,8,23,21,5,44,16.965989565989567,88,83
"['1001', '110011', '00110', '010101', '1110']",1,5,11,14,4,25,6.554545454545455,27,23
"['110110', '001', '111', '00000', '11000', '1101110', '1100', '01011']",1,8,18,20,5,38,15.200277500277501,81,96
"['11110', '0011', '1000111', '0000101', '00', '011111', '011010', '01011']",1,8,19,23,6,42,15.769524919524919,89,79
"['11', '100', '0110011']",1,3,5,7,0,12,1.4444444444444444,11,8
"['01111', '1110', '11']",1,3,2,9,0,11,1.9047619047619047,7,12
"['101', '1', '1110000']",1,3,5,6,0,11,1.15,13,8
"['00100', '00', '1011']",1,3,7,4,0,11,1.349206349206349,9,8
"['0010', '010', '011', '00111', '1110101']",1,5,10,12,2,22,6.257359307359307,27,27
"['111', '000', '000010', '0100011', '01110']",1,5,14,10,2,24,4.953574203574203,33,28
"['100', '1', '00001']",1,3,6,3,0,9,1.3333333333333333,9,7
"['0', '1000', '1010111', '0110']",1,4,8,8,2,16,2.6409090909090907,23,11
"['0110111', '0110', '10']",1,3,5,8,0,13,1.8383838383838382,10,10
"['01', '010', '11', '00011', '1110']",1,5,7,9,2,16,5.358730158730158,24,25
"['100', '101', '1110011', '100011']",1,4,8,11,2,19,3.9692307692307693,17,26
"['101000', '100', '1', '000110']",1,4,10,6,2,16,2.6825396825396823,23,15
"['0', '11100', '11']",1,3,3,5,0,8,0.9047619047619047,9,6
"['01101', '011010', '1', '011000']",1,4,9,9,2,18,3.3744588744588744,18,20
"['0111000', '01', '111', '100110', '111001']",1,5,10,14,2,24,5.6068376068376065,35,24
"['01101', '11', '1000010', '10', '10011']",1,5,10,11,4,21,5.4412698412698415,33,29
"['0101110', '11000', '100', '01111']",1,4,9,11,2,20,3.1666666666666665,20,15
"['101', '11010', '1', '0110011']",1,4,6,10,0,16,3.1,21,15
"['1110101', '001', '100']",1,3,6,7,2,13,1.6666666666666665,10,8
"['001', '1', '10110', '000011']",1,4,8,7,0,15,2.831168831168831,21,13
"['0010', '010101', '0110', '010111']",1,4,10,10,4,20,4.183333333333334,12,20
"['01001', '1', '010010']",1,3,7,5,0,12,1.528138528138528,10,8
"['0011111', '0000100', '000001', '1']",1,4,13,8,2,21,2.4450549450549453,27,17
"['10110', '111010', '000010', '111011']",1,4,10,13,3,23,3.484848484848485,16,19
"['1000010', '00', '010011', '0001']",1,4,13,6,0,19,3.753768453768454,19,14
"['011', '1001', '00110', '1100101', '010110', '001100']",1,6,16,15,2,31,10.397652347652347,42,37
"['11011', '001', '00101', '111', '0000000', '00110']",1,6,16,12,5,28,7.65,51,43
"['010100', '1101011', '1111000', '010010', '100111', '000', '1101']",1,7,19,20,5,39,11.811066711066712,70,57
"['011101', '11110', '10011', '0100100']",1,4,10,13,2,23,3.2881118881118883,19,12
"['111100', '1', '101101']",1,3,4,9,2,13,1.2380952380952381,12,8
"['11', '011011', '101011', '00', '1011', '0100']",1,6,10,14,6,24,8.133333333333333,43,46
"['011011', '11101', '0111', '0000']",1,4,8,11,2,19,3.066161616161616,17,16
"['0', '01', '010110', '110101']",1,4,7,8,2,15,2.9047619047619047,22,12
"['0111111', '000011', '100010']",1,3,9,10,2,19,1.435897435897436,11,7
"['01', '0010', '00011']",1,3,7,4,0,11,1.9047619047619047,7,7
"['101', '10100', '1011', '000000']",1,4,11,7,0,18,3.0596681096681095,18,18
"['01', '10100', '011', '11']",1,4,5,7,2,12,3.742857142857143,12,15
"['0010001', '111', '00001', '11000', '101', '110101']",1,6,15,14,4,29,8.356293706293707,45,55
"['00', '001', '0111']",1,3,5,4,0,9,1.7047619047619047,6,8
"['0', '010101', '01111', '1011100']",1,4,8,11,0,19,2.8783716283716285,23,13
"['0011', '001', '0011010']",1,3,8,6,0,14,2.1844155844155844,8,13
"['1000011', '100', '10', '11']",1,4,7,7,2,14,3.188888888888889,18,20
"['101', '1101000', '10110', '111110', '011110', '1100111', '1100']",1,7,14,24,4,38,12.757503607503608,63,65
"['1100011', '1000', '001', '000000']",1,4,14,6,0,20,3.4046842046842047,20,17
"['1110111', '0111010', '010', '11', '10110', '10000', '1010', '10011', '001011']",1,9,19,25,5,44,21.195609945609945,110,102
"['001', '1', '101101', '000101', '10010']",1,5,11,10,2,21,5.22041847041847,30,28
"['1101001', '1110010', '1101101', '01111', '1101', '01000']",1,6,14,21,5,35,9.732611832611832,44,53
"['11100', '1001', '100']",1,3,6,6,0,12,2.2738095238095237,6,10
"['1001110', '110010', '00111', '0100', '0001101', '0000011', '01010', '1011011', '01011', '111001']",1,10,29,30,9,59,27.935464535464536,138,126
"['1110001', '01110', '0110011']",1,3,8,11,2,19,2.0476190476190474,9,7
"['0010', '0101000', '11110', '111', '101', '0010011', '1100', '01011', '0100']",1,9,21,21,9,42,20.63809523809524,101,106
"['011011', '011001', '10010', '00001']",1,4,12,10,4,22,3.796969696969697,15,17
"['010', '0100110', '00100', '0001', '000', '111000', '0110001']",1,7,23,12,4,35,13.495726495726496,61,80
"['1100010', '10', '011']",1,3,6,6,0,12,1.2444444444444445,12,8
"['11000', '01', '1']",1,3,4,4,0,8,1.2857142857142856,9,6
"['0100010', '11000', '110']",1,3,9,6,0,15,1.8166666666666667,9,9
"['0', '11010', '10001', '1010', '000111', '1100']",1,6,13,12,4,25,8.286219336219336,46,37
"['0000111', '010000', '110']",1,3,10,6,0,16,1.45982905982906,13,10
"['01111', '010110', '11']",1,3,4,9,0,13,1.6168831168831168,9,7
"['11010', '110', '11']",1,3,3,7,0,10,2.1214285714285714,6,13
"['1110101', '011', '10']",1,3,4,8,0,12,1.2444444444444445,11,7
"['00010', '1', '1101110']",1,3,6,7,0,13,1.0833333333333333,14,5
"['1101', '010', '001', '110']",1,4,6,7,3,13,3.6666666666666665,11,14
"['0101111', '001', '001101', '0011001', '1101100', '01010', '0000', '01000']",1,8,25,19,5,44,17.085880785880786,83,101
"['10111', '10101', '1100', '1']",1,4,5,10,2,15,2.977777777777778,17,21
"['10111', '010101', '110', '10011']",1,4,7,12,2,19,3.517171717171717,15,18
"['01', '11', '0010011', '100010', '0110110']",1,5,12,12,4,24,4.937118437118437,38,22
"['0011', '100111', '110111', '1011100']",1,4,8,15,2,23,4.317249417249418,16,23
"['101', '00010', '00011']",1,3,8,5,2,13,1.8,7,7
"['010', '00', '10', '1001011', '0111100']",1,5,11,10,4,21,5.506349206349206,36,25
"['1', '111010', '0000']",1,3,6,5,0,11,0.6857142857142857,13,4
"['01', '1101', '10001', '000']",1,4,8,6,0,14,3.34047619047619,14,13
"['000011', '1', '1000111']",1,3,7,7,0,14,1.304945054945055,13,9
"['00010', '1001', '100', '00000']",1,4,13,4,2,17,3.768253968253968,13,19
"['101011', '0110010', '110']",1,3,7,9,0,16,1.6598290598290597,11,6
"['0', '001110', '110111']",1,3,5,8,2,13,1.2380952380952381,13,4
"['1101001', '10', '011']",1,3,5,7,0,12,1.2444444444444445,11,7
"['00110', '00', '010', '011']",1,4,8,5,2,13,3.9380952380952383,11,22
"['0010000', '00001', '11', '110011', '0110011']",1,5,15,12,2,27,5.144355644355644,36,34
"['00', '10010', '1']",1,3,5,3,0,8,0.9047619047619047,9,4
"['0101', '1101101', '00001']",1,3,8,8,0,16,1.323232323232323,9,10
"['001', '011', '11', '00', '000001', '1010010']",1,6,14,9,4,23,7.6320512820512825,46,37
"['10111', '11000', '10']",1,3,5,7,2,12,1.5428571428571427,10,8
"['110011', '1', '0000']",1,3,6,5,0,11,0.6857142857142857,13,4
"['0011010', '0011000', '00001']",1,3,13,6,2,19,1.8571428571428572,7,17
"['00', '1110', '111011']",1,3,4,8,0,12,1.3833333333333333,10,8
"['01', '00001', '10111', '1001000', '0001101', '100011', '0001000', '1110']",1,8,25,18,5,43,15.035209235209235,94,87
"['1010110', '001001', '110010']",1,3,10,9,2,19,1.8974358974358974,8,7
"['101011', '0001', '010']",1,3,7,6,0,13,1.638095238095238,8,4
"['11', '1011110', '1000110', '1100110', '000010', '0100']",1,6,17,16,3,33,8.13105228105228,53,43
"['01111', '10', '000010']",1,3,7,6,0,13,1.1493506493506493,12,7
"['0', '111100', '10100', '0011011', '01100']",1,5,12,12,2,24,5.085131535131535,36,33
"['0100111', '10', '11111']",1,3,4,10,0,14,1.2301587301587302,12,10
"['10111', '111', '000']",1,3,4,7,2,11,1.0,9,8
"['110110', '111', '101', '00', '10011', '1110']",1,6,8,15,2,23,8.255050505050505,36,44
"['111', '11000', '101', '0111', '00010']",1,5,9,11,4,20,5.334126984126984,27,27
"['00001', '1001', '00', '100111', '10011', '011010', '110']",1,7,16,15,4,31,12.227922077922077,58,56
"['101111', '1101101', '1', '000000']",1,4,9,11,2,20,1.7793040293040294,29,13
"['101', '0110001', '1110']",1,3,6,8,0,14,1.7168831168831167,10,7
"['10101', '1', '0010']",1,3,5,5,0,10,1.4,9,4
"['0101010', '010', '00011']",1,3,9,6,0,15,1.6,10,12
"['10101', '01001', '000']",1,3,8,5,2,13,1.8,7,5
"['0010', '01101', '1']",1,3,5,5,0,10,1.4,9,4
"['0111010', '010010', '111111', '1000', '10', '000', '1100']",1,7,16,16,4,32,11.055999555999556,67,57
"['1101', '1', '0011010', '0111100']",1,4,8,11,2,19,2.8870129870129873,25,9
"['1', '1001', '0010101', '1101', '110101']",1,5,9,13,2,22,5.545854145854146,30,46
"['01', '11110', '0011001', '11000', '11111', '0110010']",1,6,13,18,5,31,7.9031746031746035,50,41
"['11', '1100000', '1100011', '001001', '111101']",1,5,13,15,4,28,5.09035409035409,38,44
"['110011', '1000', '001011', '011000']",1,4,12,10,3,22,3.6333333333333333,18,18
"['0', '0110', '0110111']",1,3,5,7,0,12,1.3772727272727274,12,11
"['0010110', '101', '100', '1011001']",1,4,10,10,4,20,3.5809523809523807,21,16
"['0', '111', '10111', '00110', '1010']",1,5,7,11,2,18,4.821428571428571,27,23
"['001100', '111', '000']",1,3,7,5,2,12,1.1111111111111112,10,8
"['010', '10000', '01000', '111']",1,4,10,6,4,16,2.8833333333333333,17,14
"['01', '0000001', '1100100']",1,3,11,5,2,16,1.3174603174603174,14,8
"['0001101', '1011011', '000101']",1,3,10,10,2,20,2.098901098901099,7,11
"['001', '11011', '1001', '1111', '0101']",1,5,7,13,3,20,6.186507936507937,19,34
"['0', '11000', '111110', '100']",1,4,7,8,0,15,2.8589466089466087,20,14
"['1', '10110', '010110', '0111101', '111001']",1,5,9,16,2,25,5.342407592407592,35,24
"['01', '010001', '1111101', '10100', '100000', '0011100']",1,6,18,15,4,33,7.58011433011433,57,39
"['01001', '010', '1111110']",1,3,6,9,0,15,1.4833333333333334,12,9
"['11', '10111', '11000', '1001', '010110']",1,5,9,13,2,22,5.915584415584416,28,26
"['1010', '100', '0000000', '110001']",1,4,14,6,0,20,3.3489843489843487,21,13
"['001', '011', '101', '0001101', '00', '11101', '0011111', '0101', '01110']",1,9,17,22,7,39,21.985425685425685,99,103
"['110110', '1101', '00', '1']",1,4,5,8,0,13,2.3190476190476192,19,13
"['0', '0101', '10110', '111']",1,4,5,8,0,13,2.4714285714285715,17,10
"['0', '11000', '01', '1011001']",1,4,8,7,0,15,2.6468253968253967,23,11
"['011100', '11000', '10110', '1101', '1011', '01001']",1,6,13,16,5,29,9.931818181818182,38,38
"['001', '001110', '000']",1,3,8,4,2,12,2.0,7,14
"['1110101', '001', '000']",1,3,7,6,2,13,1.4666666666666668,10,7
"['0', '001', '1001100']",1,3,7,4,0,11,1.35,12,7
"['1110101', '101000', '01', '000']",1,4,10,8,0,18,3.0264957264957264,22,15
"['1000010', '01101', '10000', '00111']",1,4,13,9,3,22,3.4333333333333336,20,17
"['0110101', '10', '111']",1,3,4,8,0,12,1.4444444444444444,11,6
"['110110', '00', '010111']",1,3,6,8,2,14,1.6666666666666665,10,7
"['111', '1001', '0110', '0111111', '001110']",1,5,8,16,2,24,5.8339993339993335,32,24
"['1010', '11100', '00000']",1,3,9,5,2,14,1.511111111111111,8,8
"['1110111', '0011000', '1101110']",1,3,8,13,3,21,1.857142857142857,11,6
"['0', '1010', '110111']",1,3,4,7,0,11,1.2857142857142856,11,4
"['011', '00100', '1001000', '100110', '100101', '01110', '110', '101111']",1,8,20,21,7,41,16.925252525252525,78,78
"['11001', '01', '1100', '000']",1,4,8,6,0,14,3.265079365079365,14,16
"['010111', '0011000', '00011']",1,3,10,8,0,18,2.0093240093240095,10,10
"['101010', '00100', '0111']",1,3,8,7,0,15,1.7717171717171718,8,6
"['01', '011', '100', '10110', '000']",1,5,9,7,3,16,5.504761904761905,21,24
"['11111', '00', '00011']",1,3,5,7,2,12,0.9714285714285714,11,8
"['01', '110101', '11111']",1,3,3,10,0,13,1.512987012987013,10,11
"['01', '001111', '0010101', '1000', '000001', '00010']",1,6,19,11,2,30,8.231490731490732,47,47
"['101110', '101', '10', '0011010']",1,4,8,10,0,18,3.6264957264957265,19,17
"['1100111', '1', '000000']",1,3,8,6,0,14,0.5576923076923077,17,4
"['1011', '11', '011001']",1,3,4,8,0,12,1.7666666666666666,9,10
"['01', '10111', '100', '0011110', '00', '011110', '011010']",1,7,14,17,4,31,11.922177822177822,65,63
"['01101', '000101', '100110', '11101', '1010000']",1,5,15,14,4,29,6.424708624708625,30,30
"['1111010', '10100', '00', '10']",1,4,8,8,2,16,3.198412698412698,20,16
"['0010', '00101', '101011', '1011101', '1011100', '000', '1100']",1,7,18,18,4,36,12.453352203352203,61,68
"['00111', '10111', '0101100', '1111']",1,4,7,14,2,21,3.83030303030303,14,22
"['100001', '101', '00', '111110', '101001']",1,5,11,12,3,23,4.761111111111111,35,28
"['1011', '0100111', '001011', '01000']",1,4,11,11,0,22,3.953069153069153,17,19
"['01101', '10', '0011100']",1,3,7,7,0,14,1.6825396825396823,11,6
"['01', '1111110', '000', '000010']",1,4,10,8,0,18,2.2965811965811964,26,19
"['100001', '00101', '101', '1000110', '10']",1,5,13,10,0,23,6.313891663891663,30,35
"['0110101', '1100101', '10']",1,3,7,9,2,16,1.746031746031746,12,9
"['0', '101', '1011011']",1,3,4,7,0,11,1.35,12,6
"['01', '111010', '00001']",1,3,7,6,0,13,1.435064935064935,11,7
"['0', '001101', '111', '010101', '001011', '01000']",1,6,14,13,3,27,7.36976911976912,49,38
"['0001', '0101', '111', '00000']",1,4,10,6,2,16,2.4682539682539684,16,15
"['0110101', '010', '111110']",1,3,6,10,0,16,1.505982905982906,11,8
"['0', '101', '0001', '00110', '011111', '01001']",1,6,12,12,2,24,7.764718614718614,45,34
"['010', '011', '0010100', '0101', '1111011']",1,5,11,13,4,24,6.282251082251082,32,25
"['1010110', '111', '111001']",1,3,5,11,0,16,1.682051282051282,10,12
"['01', '110010', '100001', '0011', '100101']",1,5,13,11,3,24,6.5,28,28
"['001', '0101110', '0110', '1010', '0111', '00010', '011010']",1,7,17,16,3,33,13.175319125319126,50,80
"['000110', '001', '1110', '0011001', '1000011', '0110001', '110101']",1,7,21,19,5,40,12.801920301920301,70,58
"['101', '00', '1000101']",1,3,7,5,0,12,1.4444444444444444,11,7
"['0', '10111', '1011101', '1001111']",1,4,6,14,2,20,3.357142857142857,22,20
"['0100111', '110', '000000']",1,3,10,6,0,16,0.9299145299145299,14,7
"['0', '101', '100', '1110']",1,4,5,6,2,11,3.2095238095238097,12,11
"['010001', '001', '10', '101111']",1,4,8,9,2,17,3.011111111111111,21,15
"['11011', '0101', '10']",1,3,4,7,0,11,1.9047619047619047,7,6
"['01001', '0011101', '0110', '10']",1,4,9,9,0,18,3.5764790764790764,18,15
"['00', '010', '1101']",1,3,5,4,0,9,1.7047619047619047,6,4
"['110011', '10100', '100']",1,3,7,7,0,14,2.143939393939394,8,9
"['10111', '01', '1100', '10']",1,4,5,8,2,13,3.087301587301587,16,14
"['11001', '0100110', '111', '00001', '1010', '000', '001001']",1,7,19,14,4,33,11.735825285825285,59,55
"['1000100', '01101', '0110111', '001000', '00110', '10010', '1000011', '1100']",1,8,26,20,6,46,17.687279387279386,88,80
"['11001', '0', '0101101', '1010', '1101', '01110']",1,6,11,15,4,26,8.33939393939394,45,35
"['010', '010111', '10', '110', '111001']",1,5,8,12,4,20,5.988888888888889,29,27
"['1100001', '11010', '0101011', '0001']",1,4,12,11,2,23,3.154401154401154,18,19
"['010', '000011', '100', '1111', '1110101', '1011', '010011']",1,7,14,19,6,33,11.867976467976469,61,66
"['101', '0011010', '1111']",1,3,5,9,0,14,1.7168831168831167,10,4
"['01001', '01', '00', '110111']",1,4,7,8,2,15,2.938311688311688,19,12
"['11001', '10101', '111', '01000']",1,4,8,10,3,18,3.75,15,15
"['011111', '0011', '111100', '0111100']",1,4,8,15,2,23,3.9044289044289044,17,28
"['100', '1001', '101101', '0100']",1,4,9,8,2,17,4.530952380952381,12,17
"['101000', '001001', '101']",1,3,9,6,2,15,1.7777777777777777,8,10
"['000011', '011011', '100', '1110001', '110']",1,5,12,13,4,25,5.597435897435897,34,28
"['0', '001110', '0000100']",1,3,10,4,0,14,1.151098901098901,14,14
"['10010', '011', '0011100', '1101100']",1,4,11,11,2,22,3.414285714285714,21,17
"['0', '01011', '11']",1,3,3,5,0,8,0.9047619047619047,9,6
"['10', '0011111', '110101']",1,3,5,10,0,15,1.1837606837606838,14,7
"['0001000', '01', '000011', '11']",1,4,11,6,2,17,2.782051282051282,23,16
"['0111011', '00100', '0110', '10010', '000010', '1001001', '101001']",1,7,23,17,6,40,14.035298035298036,58,57
"['00111', '111000', '100111']",1,3,7,10,2,17,1.9545454545454546,11,15
"['01', '1011001', '000', '1111']",1,4,7,9,0,16,2.1232323232323234,21,11
"['0', '0001100', '000100', '0100110']",1,4,15,6,2,21,3.1813186813186816,22,31
"['0010', '00', '0000011']",1,3,10,3,0,13,1.6565656565656566,11,13
"['001', '10010', '011']",1,3,6,5,2,11,1.9166666666666665,6,6
"['0010', '010', '011', '010111', '100111', '0111100']",1,6,13,16,4,29,9.367421467421467,44,46
"['11001', '0001', '0010111', '1100']",1,4,10,10,2,20,3.4646464646464645,18,22
"['0', '01101', '010010']",1,3,7,5,0,12,1.3463203463203464,11,9
"['001', '0110', '1111', '10', '000100']",1,5,10,9,2,19,4.723809523809524,29,21
"['01', '00', '0000001']",1,3,9,2,2,11,1.3888888888888888,11,9
"['0011', '001101', '010110', '11']",1,4,8,10,2,18,4.1,16,15
"['010', '010001', '011010']",1,3,9,6,2,15,1.8333333333333333,9,14
"['1110010', '1', '10']",1,3,4,6,0,10,1.3611111111111112,12,7
"['11000', '1100', '0101011']",1,3,8,8,0,16,1.5858585858585859,9,12
"['1100', '01010', '1001101']",1,3,8,8,0,16,1.8787878787878787,10,4
"['1111101', '11', '1010111', '01011', '0001000']",1,5,11,17,3,28,4.658730158730158,42,30
"['0', '011010', '11']",1,3,4,5,0,9,0.7857142857142857,11,4
"['01', '1010010', '0000']",1,3,9,4,0,13,1.323232323232323,11,6
"['1101100', '00110', '000001', '000', '1010001', '1110']",1,6,19,13,2,32,7.981468531468531,50,45
"['00', '100111', '10011']",1,3,6,7,0,13,1.9805194805194803,8,9
"['0', '10100', '0111101', '0011000']",1,4,11,9,2,20,2.571428571428571,26,16
"['001', '1', '10000']",1,3,6,3,0,9,1.3333333333333333,9,7
"['10101', '101', '0010', '110']",1,4,7,8,2,15,3.7261904761904763,12,15
"['01101', '1000110', '000001', '000', '01001']",1,5,17,9,2,26,6.106293706293706,29,29
"['0100001', '1101001', '00110']",1,3,11,8,2,19,1.7142857142857144,10,6
"['110010', '1', '01100', '001000']",1,4,11,7,2,18,3.0259740259740258,22,12
"['01', '0111011', '110010', '11']",1,4,6,11,2,17,3.0042735042735043,22,18
"['010', '00001', '11000', '1111', '0101']",1,5,11,10,4,21,4.798412698412698,27,25
"['0001', '0110001', '100010']",1,3,11,6,0,17,2.2965034965034965,8,9
"['10100', '100100', '010']",1,3,9,5,0,14,2.3257575757575757,6,10
"['0', '011011', '00110', '1010', '0111101']",1,5,10,13,0,23,5.244338994338994,35,25
"['001', '111', '111110']",1,3,3,9,2,12,1.222222222222222,10,10
"['011011', '1001', '000101', '0110000', '1101']",1,5,14,13,4,27,6.138344988344988,30,28
"['11000', '100111', '01010', '1101', '0100011']",1,5,13,14,2,27,6.0904428904428904,29,27
"['00100', '1101011', '11111']",1,3,6,11,2,17,1.3666666666666667,10,8
"['011111', '001', '10110', '1']",1,4,5,10,0,15,2.6089466089466087,21,12
"['101', '0000110', '1100', '10']",1,4,9,7,0,16,3.427994227994228,20,13
"['001010', '0110', '1110']",1,3,7,7,2,14,1.9500000000000002,6,12
"['0101101', '101', '00', '01011']",1,4,8,9,0,17,3.5992063492063493,18,16
"['101010', '010111', '1100011', '01000', '110101']",1,5,14,16,3,30,6.651515151515151,26,26
"['010100', '1110000', '111', '1100001', '1011', '1101', '110']",1,7,15,19,6,34,12.8506105006105,61,73
"['0', '111010', '0110', '10010', '010110', '0111']",1,6,12,14,4,26,8.105266955266956,43,51
"['1111101', '011', '111']",1,3,2,11,2,13,1.6666666666666665,10,15
"['01', '001', '100001', '00011']",1,4,10,6,0,16,4.0153679653679655,15,17
"['101', '0101000', '0111']",1,3,7,7,0,14,1.7168831168831167,10,5
"['01101', '010', '001', '0001', '110011', '1010001']",1,6,15,13,2,28,9.242751692751693,40,40
"['010', '1000101', '1']",1,3,6,5,0,11,1.35,12,4
"['01', '00000', '111011', '1010', '1110110', '001001']",1,6,15,15,2,30,7.895582195582196,51,38
"['101', '11101', '1011', '1111']",1,4,3,13,2,16,4.234126984126984,9,35
"['01', '001', '011', '000', '11111']",1,5,7,9,3,16,4.7023809523809526,24,24
"['1111', '011', '0010011']",1,3,5,9,0,14,1.535064935064935,10,12
"['010', '100011', '111100']",1,3,7,8,2,15,1.3888888888888888,13,5
"['0', '1100111', '001']",1,3,5,6,0,11,1.35,12,4
"['0000111', '0011011', '111111', '10']",1,4,8,14,2,22,2.707875457875458,26,20
"['00100', '101', '11111', '0010010', '01100']",1,5,13,12,3,25,5.333333333333333,31,25
"['0010', '010001', '00011', '01111', '000']",1,5,14,9,2,23,6.107647907647907,25,31
"['0', '101110', '00001']",1,3,7,5,0,12,0.9826839826839826,13,6
"['1000', '0100110', '1110000']",1,3,11,7,2,18,2.025974025974026,10,8
"['1011110', '1101', '1001000']",1,3,8,10,2,18,1.6623376623376622,11,7
"['1000000', '0001010', '1001']",1,3,13,5,2,18,1.8051948051948052,11,8
"['10111', '1010', '0001', '01100']",1,4,9,9,4,18,3.322222222222222,17,13
"['110000', '1000', '010010']",1,3,11,5,2,16,2.2666666666666666,6,8
"['110000', '0110', '0001000']",1,3,12,5,0,17,1.760839160839161,11,12
"['0011101', '1001', '1111001', '00', '00010', '110']",1,6,14,14,2,28,8.618759018759018,50,38
"['010100', '010000', '11', '1010100', '1011', '111101']",1,6,15,16,3,31,8.188383838383839,47,42
"['10100', '10', '000']",1,3,7,3,0,10,1.4714285714285715,7,9
"['01', '110001', '0001100', '110', '0111110']",1,5,12,13,2,25,5.303907203907204,40,24
"['0001', '00010', '1', '10110']",1,4,9,6,2,15,3.0,17,14
"['0', '111100', '1100001', '100', '0011111', '1110']",1,6,12,16,2,28,7.474059274059274,60,42
"['1000', '100011', '10011', '000', '1011', '00010']",1,6,16,11,4,27,10.062554112554112,31,53
"['1001110', '1', '10']",1,3,4,6,0,10,1.3611111111111112,12,8
"['0011111', '0101', '111']",1,3,4,10,0,14,1.7168831168831167,10,10
"['0', '01001', '01000', '1111']",1,4,8,7,2,15,2.1333333333333333,20,13
"['011', '00110', '1010', '0000', '01011', '1011111']",1,6,13,15,4,28,8.595526695526695,43,38
"['101100', '00', '0110', '01100']",1,4,10,7,0,17,4.3360750360750355,13,29
"['1010001', '0101000', '0110110']",1,3,12,9,3,21,2.142857142857143,9,5
"['1110111', '1010001', '010', '100']",1,4,9,11,4,20,3.238095238095238,23,11
"['0010110', '11010', '00', '001110']",1,4,11,9,0,20,3.484404484404484,19,28
"['11100', '110111', '01110']",1,3,5,11,2,16,2.0727272727272728,8,7
"['01', '1010', '00', '1110110']",1,4,7,8,2,15,3.4494949494949494,18,13
"['010', '0011', '111111', '1100101', '10', '101111']",1,6,9,19,2,28,7.636735486735486,50,45
"['101', '1', '0100']",1,3,4,4,0,8,1.4714285714285715,7,4
"['00011', '10101', '00', '0101100', '101110']",1,5,13,12,2,25,6.062592962592962,31,25
"['00011', '001', '11111']",1,3,5,8,2,13,1.4,9,9
"['10111', '0110010', '0000000']",1,3,12,7,2,19,1.2619047619047619,13,4
"['1000110', '10001', '0110100']",1,3,11,8,2,19,1.9047619047619047,10,8
"['110011', '111010', '10011']",1,3,6,11,2,17,1.9393939393939394,6,16
"['0', '1100', '10011', '011110']",1,4,7,9,0,16,2.831168831168831,22,11
"['0001', '110', '0111']",1,3,5,6,2,11,1.3571428571428572,7,7
"['1110111', '1111', '001010', '1100110', '000']",1,5,11,16,2,27,5.2662670662670665,36,31
"['01', '001011', '0000100', '11']",1,4,10,7,2,17,2.782051282051282,23,14
"['1010', '0000001', '1111011']",1,3,9,9,2,18,1.1948051948051948,14,6
"['001111', '000101', '0010100', '1001101', '000']",1,5,17,12,4,29,6.615140415140415,29,36
"['10001', '1001', '110']",1,3,6,6,0,12,1.9603174603174602,6,12
"['01', '101010', '1111', '1000', '101110']",1,5,9,13,4,22,5.35,28,25
"['0', '10001', '1111']",1,3,4,6,0,10,0.7777777777777777,11,4
"['11110', '11111', '00', '010110', '01110', '1010011', '110', '01000', '0110011']",1,9,19,26,6,45,19.904673104673105,108,114
"['110111', '001', '111']",1,3,3,9,2,12,1.4444444444444444,9,14
"['1000011', '001001', '0110', '000']",1,4,13,7,0,20,3.5989343989343987,20,12
"['11', '1001', '1101100', '10010', '10']",1,5,9,11,2,20,5.799422799422799,29,30
"['010101', '10', '1001']",1,3,6,6,0,12,1.5666666666666667,8,8
"['01101', '010000', '1', '0011110', '000', '01001', '101110']",1,7,18,15,4,33,10.442096792096791,73,58
"['0000010', '100101', '0110100', '0110']",1,4,15,9,2,24,3.321078921078921,20,17
"['11', '1001', '010110', '111110']",1,4,6,12,2,18,3.333333333333333,19,14
"['0', '111010', '1110']",1,3,4,7,0,11,1.4857142857142858,10,10
"['00111', '0001', '100100', '010111', '10011']",1,5,13,13,4,26,6.542424242424242,24,31
"['0110100', '00111', '10010', '10', '000', '111001']",1,6,15,13,2,28,8.117476967476968,51,37
"['1000100', '001', '1010101', '10110', '01010', '01011', '01000', '110101']",1,8,23,20,6,43,18.337284937284938,70,74
"['01', '010000', '11', '110001', '01000', '1111011']",1,6,14,14,4,28,7.555472305472305,53,43
"['101', '01', '110101', '1111']",1,4,4,11,0,15,3.6714285714285713,15,24
"['00111', '1011101', '1', '000000']",1,4,10,9,0,19,1.9213286713286712,28,12
"['0', '0110', '10', '1110']",1,4,5,6,2,11,3.55,12,18
"['010', '1', '100', '1101110', '00110']",1,5,9,10,2,19,5.2,32,23
"['1100', '100011', '111011']",1,3,6,10,2,16,1.8666666666666667,8,14
"['0001', '100', '1111']",1,3,5,6,2,11,1.1071428571428572,8,7
"['0111001', '11100', '1001']",1,3,7,9,0,16,2.2272727272727275,8,9
"['11001', '10110', '1101110', '0101010', '0110001']",1,5,14,17,5,31,6.957142857142857,28,27
"['0010001', '01', '1000101', '1011101', '0010101']",1,5,16,14,4,30,5.777777777777778,33,40
"['1000100', '011', '1101100', '10', '0111110']",1,5,12,14,3,26,4.476190476190476,40,27
"['0001010', '010', '1', '10000']",1,4,11,5,0,16,2.85,22,14
"['0101000', '1111', '00', '1010010', '110', '01100']",1,6,15,13,2,28,7.692424242424242,50,39
"['0001001', '111100', '101', '100100', '10011', '10']",1,6,15,14,2,29,8.747147297147297,47,46
"['00001', '11110', '11']",1,3,5,7,2,12,1.0571428571428572,12,8
"['10111', '0011110', '110011', '00', '01011']",1,5,10,15,2,25,6.004850704850705,33,24
"['11', '10', '0000']",1,3,5,3,2,8,0.8333333333333333,8,4
"['1110111', '0110111', '1010', '111111', '010110']",1,5,8,22,4,30,6.096769896769897,26,39
"['110010', '111100', '0011', '0111', '110']",1,5,9,14,4,23,6.0928571428571425,29,34
"['00110', '10', '1101010']",1,3,7,7,0,14,1.5158730158730158,11,9
"['0010', '11', '10', '0100100', '0000111']",1,5,13,9,4,22,4.8997113997114,37,24
"['0100001', '100001', '0110100']",1,3,13,7,2,20,1.9560439560439562,8,10
"['010000', '001000', '11', '100110', '010110', '1100110', '000', '001011']",1,8,25,17,5,42,16.916239316239317,89,98
"['0001', '00', '1100101', '1100', '0011100']",1,5,14,10,4,24,5.839105339105339,35,37
"['0', '0010', '1111', '011001', '0111101']",1,5,9,13,2,22,4.427672327672328,36,21
"['0010', '010001', '0011100', '0011', '010111', '0111', '0101', '01100']",1,8,21,19,6,40,19.179059829059828,67,98
"['0010', '1001', '010101']",1,3,8,6,2,14,2.15,6,5
"['011010', '1', '110101']",1,3,5,8,2,13,1.4047619047619047,12,4
"['01', '11', '0101101', '101000', '010010', '100010', '0000010']",1,7,22,14,7,36,11.663614163614163,72,58
"['1101011', '0111', '01010', '010011', '01000', '0100']",1,6,16,15,4,31,10.07024087024087,34,56
"['1', '10100', '1000', '10', '0000010']",1,5,13,6,0,19,5.044660894660894,33,26
"['0110000', '0111010', '1']",1,3,8,7,2,15,1.2142857142857144,14,6
"['11001', '00', '11101', '01000']",1,4,9,8,3,17,3.2285714285714286,16,12
"['0', '0110000', '1001']",1,3,8,4,0,12,1.1954545454545453,13,4
"['01', '010', '1101', '0100']",1,4,7,6,2,13,4.061904761904762,10,15
"['00', '010', '0001']",1,3,7,2,0,9,2.038095238095238,5,10
"['0010', '1110010', '0111', '0111100']",1,4,10,12,4,22,3.5779220779220777,19,23
"['1010000', '1110001', '1001', '1']",1,4,10,9,2,19,2.8870129870129873,24,21
"['10101', '010111', '10', '000']",1,4,8,8,0,16,3.1431457431457432,18,11
"['10', '011100', '11111']",1,3,4,9,0,13,1.331168831168831,11,4
"['0', '011', '1111001', '1011000', '11100']",1,5,10,13,2,23,5.214285714285714,36,23
"['1', '101001', '01110']",1,3,5,7,0,12,0.9826839826839826,13,4
"['100000', '1010', '001010', '011']",1,4,12,7,2,19,3.3603174603174604,18,17
"['0010', '001', '000001', '1110110', '1011111']",1,5,13,14,2,27,5.019713619713619,39,27
"['110011', '1', '000']",1,3,5,5,0,10,0.7301587301587301,12,4
"['101', '01', '1101101', '0100111']",1,4,7,12,2,19,3.6031746031746033,22,20
"['01', '100', '0111111']",1,3,4,8,0,12,1.0444444444444445,13,7
"['110011', '10110', '1110100', '11111']",1,4,7,16,2,23,3.6214452214452213,16,24
"['1111001', '1001000', '10', '1']",1,4,8,9,2,17,2.626984126984127,26,15
"['11001', '00', '111110', '0100101']",1,4,9,11,0,20,2.7856865356865357,23,12
"['01', '11100', '000']",1,3,6,4,0,10,1.1857142857142857,9,8
"['01', '111', '001000', '01001', '1100', '011000']",1,6,15,11,2,26,8.397402597402598,42,41
"['100000', '01', '0110']",1,3,8,4,0,12,1.3166666666666667,11,7
"['010', '0001110', '111100', '101', '10001', '00010', '1100', '01100', '1110']",1,9,22,20,7,42,21.98796758796759,99,104
"['01', '0010', '011', '1001', '1000', '1010000']",1,6,15,9,3,24,8.807864357864357,41,38
"['00110', '10001', '1100']",1,3,8,6,2,14,1.9333333333333331,8,5
"['101', '0111010', '1110', '0000']",1,4,9,9,2,18,2.97987012987013,19,11
"['110110', '011', '0100101', '1110']",1,4,8,12,0,20,3.417116217116217,18,18
"['0111001', '00000', '10', '0111', '0100']",1,5,13,9,2,22,4.684704184704184,32,29
"['01', '010000', '0000000', '1111', '1011', '110101']",1,6,16,13,4,29,6.5271173271173275,56,39
"['110110', '11000', '011000']",1,3,9,8,2,17,2.3030303030303028,6,12
"['01', '010', '001111', '011', '000000', '110']",1,6,13,10,5,23,7.527777777777778,46,41
"['1101', '00101', '000010']",1,3,9,6,0,15,1.793939393939394,8,7
"['0100111', '0011101', '011', '111', '111000', '01100']",1,6,13,18,4,31,9.27959262959263,50,49
"['001', '1101', '0000111', '010011', '1110']",1,5,11,13,2,24,5.533949383949384,33,29
"['1001', '1', '0010101']",1,3,6,6,0,12,1.1954545454545453,12,9
"['0', '1110110', '1101010']",1,3,6,9,2,15,1.3571428571428572,14,8
"['0', '0010', '10110', '010011', '111000']",1,5,12,10,2,22,5.125974025974026,36,25
"['110000', '100', '1', '1111110']",1,4,7,10,0,17,2.5639194139194137,25,14
"['0010110', '1000100', '01', '010', '0011110', '1100100', '0111']",1,7,20,17,4,37,12.683405483405483,75,66
"['011', '00011', '00100', '0011010', '111110', '001001', '101111']",1,7,18,20,5,38,12.346658896658896,63,64
"['0', '010', '000101', '111011']",1,4,8,8,2,16,2.6825396825396823,23,10
"['10101', '111000', '001', '11']",1,4,7,9,0,16,2.961327561327561,18,18
"['0', '01', '000111', '1111']",1,4,5,8,0,13,2.3857142857142857,20,14
"['1001', '100001', '1110', '111011']",1,4,8,12,4,20,3.6,17,26
"['0001001', '00', '1', '011']",1,4,8,5,0,13,2.1944444444444446,21,12
"['10111', '10110', '101011', '010111']",1,4,7,15,4,22,4.724242424242425,9,27
"['0', '1100111', '0101', '1100', '01011', '0100']",1,6,12,13,3,25,8.268181818181818,43,44
"['1010000', '000111', '1011100']",1,3,11,9,2,20,1.7912087912087913,11,12
"['0', '111010', '0011010', '10', '101111']",1,5,9,13,2,22,4.983821733821734,38,27
"['0010001', '100', '10', '11']",1,4,8,6,2,14,3.188888888888889,18,14
"['01', '0101101', '1100011', '110', '0100']",1,5,11,12,2,23,5.571139971139971,35,26
"['0000101', '100111', '1110000', '0']",1,4,12,9,2,21,2.4340659340659343,30,15
"['0011001', '01001', '0']",1,3,8,5,0,13,1.4166666666666667,12,9
"['0101', '010', '1111101', '101011']",1,4,7,13,0,20,3.7308025308025305,18,15
"['100', '1', '1100110']",1,3,5,6,0,11,1.35,12,6
"['1101', '100000', '01011']",1,3,8,7,0,15,1.4303030303030302,10,7
"['110110', '010', '10', '0010101']",1,4,9,9,0,18,3.404273504273504,21,15
"['010', '111100', '101010', '10011', '000111', '1110']",1,6,13,17,3,30,8.371428571428572,47,43
"['0101', '001111', '1', '00011']",1,4,7,9,0,16,3.012987012987013,19,14
"['110011', '101', '011001', '11']",1,4,6,11,2,17,3.966666666666667,17,23
"['0010001', '0101010', '00', '1101110']",1,4,13,10,3,23,3.1904761904761902,25,17
"['1100011', '11010', '0111101', '0']",1,4,8,12,2,20,2.738095238095238,26,13
"['1100111', '00010', '1']",1,3,6,7,0,13,1.0833333333333333,14,4
"['0100101', '001101', '1111111']",1,3,7,13,2,20,1.6593406593406594,10,8
"['11011', '0110111', '00', '100000', '11111']",1,5,10,15,2,25,4.216638916638916,37,30
"['001111', '10', '01100']",1,3,6,7,0,13,1.3668831168831168,11,7
"['001', '111', '101', '10110', '001010']",1,5,9,11,3,20,5.921717171717171,23,24
"['101000', '0001', '11100']",1,3,9,6,0,15,1.7717171717171718,9,10
"['000011', '10111', '10', '000010', '011001', '0111', '110']",1,7,16,16,3,32,12.073665223665223,64,58
"['01101', '100100', '1111110', '00', '10', '01110']",1,6,12,15,4,27,7.635830835830836,51,42
"['111100', '11', '10001', '100101', '10011', '01001', '01011']",1,7,15,19,6,34,13.658441558441558,58,77
"['101001', '1', '1011100', '0110110']",1,4,9,12,2,21,2.8846153846153846,27,12
"['0010', '1', '0001111']",1,3,6,6,0,12,1.1954545454545453,13,5
"['0', '1110001', '100000']",1,3,9,5,0,14,1.151098901098901,14,4
"['1010000', '10', '011']",1,3,7,5,0,12,1.2444444444444445,12,7
"['010', '11101', '11']",1,3,3,7,0,10,1.4714285714285715,8,6
"['10111', '1001', '110100']",1,3,6,9,0,15,1.812121212121212,8,10
"['001', '0101000', '011', '1110010', '101', '01111', '1111110']",1,7,14,21,6,35,11.06904761904762,73,57
"['0', '00010', '0101110']",1,3,8,5,0,13,1.0833333333333333,13,13
"['010', '0011', '10001', '100', '010101', '0000', '000111', '1101010']",1,8,22,16,6,38,17.167493617493616,78,75
"['11011', '10101', '1101101', '01111', '11111']",1,5,6,21,4,27,7.366666666666667,20,54
"['010', '100011', '01011', '01110']",1,4,9,10,2,19,3.817171717171717,16,17
"['00100', '100', '0010101', '100111', '0000', '011111', '01001']",1,7,20,16,4,36,12.587357087357088,61,62
"['00', '001', '001000']",1,3,9,2,0,11,1.9666666666666668,8,17
"['1010', '0010100', '111']",1,3,7,7,0,14,1.6987012987012986,10,4
"['10111', '1101101', '1111', '111000', '01011', '1110']",1,6,9,22,4,31,9.46942501942502,38,66
"['11001', '001', '011101']",1,3,6,8,0,14,1.9217171717171717,7,10
"['01', '0010', '11', '10101', '110011']",1,5,8,11,2,19,5.6367965367965365,28,25
"['1001', '011', '10']",1,3,4,5,0,9,1.638095238095238,6,7
"['110110', '010', '001', '10', '1000011', '011010']",1,6,14,13,4,27,8.22136752136752,50,38
"['01', '100001', '00000', '1010', '0111', '011111', '1100', '0111100']",1,8,19,19,5,38,14.264463314463315,95,80
"['1', '01011', '00000']",1,3,7,4,2,11,0.7333333333333334,12,4
"['01101', '100', '111', '01010']",1,4,7,9,4,16,3.6333333333333333,14,11
"['0010', '1011001', '0011', '1111', '1110001', '10010']",1,6,14,17,5,31,9.145021645021645,44,45
"['0', '1000', '1110111', '111001']",1,4,7,11,0,18,2.6685814185814185,24,15
"['000011', '100100', '00110', '00', '01010', '111101', '0100']",1,7,20,14,5,34,11.944372294372295,64,66
"['010', '111', '011', '00001', '110', '101001']",1,6,11,12,4,23,8.338383838383837,36,37
"['01101', '111', '101010', '11000', '1011111', '10100', '100000', '100101', '000', '0111100']",1,10,26,27,10,53,25.823920523920524,138,132
"['0001100', '10', '1011100', '000010']",1,4,14,8,2,22,3.1800976800976803,22,24
"['111000', '101110', '1111111', '0100']",1,4,8,15,2,23,2.9715617715617717,22,15
"['0', '11010', '010110', '1011111']",1,4,7,12,0,19,2.52988677988678,24,12
"['010100', '0', '0011101', '0011', '1011', '11100']",1,6,13,14,2,27,7.78998778998779,50,41
"['0', '00111', '10000']",1,3,7,4,2,11,1.0666666666666667,12,7
"['0010', '11011', '0101011', '00', '110']",1,5,10,11,0,21,5.341486291486292,29,29
"['0110101', '11', '101', '0011', '110001', '01111']",1,6,10,17,0,27,9.280774780774781,43,51
"['11010', '0100110', '0011', '10001', '0110', '0011100']",1,6,17,15,6,32,9.528932178932179,46,41
"['111010', '0011', '00', '0111101', '111001']",1,5,10,15,2,25,6.028360528360528,34,26
"['0', '00010', '0101']",1,3,7,3,0,10,1.4,9,8
"['111', '000011', '10100', '100011', '0000', '0101']",1,6,16,12,4,28,7.913852813852814,41,46
"['0111000', '101', '100100', '01010']",1,4,12,9,0,21,3.825990675990676,20,13
"['01101', '0111001', '1', '001000', '1001', '110111', '1101010']",1,7,16,20,4,36,11.33948273948274,75,53
"['0', '1011010', '111']",1,3,4,7,0,11,0.85,13,4
"['010001', '1001010', '100', '110011', '0000']",1,5,16,10,2,26,6.283316683316683,29,22
"['01', '10010', '1000111']",1,3,7,7,0,14,1.6825396825396823,11,8
"['1011', '1000', '111']",1,3,4,7,2,11,1.3571428571428572,6,11
"['01', '0101011', '11']",1,3,4,7,2,11,1.3888888888888888,11,9
"['11001', '101101', '0']",1,3,5,7,0,12,1.3463203463203464,11,5
"['01', '11101', '0110']",1,3,4,7,0,11,1.9047619047619047,7,6
"['1111101', '00011', '1001', '10000', '111111', '110']",1,6,11,19,2,30,7.62985902985903,52,56
"['00', '0110', '00101', '000011']",1,4,11,6,0,17,3.732034632034632,17,19
"['0', '1001100', '1111101', '111']",1,4,6,12,2,18,2.071428571428571,26,14
"['101', '00', '11']",1,3,3,4,2,7,1.2000000000000002,5,4
"['0010', '010', '11011', '00011', '100000', '1001011', '111001']",1,7,19,17,4,36,12.397002997002996,62,59
"['0010', '001', '111', '00001', '000101', '1101', '001011']",1,7,17,14,6,31,12.644155844155843,51,68
"['11101', '1', '0101100']",1,3,5,8,0,13,1.25,13,4
"['01', '01001', '0100']",1,3,7,4,0,11,2.126984126984127,6,12
"['00', '0000100', '10']",1,3,9,2,2,11,1.3888888888888888,11,12
"['0', '001010', '101110', '110100']",1,4,10,9,3,19,2.8571428571428568,23,16
"['00010', '01011', '01010', '1110']",1,4,10,9,3,19,3.333333333333333,12,22
"['0001', '0011010', '110011', '10011', '1001011']",1,5,14,15,2,29,6.865567765567765,27,34
"['0110', '1000', '001010', '000', '101001']",1,5,15,8,4,23,6.306349206349206,25,29
"['0010', '100', '0110', '1111', '1001001', '111101']",1,6,12,16,3,28,8.052736152736152,44,37
"['100', '000101', '10', '1']",1,4,7,5,0,12,3.196825396825397,17,14
"['00011', '0011', '1011101', '0010011', '00', '0111', '0011100']",1,7,18,18,5,36,13.067460317460316,65,75
"['10111', '00010', '01101']",1,3,7,8,3,15,1.6,8,4
"['00', '0101', '01111', '011010']",1,4,8,9,0,17,3.4463203463203462,16,18
"['1011', '0010', '0111']",1,3,5,7,3,12,1.75,6,5
"['11110', '10001', '00', '10', '1011']",1,5,8,10,4,18,5.011111111111111,27,23
"['0010001', '000111', '100000']",1,3,13,6,2,19,1.7307692307692308,10,10
"['01', '0101000', '00101', '001000', '11000', '10100', '011111']",1,7,21,15,5,36,12.37884337884338,64,72
"['000110', '11010', '0000']",1,3,10,5,0,15,1.7898989898989899,8,13
"['0010', '001', '11', '0000', '1100']",1,5,11,6,3,17,5.1499999999999995,23,30
"['101000', '0011110', '10']",1,3,8,7,0,15,1.2521367521367521,13,9
"['1101111', '011011', '0011111', '000', '110']",1,5,9,17,4,26,5.297191697191697,37,32
"['0', '011101', '01000', '0101100', '0100101']",1,5,15,11,2,26,5.287212787212788,34,39
"['0011001', '1', '011']",1,3,5,6,0,11,1.35,12,6
"['1010', '0101', '10110']",1,3,6,7,2,13,2.3055555555555554,6,9
"['01', '001', '010110', '101101']",1,4,8,9,2,17,3.522222222222222,17,14
"['0101', '01111', '1']",1,3,3,7,0,10,1.4,9,7
"['00110', '1', '1101011']",1,3,5,8,0,13,1.25,14,4
"['0000', '100100', '011', '1001101']",1,4,12,8,0,20,3.4448440448440447,19,15
"['0001010', '0100', '11']",1,3,8,5,0,13,1.505050505050505,11,5
"['0000110', '01', '1100']",1,3,8,5,0,13,1.323232323232323,13,7
"['0001001', '00', '1001']",1,3,9,4,0,13,1.8383838383838382,10,9
"['11110', '011', '0000']",1,3,6,6,0,12,1.007936507936508,10,7
"['11001', '11000', '100', '01111', '01010', '0100001']",1,6,16,14,4,30,9.2,42,40
"['101', '110001', '110']",1,3,5,7,2,12,2.0,8,11
"['11001', '0101101', '1101101', '100011', '0111', '1001100']",1,6,15,21,3,36,10.446320346320347,43,53
"['01111', '111', '111001']",1,3,3,11,0,14,2.143939393939394,8,18
"['0011', '100', '110', '11']",1,4,5,7,2,12,3.676190476190476,12,18
"['1010', '00011', '001', '11']",1,4,7,7,0,14,3.403968253968254,14,15
"['1', '10111', '000101', '0000000', '1000010', '1100']",1,6,19,11,2,30,6.333605283605284,62,37
"['10111', '01111', '000']",1,3,5,8,2,13,1.3,10,6
"['011011', '100', '110011']",1,3,6,9,2,15,1.6111111111111112,9,9
"['0', '0111101', '10011', '100100']",1,4,9,10,0,19,2.557858807858808,25,13
"['1000010', '01100', '0100']",1,3,11,5,0,16,1.9343434343434343,9,11
"['01000', '100101', '10', '000']",1,4,11,5,0,16,3.4335497835497835,17,15
"['101', '100', '0110', '000']",1,4,8,5,3,13,3.380952380952381,11,13
"['1110011', '001', '10']",1,3,5,7,0,12,1.4444444444444444,11,6
"['11001', '00100', '10110', '111100']",1,4,10,11,3,21,3.8,16,14
"['0100000', '010', '000101', '00110', '10', '110']",1,6,17,9,2,26,9.082461982461982,44,49
"['011', '10111', '101011', '10001', '00']",1,5,9,12,2,21,5.728354978354979,26,28
"['1000100', '011100', '101', '011110', '000111', '110']",1,6,15,16,5,31,8.32905982905983,50,39
"['0101', '11011', '111', '011100']",1,4,6,12,0,18,3.80021645021645,16,15
"['11000', '111000', '110', '01011', '01000']",1,5,13,11,3,24,6.216666666666667,24,39
"['01', '1011001', '111', '1101111', '101', '00']",1,6,8,16,6,24,7.436507936507937,50,45
"['0110101', '1', '01111', '0000001', '0000', '1100111']",1,6,16,15,3,31,6.060966810966811,62,40
"['01', '011010', '001', '11']",1,4,6,7,2,13,3.1444444444444444,15,12
"['0000101', '101111', '101101']",1,3,8,11,2,19,1.7564102564102564,8,13
"['0001001', '0101000', '0011', '01111', '1010', '100000']",1,6,20,13,4,33,8.437284937284938,48,42
"['100010', '1100', '1111']",1,3,6,8,2,14,1.5,9,8
"['0010', '010', '010101']",1,3,8,5,0,13,2.123809523809524,6,12
"['010100', '1010', '01011']",1,3,8,7,0,15,2.193939393939394,6,9
"['01', '00010', '100']",1,3,7,3,0,10,1.4714285714285715,8,7
"['01111', '1000', '1']",1,3,4,6,0,10,0.9555555555555555,11,6
"['1011010', '100', '111']",1,3,5,8,2,13,1.5333333333333332,10,7
"['001', '1', '1000101', '000']",1,4,9,5,2,14,2.6166666666666667,20,13
"['101', '11111', '1100110', '0001111']",1,4,7,15,2,22,3.4047619047619047,22,23
"['101', '010000', '100000', '0101011']",1,4,14,8,2,22,3.399145299145299,21,16
"['0', '110', '0010111']",1,3,5,6,0,11,1.15,13,7
"['1000', '000000', '011111', '1010000', '110', '101111']",1,6,17,15,3,32,6.561094461094461,57,49
"['0001001', '010001', '10111', '0011', '1010011']",1,5,15,14,2,29,6.698901098901099,27,32
"['1000001', '001101', '0110100', '00111', '100', '10']",1,6,17,13,2,30,8.354145854145854,54,42
"['1101101', '111', '01100', '111110']",1,4,6,15,0,21,3.44032634032634,18,17
"['11000', '1001', '00', '10', '0111']",1,5,9,8,4,17,5.253968253968254,26,22
"['0', '101', '10010', '11']",1,4,5,6,0,11,2.954761904761905,14,11
"['01111', '101', '1010', '11100']",1,4,6,11,2,17,3.568253968253968,15,16
"['1000000', '0010', '0011101', '1011']",1,4,13,9,4,22,2.7857142857142856,23,15
"['0011', '1', '000', '0100']",1,4,8,4,2,12,2.442857142857143,15,15
"['1001', '111', '00000']",1,3,7,5,0,12,1.0158730158730158,10,4
"['01', '101', '10001', '00', '1100']",1,5,9,7,2,16,5.830952380952381,21,24
"['101', '10101', '1111', '000010', '0001000', '110101']",1,6,16,15,2,31,8.366339216339217,49,44
"['1000100', '001100', '10000']",1,3,13,5,0,18,1.8403263403263403,7,15
"['00101', '011', '00', '011111', '00010']",1,5,11,10,2,21,5.418614718614719,30,30
"['010', '111', '00000']",1,3,7,4,2,11,0.8333333333333333,10,4
"['01101', '00000', '11', '10010', '1111011']",1,5,11,13,3,24,4.520634920634921,37,22
"['01001', '110', '1']",1,3,4,5,0,9,1.3333333333333333,9,6
"['000110', '101', '10101', '1000', '0000']",1,5,14,8,2,22,5.858152958152958,26,32
"['111011', '100000', '10011', '0000']",1,4,12,9,2,21,3.0505050505050506,19,21
"['100010', '1111010', '10', '0101100', '1100', '0100']",1,6,16,14,4,30,9.190703740703741,48,47
"['1101', '1', '111001']",1,3,3,8,0,11,1.4857142857142858,10,14
"['100110', '000111', '1001111']",1,3,8,11,2,19,2.2051282051282053,6,12
"['00110', '010', '1001010']",1,3,9,6,0,15,2.1833333333333336,8,12
"['0111', '00', '11010', '0100']",1,4,8,7,2,15,3.1825396825396823,15,18
"['1010111', '0000101', '10', '11']",1,4,8,10,4,18,2.849206349206349,24,17
"['110010', '111000', '110111', '010']",1,4,9,12,3,21,3.5555555555555554,19,19
"['0001', '10010', '0100100']",1,3,11,5,0,16,2.2272727272727275,7,7
"['1001110', '101', '0010', '10']",1,4,8,8,0,16,3.8098124098124098,17,16
"['0', '111', '0001101', '00110', '1011']",1,5,9,11,0,20,4.70021645021645,32,19
"['11001', '01', '1', '10000']",1,4,7,6,2,13,2.7904761904761903,18,15
"['101', '0100', '011000']",1,3,8,5,0,13,1.8158730158730159,8,6
"['0010', '00011', '10111', '110001', '1101110', '10']",1,6,13,16,2,29,8.546264846264846,48,40
"['1000', '0101', '0000']",1,3,9,3,3,12,1.75,6,10
"['010', '1', '0001', '100', '001110']",1,5,10,7,2,17,5.2063492063492065,28,22
"['001', '0000110', '1111']",1,3,7,7,0,14,1.2493506493506494,12,5
"['011', '111', '00001', '10', '0110010']",1,5,10,10,2,20,4.813492063492063,32,23
"['0111000', '001', '001000', '1010100', '1111', '1111010']",1,6,17,17,3,34,8.170562770562771,52,46
"['0010', '0111001', '1', '000']",1,4,9,6,0,15,2.4525974025974024,21,12
"['10111', '101', '1101', '1010', '0111', '0010010']",1,6,11,16,3,27,9.994300144300144,37,45
"['0', '110110', '1101']",1,3,4,7,0,11,1.4857142857142858,10,7
"['01001', '001', '1', '011110']",1,4,7,8,0,15,2.8589466089466087,20,13
"['1001', '01110', '0000']",1,3,8,5,2,13,1.3888888888888888,9,4
"['0001110', '110', '010110']",1,3,8,8,0,16,2.0358974358974358,9,14
"['10000', '1', '10']",1,3,5,3,0,8,1.5714285714285714,8,7
"['0010', '10110', '1', '01110']",1,4,7,8,2,15,3.2,17,14
"['011', '0011100', '11', '0101011', '0101010', '01100']",1,6,15,16,3,31,9.564285714285715,48,51
"['1101', '0000010', '1110', '00000']",1,4,13,7,2,20,2.755050505050505,22,20
"['1111', '111100', '0100', '1101010']",1,4,8,13,2,21,3.71993006993007,16,21
"['01', '011100', '101011', '1011101', '110100']",1,5,11,16,3,27,5.777777777777778,33,25
"['0010', '11011', '11', '00', '0000011']",1,5,11,9,2,20,4.235930735930736,35,30
"['010', '1011101', '111011', '0101', '1100']",1,5,9,15,2,24,6.033155733155733,29,24
"['01001', '10110', '10', '1101100']",1,4,9,10,2,19,3.687301587301587,20,14
"['10010', '10', '1011000']",1,3,8,6,0,14,1.6825396825396823,11,10
"['001', '1101100', '1100', '1110', '0110011']",1,5,11,14,4,25,5.866883116883117,33,32
"['011', '10', '1110']",1,3,3,6,0,9,1.638095238095238,6,8
"['0', '010100', '001101', '1011110', '1011101', '100010', '110']",1,7,17,19,5,36,11.149328449328449,74,54
"['100110', '001110', '01010', '011111', '0001010']",1,5,15,15,3,30,6.833333333333334,26,38
"['0011', '1', '011']",1,3,3,5,0,8,1.7571428571428571,6,8
"['1010', '1', '1100101']",1,3,5,7,0,12,1.1954545454545453,12,8
"['11100', '0101', '010111', '110']",1,4,7,11,0,18,3.5557720057720057,17,19
"['11001', '11110', '111', '10010', '1100', '01011']",1,6,10,17,4,27,8.938095238095238,34,51
"['0', '0101', '1101', '100']",1,4,6,6,2,12,3.192857142857143,13,12
"['1000', '100111', '10', '00010', '01100', '1101010']",1,6,16,13,2,29,8.687534687534686,46,41
"['101', '1100001', '01011']",1,3,7,8,0,15,1.6833333333333333,10,10
"['0111000', '1', '10000', '1111110', '01010', '01110']",1,6,14,16,5,30,7.371428571428571,55,43
"['1011001', '101001', '1111011']",1,3,7,13,2,20,2.10989010989011,6,17
"['0101', '0000110', '0000']",1,3,11,4,2,15,1.7727272727272727,9,14
"['011111', '0101010', '111110', '01010']",1,4,9,15,2,24,3.498834498834499,16,30
"['10101', '11011', '100101']",1,3,6,10,2,16,2.4363636363636365,5,16
"['1101', '00', '1101010']",1,3,6,7,0,13,1.505050505050505,11,7
"['11010', '00101', '10']",1,3,6,6,2,12,1.7428571428571429,9,7
"['11010', '0010', '111100', '1001', '0010011', '01011']",1,6,15,16,4,31,9.356993006993006,43,42
"['00100', '1101100', '1010', '00', '011110', '0101', '1011111']",1,7,16,19,4,35,11.866050616050616,69,56
"['0100010', '000110', '100111', '0']",1,4,12,8,2,20,2.8727106227106227,23,13
"['01', '110010', '1010100', '001110', '10']",1,5,12,11,4,23,4.811965811965812,38,25
"['0010000', '11000', '0001', '0110', '1010', '01011', '01100']",1,7,21,13,6,34,12.797474747474746,59,67
"['10100', '100', '011']",1,3,6,5,2,11,1.5833333333333333,8,9
"['10000', '1100', '1110100', '1']",1,4,9,8,0,17,2.8772727272727274,21,17
"['11110', '1', '010110']",1,3,4,8,0,12,1.3463203463203464,11,6
"['00001', '101000', '00', '1011100', '010011', '101110']",1,6,18,14,3,32,8.793262293262293,49,49
"['010100', '110', '011', '01100']",1,4,9,8,2,17,4.186868686868687,13,21
"['001', '101000', '111110', '011110', '0000']",1,5,13,12,3,25,4.382539682539682,34,33
"['0100111', '00', '0111', '011001', '011010']",1,5,12,13,2,25,6.16915306915307,31,35
"['0100010', '1101001', '100', '11']",1,4,10,9,2,19,3.2031746031746033,23,12
"['1000100', '11110', '0001', '101111']",1,4,10,12,0,22,2.8716394716394715,21,17
"['0001011', '001011', '1110']",1,3,8,9,0,17,1.6867132867132868,10,14
"['0', '0101111', '00110', '010101', '10010']",1,5,12,12,2,24,5.211005661005661,36,26
"['101', '110', '000011']",1,3,6,6,2,12,1.5555555555555554,11,7
"['110010', '011', '11000', '1000', '0101100', '11111']",1,6,14,16,2,30,8.256654456654456,45,45
"['0', '0111001', '010001', '011100', '000001', '001011']",1,6,19,13,4,32,7.662087912087912,52,49
"['101', '1101000', '100', '111011', '10011']",1,5,10,14,2,24,6.32043512043512,29,37
"['01001', '110', '00101']",1,3,7,6,2,13,1.8,8,7
"['10101', '00', '011']",1,3,5,5,0,10,1.7214285714285715,7,4
"['11101', '0101', '100', '1111000']",1,4,8,11,0,19,3.368398268398268,19,17
"['0011', '10101', '111110', '10', '000001', '111000']",1,6,14,15,3,29,6.827489177489177,54,41
"['01', '0001110', '1110000', '100', '100010', '11101', '10']",1,7,17,15,4,32,11.553757353757353,77,55
"['11000', '1100', '0110001', '001000']",1,4,14,8,0,22,4.545998445998446,13,22
"['001', '101', '0000001', '001010', '1101', '01110']",1,6,16,12,2,28,8.58101898101898,46,39
"['001100', '1101', '10', '11']",1,4,6,8,2,14,3.433333333333333,16,12
"['0011001', '001010', '1110']",1,3,9,8,0,17,1.7146853146853147,10,9
"['1001100', '0010', '1']",1,3,7,5,0,12,1.3772727272727274,12,5
"['010001', '0000110', '0011111', '011010', '11100']",1,5,16,15,4,31,5.805694305694306,33,29
"['010', '011', '0111011', '00011', '101001', '0100']",1,6,14,14,2,28,9.51112776112776,41,43
"['110000', '101', '10010', '10']",1,4,9,7,0,16,3.793145743145743,16,16
"['0', '01111', '1000111', '11111']",1,4,5,13,2,18,2.55,22,22
"['001110', '110', '00011']",1,3,7,7,0,14,1.893939393939394,9,10
"['11001', '11010', '011', '1000000', '00', '01001', '1110']",1,7,17,14,3,31,11.254906204906204,64,54
"['00', '001', '1110', '1111']",1,4,5,8,2,13,2.454761904761905,15,16
"['101010', '110110', '00101']",1,3,8,9,2,17,2.106060606060606,8,7
"['0100000', '001', '11', '00', '0110010']",1,5,14,7,4,21,4.184126984126984,37,26
"['0100001', '11110', '1']",1,3,6,7,0,13,0.9166666666666666,15,6
"['00111', '1010', '01', '1110']",1,4,6,9,2,15,3.1825396825396823,15,15
"['000000', '010010', '0111']",1,3,11,5,2,16,1.3,10,9
"['010100', '110', '11100', '000']",1,4,10,7,2,17,3.1994949494949494,15,21
"['001100', '01', '0011', '0111']",1,4,8,8,2,16,3.9833333333333334,14,18
"['011101', '101011', '1101', '00']",1,4,7,11,2,18,3.2333333333333334,18,14
"['01', '11110', '111', '0101011', '0011011']",1,5,8,16,2,24,5.015079365079365,36,34
"['1100011', '01101', '1']",1,3,5,8,0,13,1.25,14,8
"['01', '1001', '0001000', '11']",1,4,9,6,2,15,3.0454545454545454,20,11
"['1001110', '1', '1111000', '000010']",1,4,11,10,2,21,2.576923076923077,29,13
"['0101101', '110110', '100', '1']",1,4,7,10,0,17,3.0716117216117214,22,12
"['1010', '110111', '11']",1,3,3,9,0,12,1.7666666666666666,9,12
"['001001', '111100', '00011']",1,3,9,8,2,17,1.5909090909090908,11,10
"['1000', '1101101', '1']",1,3,5,7,0,12,1.1954545454545453,13,8
"['0', '10100', '110']",1,3,5,4,0,9,1.3333333333333333,8,6
"['0110101', '111111', '1001', '010']",1,4,7,13,0,20,2.7726717726717727,22,12
"['0011', '001', '110']",1,3,5,5,2,10,1.7619047619047619,7,9
"['0010001', '10101', '100010', '00110', '00010', '01011']",1,6,20,13,4,33,10.344988344988344,36,40
"['101', '00', '11100']",1,3,5,5,0,10,1.4714285714285715,8,6
"['1110001', '01', '011', '00001']",1,4,9,8,0,17,3.3825396825396825,20,19
"['10111', '10', '000']",1,3,5,5,0,10,1.2214285714285715,9,5
"['1000100', '011', '0001000', '1010', '00', '111101']",1,6,17,12,2,29,7.52052947052947,56,38
"['1001110', '1101000', '10']",1,3,8,8,2,16,1.4603174603174602,13,8
"['0', '1010000', '0111']",1,3,7,5,0,12,1.0136363636363637,14,6
"['0', '111100', '00111', '0000010', '01011']",1,5,13,11,2,24,4.219164169164169,42,29
"['0', '1101', '110']",1,3,3,5,0,8,1.7571428571428571,6,6
"['0100000', '1', '101000', '11000', '101']",1,5,14,8,0,22,5.28070263070263,34,27
"['0010', '1', '00001', '011011', '10111', '110001', '00110', '1010']",1,8,18,18,7,36,15.202236652236651,84,68
"['010', '00000', '1100001', '1000010', '110011', '100111', '10', '001001']",1,8,25,17,5,42,16.354667554667554,92,71
"['1000', '10', '0111', '111']",1,4,5,8,2,13,2.7928571428571427,15,17
"['00110', '101001', '11']",1,3,6,7,0,13,1.6168831168831168,10,4
"['0', '0110', '1110']",1,3,4,5,2,9,1.55,7,10
"['0', '101011', '011101', '1100011']",1,4,8,12,2,20,2.552197802197802,25,13
"['0101101', '011', '110', '0000010']",1,4,11,9,4,20,3.0952380952380953,24,15
"['00100', '10101', '111']",1,3,6,7,2,13,1.6,8,4
"['01', '010000', '11', '1100000', '1100101', '10']",1,6,15,11,5,26,7.13949938949939,55,40
"['0', '00011', '101', '111101', '111000', '0110110']",1,6,12,16,2,28,7.172399822399822,56,34
"['010', '10101', '1101110', '1000', '000', '11100', '1110']",1,7,15,16,6,31,12.575108225108224,53,58
"['11', '00111', '11000', '01000', '0100']",1,5,12,9,3,21,5.3619047619047615,29,34
"['0101101', '11', '000', '00001']",1,4,10,7,0,17,2.4134920634920634,21,15
"['01', '001111', '1110000', '1010', '110']",1,5,10,12,0,22,4.811754911754912,37,26
"['00100', '01001', '110']",1,3,8,5,2,13,1.8,8,6
"['11001', '01', '0001110', '00001', '0011', '1100001', '101', '001001']",1,8,22,17,4,39,17.40082695082695,85,93
"['010100', '01', '11011', '001', '00111', '01111', '0101011']",1,7,14,19,3,33,12.458769008769009,57,66
"['0011', '1101000', '0001', '0011111']",1,4,11,11,4,22,3.3603896103896105,23,24
"['0100010', '101', '101100', '00001']",1,4,13,8,0,21,3.379020979020979,20,14
"['101', '00010', '100']",1,3,7,4,2,11,1.6666666666666665,7,6
"['0', '111010', '00101', '1101']",1,4,7,9,0,16,3.031168831168831,19,13
"['1', '101011', '110111', '1010000', '011010', '0001000']",1,6,17,16,5,33,7.315018315018315,60,35
"['1110011', '001110', '0100', '100010']",1,4,12,11,2,23,3.4428904428904428,21,12
"['110010', '001', '101', '0011110', '1001000', '0111', '011010', '110']",1,8,19,20,7,39,16.869785769785768,87,74
"['1101001', '1', '1011001', '00100', '000', '0111101', '1100']",1,7,17,17,3,34,10.361904761904762,75,54
"['101', '0011', '001', '111']",1,4,5,8,3,13,3.6666666666666665,9,19
"['00100', '0110', '000']",1,3,9,3,0,12,1.9880952380952381,6,16
"['1111100', '1', '00101', '101000', '0011010', '10000', '1101']",1,7,18,17,4,35,10.844477744477745,75,56
"['0010', '0100111', '001111', '111100', '1000', '100111', '0000', '0101', '110']",1,9,22,22,7,44,20.291219891219892,112,112
"['1110100', '010110', '0100']",1,3,9,8,0,17,2.1426573426573428,8,13
"['1101100', '100110', '1010', '0111', '000', '0101', '0110110']",1,7,17,18,5,35,13.336996336996338,59,57
"['10100', '0100110', '10']",1,3,8,6,0,14,1.6825396825396823,11,8
"['010100', '011111', '1111111']",1,3,5,14,2,19,1.576923076923077,10,13
"['0', '010', '1010', '111111', '110']",1,5,6,11,2,17,4.561904761904762,29,24
"['01100', '100', '0010101', '00110', '1100110', '01000']",1,6,19,13,5,32,10.447619047619048,42,53
"['0', '0001001', '11010']",1,3,8,5,0,13,1.0833333333333333,14,6
"['11', '1011', '111001']",1,3,3,9,0,12,1.7666666666666666,9,17
"['11011', '100', '00', '1011100', '0100']",1,5,11,10,0,21,5.9923520923520925,30,31
"['0011011', '00010', '111']",1,3,7,8,0,15,1.5166666666666666,11,7
"['1011', '001', '00000']",1,3,8,4,0,12,1.2936507936507935,9,6
"['1001', '100', '01011', '110']",1,4,7,8,2,15,3.761904761904762,12,15
"['11', '1011110', '11000', '0100001', '01001']",1,5,13,13,4,26,5.56031746031746,36,27
"['1110110', '00', '1000']",1,3,7,6,0,13,1.6565656565656566,11,8
"['000110', '001001', '110']",1,3,9,6,2,15,1.7777777777777777,10,9
"['1111010', '11101', '1', '000']",1,4,6,10,0,16,2.066666666666667,24,12
"['0111000', '0', '0101111', '011', '0101101', '010010', '0001010']",1,7,20,18,4,38,11.48974358974359,77,75
"['11', '00', '0010000', '110101']",1,4,10,7,2,17,2.128205128205128,25,14
"['0', '11', '11100', '0100']",1,4,6,6,0,12,2.3047619047619046,17,14
"['0', '000110', '0101011']",1,3,8,6,0,14,1.304945054945055,14,8
"['1101001', '0110101', '0100000', '0100111', '1100110']",1,5,18,17,5,35,6.285714285714286,29,28
"['011010', '1011001', '110111', '0111']",1,4,8,15,2,23,4.5324009324009324,16,16
"['0', '10100', '010001']",1,3,8,4,0,12,1.3463203463203464,12,6
"['011111', '100011', '1100', '11100']",1,4,8,13,2,21,3.4797979797979797,19,22
"['00101', '0100010', '101', '100', '0001101', '0111111']",1,6,16,16,5,32,8.230952380952381,53,39
"['0010001', '1', '0001', '1100000', '011101', '01001']",1,6,18,12,2,30,7.7896214896214895,55,45
"['1011', '10001', '110111']",1,3,5,10,0,15,2.012121212121212,7,15
"['111', '101', '10110', '00', '0011111']",1,5,7,13,2,20,4.832539682539682,31,26
"['0', '000111', '10010', '000001']",1,4,12,6,2,18,2.662337662337662,22,14
"['01', '100', '01011']",1,3,5,5,0,10,1.4714285714285715,8,7
"['00', '000001', '1000011', '1100', '1110']",1,5,14,9,2,23,4.972766122766123,35,26
"['1000101', '00000', '011011', '100', '1010', '10010', '101001']",1,7,21,15,4,36,13.276295926295926,58,60
"['1011010', '001', '1001101', '1010111', '0111100']",1,5,13,18,4,31,5.942857142857143,35,24
"['1110000', '0011010', '11']",1,3,8,8,2,16,1.4603174603174602,14,7
"['0', '11001', '111', '0100']",1,4,6,7,0,13,2.4357142857142855,17,10
"['10111', '010010', '1110']",1,3,6,9,0,15,1.612121212121212,8,7
"['1010110', '00', '001011']",1,3,8,7,0,15,1.7136752136752138,11,8
"['101', '11010', '0111101', '110101']",1,4,7,14,0,21,4.207808857808858,15,24
"['01101', '1100', '110']",1,3,5,7,0,12,2.2738095238095237,5,8
"['1011011', '001', '11']",1,3,4,8,0,12,1.2444444444444445,11,10
"['1000001', '1000110', '10100']",1,3,12,7,2,19,1.7142857142857144,9,11
"['110110', '11', '101', '1010', '00', '0010010']",1,6,12,12,2,24,8.506870906870907,43,36
"['1', '10110', '0010101', '00', '00110', '0110010']",1,6,15,12,4,27,7.403174603174603,53,41
"['01', '11011', '011011', '0001', '01001']",1,5,10,12,2,22,6.279220779220779,24,32
"['00', '0011101', '10', '111']",1,4,6,8,2,14,2.388888888888889,20,12
"['1011', '0101', '11']",1,3,3,7,2,10,2.083333333333333,6,10
"['0', '001', '101', '0111', '0110110']",1,5,8,10,2,18,5.186796536796537,29,21
"['001', '0000010', '111110']",1,3,9,7,0,16,1.12991452991453,14,8
"['110110', '01', '11', '101011', '1110011']",1,5,7,16,4,23,5.760683760683761,34,40
"['110011', '01', '010']",1,3,5,6,0,11,1.7444444444444445,9,5
"['1', '001111', '000101', '011001']",1,4,9,10,3,19,2.6904761904761902,23,14
"['01101', '0011', '0010', '00010']",1,4,11,7,4,18,4.238888888888889,11,21
"['0101000', '0111001', '111', '0001', '00110', '011000']",1,6,18,14,2,32,9.236752136752136,45,46
"['0', '11000', '10', '11001']",1,4,7,6,2,13,3.276190476190476,16,13
"['0', '0111101', '10']",1,3,4,6,0,10,1.3611111111111112,12,6
"['111011', '0111', '101101']",1,3,4,12,2,16,2.2333333333333334,7,11
"['0010110', '00', '01111', '011']",1,4,8,9,0,17,2.9801587301587302,20,19
"['0110101', '101', '11111', '1100011', '1100']",1,5,9,17,2,26,5.932323232323232,31,38
"['001', '0100111', '0110000', '001110', '011110']",1,5,15,14,4,29,6.131257631257632,34,37
"['001', '100001', '111', '001000', '101', '1010111', '1011100']",1,7,17,18,7,35,11.512576312576313,71,69
"['000110', '0010', '10000', '111011', '1010', '0100']",1,6,17,12,5,29,9.040909090909091,41,42
"['0011010', '1011', '011', '0100']",1,4,9,9,2,18,3.6194805194805193,17,14
"['0110000', '0011', '010111']",1,3,9,8,0,17,1.806993006993007,11,9
"['0011101', '0100010', '10111', '1010100', '100', '000']",1,6,18,14,5,32,8.02142857142857,53,42
"['1010', '0011010', '01110', '11']",1,4,8,10,0,18,3.6875901875901875,17,15
"['110011', '011010', '0']",1,3,6,7,2,13,1.2380952380952381,13,4
"['1011101', '00', '10']",1,3,5,6,2,11,1.3888888888888888,11,5
"['010', '1001', '100001', '00']",1,4,10,5,0,15,3.7825396825396824,16,12
"['1000001', '01', '111010', '00111', '10111', '1011', '1110']",1,7,13,20,4,33,12.137728937728937,64,73
"['00', '010', '0010011']",1,3,8,4,0,12,1.8444444444444446,10,10
"['10001', '0010100', '100110', '00', '10']",1,5,14,8,2,22,5.528249528249528,34,27
"['01101', '001011', '00011', '1111000', '1000', '00', '01011']",1,7,18,16,3,34,12.184915084915085,66,72
"['01', '0010', '11000', '0001', '1111', '00110']",1,6,13,11,5,24,8.151587301587302,41,40
"['0100100', '000010', '11']",1,3,10,5,0,15,1.4636752136752138,12,5
"['1111100', '01', '0000100', '101', '0000111', '0001010', '0000110', '1110', '1111011']",1,9,26,25,6,51,19.079076479076477,143,117
"['0', '110110', '01101', '001100', '00010']",1,5,13,10,4,23,5.05021645021645,34,29
"['00001', '101000', '1', '001000']",1,4,13,5,2,18,2.829004329004329,20,20
"['0', '011101', '00110', '001001', '11100', '01011']",1,6,14,14,5,28,8.038095238095238,46,39
"['0', '10110', '0110', '10', '0111']",1,5,7,9,2,16,5.676984126984127,23,30
"['100', '10', '0101100', '1111011']",1,4,8,11,2,19,3.2603174603174603,24,13
"['11010', '101010', '100010', '1001101', '1000', '000', '1011']",1,7,19,16,4,35,13.882717282717282,50,67
"['101', '10010', '100111', '0000']",1,4,10,8,0,18,3.4963203463203465,16,15
"['00100', '011', '10']",1,3,6,4,0,10,1.4714285714285715,8,6
"['0101110', '1', '1010', '000', '1010010', '0100']",1,6,15,11,4,26,7.834415584415584,49,41
"['0', '1101', '0110']",1,3,4,5,2,9,1.55,8,4
"['0100000', '11100', '0001000']",1,3,14,5,2,19,1.7142857142857144,10,15
"['111000', '001110', '001011', '111011']",1,4,10,14,4,24,3.833333333333333,18,23
"['0111', '010', '10011', '011100']",1,4,8,10,0,18,3.75021645021645,16,16
"['0101111', '111', '10110', '10', '01001']",1,5,8,14,2,22,5.520634920634921,31,28
"['1001100', '1101', '1']",1,3,5,7,0,12,1.1954545454545453,13,8
"['001', '110', '1111110', '0100']",1,4,7,10,2,17,2.63982683982684,22,16
"['001101', '11', '0011', '1000000', '1010', '10010', '10011']",1,7,18,15,4,33,13.0013653013653,60,68
"['001', '110', '1000101', '1101011', '1000', '1010', '1100011', '11100']",1,8,19,21,7,40,17.414285714285715,81,89
"['0', '0110101', '0111', '0100100', '1010000']",1,5,15,11,3,26,4.786363636363636,41,27
"['0', '010000', '000101']",1,3,10,3,2,13,1.0714285714285714,13,10
"['00', '111000', '111']",1,3,5,6,0,11,1.1666666666666665,10,10
"['11001', '0011', '111000', '001']",1,4,9,9,0,18,3.8455266955266953,17,21
"['000110', '0001', '1111']",1,3,7,7,2,14,1.4500000000000002,9,7
"['0', '10111', '111110', '100']",1,4,5,10,0,15,2.6089466089466087,20,13
"['001', '0001100', '1010', '1011100', '0000']",1,5,16,9,4,25,5.720779220779221,31,41
"['0', '1101001', '101000', '100100', '111110', '000010', '1011011', '1110']",1,8,21,22,6,43,13.7991008991009,98,72
"['0000100', '1011100', '10', '11']",1,4,10,8,4,18,2.626984126984127,25,14
"['1010', '000101', '111']",1,3,6,7,0,13,1.615873015873016,9,6
"['00111', '10001', '10']",1,3,6,6,2,12,1.457142857142857,10,7
"['1010010', '1111010', '00', '01001', '111000']",1,5,14,13,2,27,5.948995448995449,32,26
"['01', '1110010', '00001', '00000', '1101']",1,5,14,9,2,23,5.162193362193362,33,28
"['00100', '0010111', '1']",1,3,7,6,0,13,1.25,13,8
"['0100000', '011011', '100010', '000111', '1100', '1110']",1,6,18,15,5,33,8.384731934731935,51,43
"['001', '1', '011', '0100100']",1,4,8,6,2,14,3.1166666666666667,19,12
"['0', '101000', '01111', '1110101']",1,4,8,11,0,19,2.5147352647352648,25,12
"['110011', '1011', '011']",1,3,4,9,0,13,2.3238095238095235,6,16
"['0011011', '101', '0001', '010111']",1,4,9,11,0,20,3.5527805527805527,18,15
"['1111100', '01', '001', '0001100', '1010001']",1,5,14,12,3,26,5.2253968253968255,42,29
"['01', '111', '1100110', '1100011', '01001']",1,5,10,14,2,24,5.750793650793651,34,34
"['11011', '110001', '1', '0011000']",1,4,9,10,0,19,2.8655511155511157,24,15
"['0', '11001', '1000101', '11000', '00010']",1,5,14,9,3,23,5.416666666666667,33,22
"['0', '11000', '010', '1111']",1,4,6,7,0,13,2.0634920634920633,19,12
"['01', '110001', '011001']",1,3,7,7,2,14,1.8333333333333335,10,11
"['010100', '01', '1111001', '11']",1,4,7,10,2,17,3.0042735042735043,22,14
"['001', '100', '1010', '000', '0111110', '1110']",1,6,12,12,5,24,7.933766233766233,40,43
"['1110111', '1', '0011010']",1,3,5,10,2,15,1.0714285714285714,16,4
"['00110', '00', '101', '11']",1,4,6,6,2,12,2.842857142857143,14,10
"['001111', '100001', '000']",1,3,9,6,2,15,1.6111111111111112,11,6
"['01', '110100', '000', '110', '101001', '0100']",1,6,14,10,4,24,8.376190476190477,37,39
"['101010', '110', '0111110']",1,3,6,10,0,16,1.3521367521367522,10,10
"['10100', '010001', '1', '10']",1,4,8,6,0,14,3.0844155844155843,20,13
"['0', '1011', '1010']",1,3,4,5,2,9,1.55,7,6
"['0011011', '00010', '1110']",1,3,8,8,0,16,1.6565656565656566,10,9
"['0', '0001010', '1101', '110', '001011']",1,5,11,10,0,21,5.051986901986902,34,24
"['010', '001', '011']",1,3,5,4,3,9,2.0,4,7
"['011', '10111', '011101', '1010', '0000011', '01110']",1,6,13,17,2,30,9.310744810744811,44,43
"['11001', '10', '010110', '100010']",1,4,10,9,2,19,3.344155844155844,19,14
"['0', '0111', '11111']",1,3,2,8,0,10,1.0666666666666667,10,8
"['0', '010', '1100', '011010']",1,4,8,6,0,14,3.223809523809524,17,21
"['0101', '001', '110', '000110']",1,4,9,7,2,16,3.4095238095238094,15,16
"['01', '0010', '000']",1,3,7,2,0,9,1.9238095238095236,5,10
"['101100', '001', '00011', '101', '0110', '010111', '0111', '1010000', '1110']",1,9,20,22,7,42,21.45241425241425,102,100
"['01', '01111', '0000001']",1,3,8,6,0,14,1.349206349206349,13,8
"['1000', '111', '011110']",1,3,5,8,0,13,1.3523809523809525,10,4
"['110111', '100001', '111']",1,3,5,10,2,15,1.6111111111111112,10,18
"['11101', '000101', '000', '1111']",1,4,8,10,0,18,2.7510101010101007,19,20
"['0', '0011101', '0101110', '101', '0100']",1,5,11,11,2,22,5.119480519480519,36,25
"['1111100', '101', '1111110', '0000000', '0001010', '1110']",1,6,17,18,4,35,6.885714285714286,61,48
"['11000', '0001', '00100', '001011', '111001']",1,5,15,11,4,26,5.996969696969697,27,35
"['1011101', '010', '00', '01011']",1,4,8,9,0,17,3.6325396825396825,18,12
"['0001', '1101011', '0001000', '100010']",1,4,15,9,2,24,3.704095904095904,19,15
"['0001100', '001111', '10', '010110']",1,4,11,10,2,21,3.2457264957264957,22,17
"['01', '011100', '0011', '0001', '101011', '0000001', '0000101', '001011']",1,8,25,17,7,42,16.27019092019092,86,91
"['0', '110110', '000101', '100000', '11100']",1,5,14,10,3,24,4.4935064935064934,38,25
"['1010', '1000', '010010', '11']",1,4,9,7,2,16,3.65,14,13
"['1101', '001', '10']",1,3,4,5,0,9,1.638095238095238,6,7
"['0001010', '00', '11']",1,3,7,4,2,11,0.8888888888888888,12,6
"['0010000', '110100', '0000']",1,3,13,4,0,17,1.7426573426573428,9,20
"['100', '1001', '0110', '110101']",1,4,8,9,2,17,3.9952380952380953,14,13
"['1110000', '101011', '100', '000', '1101', '000111']",1,6,15,14,4,29,8.127383727383727,51,50
"['111', '10110', '00', '011001', '1110110']",1,5,9,14,0,23,5.458530358530359,32,26
"['1110111', '1010', '00', '1010011']",1,4,8,12,2,20,3.3203463203463204,22,15
"['000110', '001', '1011110', '0110', '010101', '001010', '0011111', '0111', '0000', '110']",1,10,25,25,10,50,27.38971028971029,129,147
"['01101', '1', '10111', '00110', '0000', '010011']",1,6,13,13,3,26,7.219047619047619,46,30
"['01', '00010', '0100']",1,3,8,3,0,11,1.9047619047619047,7,10
"['100111', '01011', '1']",1,3,4,8,0,12,1.3463203463203464,12,9
"['01', '110111', '011110']",1,3,4,10,2,14,1.6666666666666665,11,5
"['1', '10011', '000', '001000']",1,4,10,5,0,15,2.331168831168831,22,14
"['100010', '10000', '11']",1,3,8,5,0,13,1.6948051948051948,9,9
"['0001110', '11', '101', '00', '1101']",1,5,8,10,2,18,4.8914862914862915,31,22
"['010', '0010111', '11111', '1001', '1010', '0000']",1,6,13,14,3,27,7.625252525252525,46,35
"['1010', '01', '111010', '011110']",1,4,7,11,2,18,3.533333333333333,17,18
"['010100', '110', '0111']",1,3,6,7,0,13,1.615873015873016,8,8
"['11001', '101000', '10', '01000']",1,4,11,7,2,18,3.879220779220779,15,15
"['0', '1011', '01', '1110']",1,4,4,7,2,11,2.966666666666667,14,11
"['0', '01101', '1110000', '00011']",1,4,10,8,2,18,2.5166666666666666,26,15
"['10', '111101', '00000']",1,3,7,6,0,13,0.9675324675324675,13,4
"['0010', '0000011', '01010', '1111']",1,4,11,9,2,20,2.77020202020202,20,15
"['0011', '01', '001001']",1,3,7,5,0,12,1.9666666666666668,8,9
"['011011', '010010', '10100', '000', '11111']",1,5,12,13,4,25,5.041414141414141,32,23
"['00', '01101', '10000', '1111111']",1,4,8,11,2,19,2.2095238095238097,27,12
"['1110001', '0101', '0100']",1,3,8,7,2,15,1.8409090909090908,9,7
"['100', '00101', '0110001', '11']",1,4,9,8,0,17,3.015873015873016,20,14
"['10101', '01011', '01010']",1,3,7,8,3,15,2.4000000000000004,5,7
"['010', '0001', '111011', '000111', '0100011']",1,5,13,13,2,26,5.872205572205572,32,30
"['01', '001', '0110111', '000']",1,4,8,7,2,15,3.111111111111111,18,16
"['01', '100', '0010100', '0000', '101111']",1,5,13,9,0,22,4.682461982461982,36,28
"['101011', '110', '01100', '11']",1,4,6,10,0,16,3.6113275613275615,17,15
"['1000010', '001101', '010101', '0111110']",1,4,13,13,4,26,3.26007326007326,21,16
"['010100', '1111101', '10', '11']",1,4,6,11,2,17,2.8504273504273505,23,12
"['01101', '100001', '111', '0001', '10100', '1011']",1,6,13,14,4,27,8.182900432900432,38,48
"['0101111', '1110000', '1111', '11101', '10011', '0111', '01010', '000111']",1,8,16,27,7,43,17.0507548007548,85,114
"['00', '10000', '11']",1,3,6,3,2,9,0.8571428571428571,9,6
"['1111', '01111', '011001']",1,3,4,11,0,15,2.216161616161616,6,14
"['11001', '1011101', '10', '0']",1,4,6,9,0,15,2.9325396825396823,22,12
"['0010', '111100', '1011101', '1111001', '10100', '010110', '000']",1,7,18,20,4,38,13.414441114441114,62,57
"['001100', '110', '1100']",1,3,7,6,0,13,2.3238095238095235,6,12
"['101', '111110', '0111']",1,3,3,10,0,13,1.615873015873016,9,8
"['0', '1001001', '0011']",1,3,7,5,0,12,1.3772727272727274,12,4
"['1101101', '10', '1000111', '111001']",1,4,8,14,2,22,3.487789987789988,23,24
"['010100', '01', '011']",1,3,6,5,0,11,1.9666666666666668,8,9
"['110011', '01', '1110110']",1,3,5,10,0,15,1.7136752136752138,11,8
"['00100', '1111010', '010110', '11111', '110']",1,5,10,16,2,26,5.5062937062937065,31,31
"['010', '1', '11101', '00011']",1,4,6,8,2,14,2.5666666666666664,20,11
"['101000', '10101', '10110', '010010', '1101010']",1,5,15,14,4,29,7.747552447552448,21,29
"['0', '0011', '1010100']",1,3,7,5,0,12,1.0136363636363637,13,7
"['11110', '111', '11101', '010111', '011010', '001011', '101001']",1,7,13,24,6,37,12.592929292929293,55,68
"['11010', '011010', '0111']",1,3,6,9,0,15,2.375757575757576,6,13
"['101010', '1110010', '1', '011']",1,4,7,10,0,17,2.717765567765568,23,15
"['011011', '0100', '0']",1,3,6,5,0,11,1.2857142857142856,11,9
"['101100', '0010100', '00', '1000', '1101', '1100', '01000']",1,7,20,12,3,32,13.163891663891663,52,77
"['011', '11', '100', '10000', '001010']",1,5,11,8,2,19,5.197835497835498,29,25
"['0', '0101', '0011110', '001011']",1,4,9,9,0,18,3.0503996003996003,22,16
"['11011', '011', '01100', '1000', '1100', '01000']",1,6,14,12,5,26,9.62936507936508,32,49
"['010', '10001', '11100', '101110', '01100']",1,5,12,12,3,24,6.416666666666667,25,24
"['0', '100', '1100', '110101']",1,4,7,7,0,14,3.5095238095238095,16,14
"['0010001', '1011101', '111111', '000', '110', '01000']",1,6,15,16,4,31,7.037434787434788,56,36
"['11010', '1010', '011111', '1011', '0110010']",1,5,10,16,2,26,6.572455322455323,26,32
"['1000001', '1001', '100', '1111']",1,4,9,9,2,18,3.3337662337662337,18,26
"['11100', '0110110', '1']",1,3,5,8,0,13,1.25,13,4
"['1001', '1', '10', '000011']",1,4,7,6,0,13,2.869047619047619,19,15
"['00100', '01', '0001100', '11']",1,4,10,6,2,16,3.079365079365079,20,15
"['0010110', '011', '00011', '11000', '10000', '1010', '1001001', '01010', '11111', '1011']",1,10,25,25,9,50,26.881240981240982,125,126
"['010001', '11', '00', '1000011', '110', '1110']",1,6,12,12,2,24,7.323343323343323,50,39
"['0', '1011101', '110']",1,3,4,7,0,11,1.35,12,4
"['1000010', '101', '1010']",1,3,8,6,0,14,2.1844155844155844,8,12
"['10101', '010', '0010', '00000']",1,4,12,5,2,17,3.84047619047619,13,16
"['010001', '0011', '10001', '0101010', '010110', '01110']",1,6,18,15,4,33,10.098368298368298,36,48
"['1101', '10', '000', '01001', '000111']",1,5,11,9,0,20,5.334415584415584,29,24
"['0001', '00', '010101', '10', '110']",1,5,10,7,2,17,4.83015873015873,25,24
"['11001', '0100010', '1111']",1,3,7,9,0,16,1.6969696969696968,10,6
"['01', '100', '010011']",1,3,6,5,0,11,1.5666666666666667,9,7
"['0', '10101', '110', '011110']",1,4,6,9,0,15,2.6493506493506493,20,12
"['0', '1000', '000011', '111101']",1,4,9,8,2,17,2.3047619047619046,25,13
"['1001001', '10001', '00000']",1,3,12,5,2,17,2.1,7,8
"['01101', '1111101', '0101010', '0111', '0000111', '1010001', '01000', '0110011']",1,8,23,26,7,49,17.706060606060607,89,84
"['1', '1010111', '1001100', '110', '0100']",1,5,10,12,2,22,4.776623376623377,37,22
"['1110111', '001', '1011101', '000101', '01100']",1,5,12,16,2,28,5.134332334332335,35,25
"['0000101', '1011', '01', '11011']",1,4,8,10,0,18,3.6168831168831166,19,19
"['0', '1101', '1011100', '0100']",1,4,8,8,2,16,2.8227272727272728,21,12
"['11001', '0011', '11']",1,3,4,7,0,11,1.9047619047619047,8,13
"['1011001', '0001', '1101', '1010', '1110110']",1,5,11,15,5,26,6.282467532467533,30,30
"['101', '1101', '001010', '11']",1,4,6,9,0,15,4.09047619047619,14,16
"['110001', '100101', '000111']",1,3,9,9,3,18,2.1666666666666665,8,10
"['00101', '11', '0110', '1110001', '101001']",1,5,11,13,0,24,5.809346209346209,31,26
"['0110', '0000001', '01010']",1,3,11,5,0,16,1.5858585858585859,10,10
"['101110', '10', '111', '0100']",1,4,6,9,0,15,3.119047619047619,17,12
"['0001001', '0010', '1', '1011110', '101011', '1001', '100010']",1,7,18,17,6,35,11.877505827505829,71,59
"['101', '0001010', '101111', '110101']",1,4,9,13,2,22,3.6769230769230767,20,17
"['0', '101', '01000', '111011']",1,4,7,8,0,15,2.6493506493506493,21,8
"['0', '0010', '101010', '0011', '0010011', '1011', '1101']",1,7,15,15,4,30,11.646553446553447,60,59
"['010', '111', '0011', '01111', '10110', '111001']",1,6,9,17,4,26,9.075180375180375,39,44
"['11011', '0011', '1001', '1000', '000010', '111000']",1,6,16,13,5,29,8.786868686868686,43,46
"['1101', '1000', '1']",1,3,4,5,2,9,1.3,8,8
"['010', '1', '10000', '0011111', '000111']",1,5,11,11,0,22,4.361510711510712,41,24
"['101', '110011', '10011', '0000', '1010001']",1,5,13,12,0,25,6.0372682872682875,28,34
"['1011', '00', '01111', '1001111']",1,4,6,12,0,18,3.290764790764791,19,17
"['1001110', '01', '00001', '101', '100', '0100']",1,6,14,10,2,24,8.667676767676767,41,40
"['010', '00101', '101101', '1111', '00', '0111101']",1,6,11,16,0,27,8.37132312132312,44,36
"['001', '111100', '1111011']",1,3,5,11,0,16,1.6136752136752137,12,12
"['001', '101', '10101', '100', '000', '011111', '11100']",1,7,13,15,6,28,11.440909090909091,55,60
"['1', '0110100', '00000']",1,3,9,4,0,13,0.5833333333333333,14,6
"['1001010', '101', '10001', '1000111', '00', '000001', '0000110', '01110']",1,8,25,17,5,42,16.150555000555002,92,77
"['100110', '1101', '001']",1,3,6,7,0,13,1.838095238095238,8,7
"['01', '100100', '0110', '111']",1,4,7,8,0,15,2.9825396825396826,17,11
"['11010', '110010', '101', '10100', '11101', '110']",1,6,11,16,5,27,10.813636363636364,32,49
"['1011001', '10001', '100', '10110', '00', '111001']",1,6,14,14,2,28,10.131590631590631,40,50
"['1101', '11011', '000', '0011000']",1,4,10,9,0,19,3.07005772005772,20,18
"['0010110', '0001', '1101000']",1,3,11,7,2,18,1.6623376623376622,11,10
"['0', '101101', '01010', '001001', '110']",1,5,11,10,2,21,5.137085137085137,33,20
"['0001110', '110', '10110', '0111']",1,4,8,11,0,19,3.982034632034632,16,19
"['0', '1010', '111']",1,3,3,5,0,8,0.9714285714285714,8,4
"['101', '00110', '000110', '0110']",1,4,10,8,0,18,4.113852813852814,14,23
"['00100', '0110', '01111', '11101', '10011', '000', '110']",1,7,14,16,6,30,11.628571428571428,55,53
"['00110', '000100', '01010', '00000']",1,4,16,5,3,21,4.363636363636363,11,35
"['11', '001110', '011111', '11100', '01011', '011000']",1,6,12,18,5,30,8.694372294372295,46,45
"['1110111', '111100', '110001', '1011100', '000']",1,5,12,17,4,29,5.861294261294262,35,33
"['01', '1101', '1110011', '0001']",1,4,7,10,2,17,3.55050505050505,18,19
"['101000', '1000', '01010', '110', '01011']",1,5,13,10,2,23,5.9997113997113996,23,29
"['1010111', '00110', '001101']",1,3,8,10,0,18,2.0372960372960374,7,8
"['00', '001', '1100110']",1,3,7,5,0,12,1.8444444444444446,10,8
"['000111', '1', '10', '1001010']",1,4,8,8,0,16,2.512210012210012,25,14
"['1010001', '1010010', '0110']",1,3,10,8,2,18,1.5844155844155843,9,9
"['111', '00110', '00', '00010', '1100']",1,5,11,8,2,19,5.042063492063492,27,32
"['11', '01', '001', '0000']",1,4,7,4,2,11,2.604761904761905,13,13
"['000110', '100', '0000']",1,3,10,3,0,13,1.8158730158730159,8,15
"['101', '01', '0011', '11']",1,4,4,7,2,11,4.004761904761905,9,17
"['0111010', '11', '00100', '110001', '0101010', '010011']",1,6,17,16,4,33,8.623154623154623,49,38
"['11110', '11011', '001101', '100', '10110']",1,5,9,15,3,24,6.394444444444445,25,26
"['0', '0111111', '11001']",1,3,4,9,0,13,0.9166666666666666,14,5
"['11001', '101100', '11011', '00000', '10100']",1,5,14,12,4,26,5.927272727272728,25,29
"['0', '00101', '110111', '1110110', '000111']",1,5,10,15,2,25,4.8249250749250745,37,28
"['010', '0101100', '111001']",1,3,8,8,0,16,1.8136752136752137,11,6
"['001', '1111101', '0100010', '100110', '10', '11100']",1,6,14,16,2,30,8.052292152292152,55,36
"['010100', '00011', '0110', '10', '110']",1,5,11,9,0,20,6.0660894660894655,27,29
"['1111100', '1011', '11']",1,3,3,10,0,13,1.4747474747474747,11,13
"['0', '101111', '1111']",1,3,2,9,0,11,1.0857142857142859,11,10
"['10001', '110001', '100', '0001', '1101']",1,5,12,10,2,22,7.124170274170274,19,44
"['011111', '0000000', '00011']",1,3,11,7,0,18,1.1993006993006992,13,11
"['110000', '000001', '0111']",1,3,10,6,2,16,1.4666666666666668,12,10
"['1001010', '10011', '000', '1011011', '1100']",1,5,13,13,2,26,5.9004329004329,30,29
"['000001', '000111', '111', '01110']",1,4,10,10,2,20,3.396464646464646,19,16
"['011101', '101', '1111010', '0011010']",1,4,9,14,2,23,4.119413919413919,17,16
"['00100', '11110', '010001', '1']",1,4,9,8,2,17,2.4432900432900433,23,10
"['01', '00110', '00001', '0111100']",1,4,11,8,2,19,3.187301587301587,22,19
"['1010', '111111', '00', '010']",1,4,6,9,0,15,2.9460317460317462,19,12
"['1011', '001', '001110', '101001']",1,4,9,10,2,19,3.8047619047619046,17,16
"['1000', '01001', '1110000']",1,3,10,6,0,16,1.893939393939394,9,8
"['0', '10100', '0011101', '001000']",1,4,12,7,0,19,2.7117049617049616,24,20
"['00001', '001', '110101']",1,3,8,6,0,14,1.558080808080808,8,11
"['0001', '10101', '001011', '10']",1,4,9,8,0,17,3.1764790764790765,16,15
"['1011010', '100101', '000', '0100']",1,4,12,8,0,20,3.445088245088245,16,13
"['1000100', '011100', '0110', '00', '1000011']",1,5,16,10,2,26,5.402009102009102,38,31
"['0011101', '011', '101', '1011101', '1100100', '0011111', '01001', '101111']",1,8,17,28,6,45,17.7018648018648,90,97
"['11', '101', '1000', '001001', '11100', '1101010']",1,6,13,14,0,27,8.80874680874681,45,42
"['0010001', '10111', '110001', '00', '100011', '110', '101110']",1,7,17,18,3,35,11.98975468975469,69,63
"['0101000', '011', '010010']",1,3,10,6,0,16,2.0358974358974358,9,12
"['0', '001', '1100']",1,3,5,3,0,8,1.4714285714285715,8,7
"['0010', '100001', '011', '00', '11111']",1,5,10,10,0,20,4.268398268398268,33,20
"['1010110', '011010', '0000010']",1,3,12,8,2,20,1.6593406593406594,9,12
"['0011', '101', '10', '0001011', '1011000', '1100111', '1100', '101110', '0100101', '1011111']",1,10,23,31,7,54,26.559218559218557,157,144
"['010', '10010', '00101']",1,3,8,5,2,13,2.3,6,8
"['110011', '10010', '000']",1,3,8,6,0,14,1.9217171717171717,8,4
"['0', '1001', '110', '01011']",1,4,6,7,0,13,2.9714285714285715,16,11
"['10100', '00', '0110', '011']",1,4,8,6,0,14,3.4396825396825395,13,18
"['0', '0011', '111']",1,3,3,5,0,8,0.9714285714285714,8,6
"['00', '1100', '01011']",1,3,6,5,0,11,1.6825396825396823,8,9
"['100', '1100', '0111', '1111']",1,4,5,10,3,15,3.1785714285714284,13,21
"['0011001', '00111', '1010100', '1101100', '1011', '1101']",1,6,15,19,5,34,9.813492063492063,44,52
"['00110', '11011', '0000']",1,3,8,6,2,14,1.488888888888889,9,6
"['111111', '001', '0010101', '1001']",1,4,8,12,0,20,3.086358086358086,21,20
"['0', '1001', '100111', '001100', '1011']",1,5,10,11,4,21,5.588095238095238,31,22
"['01101', '100', '1011100', '0111', '000000']",1,5,14,11,0,25,4.984315684315685,34,29
"['010', '0100111', '00101', '00001', '0011', '1111', '0111111', '10010']",1,8,18,22,7,40,15.974025974025974,82,81
"['01', '0001', '011101', '10100', '10011']",1,5,11,11,2,22,5.511544011544011,30,26
"['0', '1001101', '111', '00001']",1,4,8,8,0,16,1.9333333333333333,24,11
"['110', '1', '0010011']",1,3,5,6,0,11,1.15,13,7
"['1000001', '00', '1010100', '1111000']",1,4,14,9,3,23,3.0476190476190474,25,16
"['0', '1110001', '10011']",1,3,6,7,0,13,1.25,13,5
"['01', '10001', '1100100', '1101']",1,4,9,9,0,18,3.743145743145743,18,19
"['110010', '0110', '000000']",1,3,11,5,2,16,1.5,10,9
"['1011011', '110', '1111111']",1,3,3,14,2,17,1.5714285714285714,11,13
"['01', '100', '0000110', '000']",1,4,11,4,2,15,2.911111111111111,19,21
"['010', '1', '1111001']",1,3,4,7,0,11,1.15,13,4
"['0', '011', '111', '01001', '00010']",1,5,9,8,4,17,4.433333333333334,28,21
"['101', '1101110', '010110', '0001010', '110']",1,5,12,14,4,26,6.30989010989011,31,29
"['0110111', '1001', '1010101', '0110', '0000101', '001110', '0111', '0000', '1100111']",1,9,24,26,8,50,21.534265734265734,111,101
"['01', '0101101', '10111', '00110', '0111101', '111101']",1,6,11,21,4,32,9.772105672105672,41,47
"['0001', '1111', '100111', '110', '0110110', '1110']",1,6,10,18,3,28,8.06047841047841,43,48
"['0', '0111000', '01011']",1,3,7,6,0,13,1.0833333333333333,14,9
"['01', '01111', '0101100']",1,3,6,8,0,14,1.5158730158730158,11,9
"['101010', '101', '111', '001100']",1,4,8,10,4,18,3.388888888888889,18,12
"['01', '01011', '0110011']",1,3,6,8,0,14,1.5158730158730158,10,11
"['0010', '100', '000', '11']",1,4,8,4,2,12,2.8285714285714283,12,15
"['01001', '001', '1101100']",1,3,8,7,0,15,1.8166666666666667,11,9
"['0', '0001', '1010101', '10011', '001001']",1,5,13,10,0,23,5.2291874791874795,32,24
"['010', '11', '0001', '1100000', '1010']",1,5,12,8,2,20,5.263924963924964,31,24
"['01', '001', '011', '10001', '100100', '0000']",1,6,15,8,2,23,9.083621933621934,36,40
"['0', '111110', '100001', '0111']",1,4,7,10,2,17,2.3047619047619046,25,12
"['01100', '01', '1011', '011110']",1,4,7,10,0,17,3.732034632034632,17,14
"['1111101', '101000', '000', '1011', '110']",1,5,10,13,2,23,4.708580308580308,34,27
"['111010', '111111', '00', '01100', '1110']",1,5,8,15,2,23,5.229004329004329,31,32
"['00101', '0011', '100', '1001', '1111000', '110100', '11101']",1,7,16,18,4,34,12.82962037962038,60,69
"['110000', '1010110', '1', '101', '101001']",1,5,11,12,2,23,4.92997557997558,37,34
"['0', '01101', '101010', '100', '011110', '0001011']",1,6,14,14,2,28,6.848856698856698,55,37
"['01', '001', '01100', '11']",1,4,6,6,2,12,3.342857142857143,13,13
"['01101', '1011011', '100111']",1,3,6,12,0,18,2.3298368298368297,7,10
"['0011101', '011011', '00110', '111110', '10010', '1001100', '1001111', '0100']",1,8,21,26,7,47,17.833189033189033,83,83
"['00100', '11101', '101', '00001']",1,4,10,8,3,18,3.15,16,16
"['0', '00111', '100', '001010']",1,4,9,6,0,15,3.012987012987013,20,18
"['101000', '0011', '10011']",1,3,8,7,0,15,1.8343434343434342,8,11
"['01', '110110', '10001', '111100']",1,4,8,11,2,19,3.079004329004329,21,14
"['10111', '1100', '1']",1,3,3,7,0,10,1.1777777777777778,10,9
"['1000', '000', '011000']",1,3,10,3,0,13,2.3238095238095235,6,19
"['00100', '100', '110', '01110']",1,4,9,7,4,16,3.7666666666666666,13,19
"['0', '1001', '1000111', '1111010', '0111111', '110111', '1011', '00010']",1,8,15,26,5,41,14.462626262626262,102,82
"['00', '000100', '011']",1,3,8,3,0,11,1.3444444444444446,10,12
"['1001010', '1', '000']",1,3,7,4,0,11,0.85,13,4
"['0', '1011', '010001', '000010']",1,4,11,6,2,17,2.8047619047619046,22,10
"['00', '001', '0111', '1111']",1,4,5,8,2,13,2.7404761904761905,14,16
"['01', '0001', '1101000']",1,3,8,5,0,13,1.6565656565656566,11,9
"['0', '110000', '101010']",1,3,8,5,2,13,1.2380952380952381,13,6
"['010001', '100001', '000011', '11', '10111', '1110011']",1,6,15,17,3,32,9.165057165057165,47,62
"['101100', '110110', '111100', '11', '1010', '01001', '000111']",1,7,15,20,4,35,12.883549783549784,65,60
"['01', '110', '111', '000']",1,4,5,6,3,11,2.2,12,12
"['101', '00100', '1100']",1,3,7,5,0,12,1.7380952380952381,7,7
"['101', '1010001', '000']",1,3,8,5,2,13,1.5333333333333332,10,7
"['0', '101100', '10100']",1,3,7,5,0,12,1.528138528138528,10,10
"['11011', '110001', '0110100']",1,3,8,10,0,18,2.163170163170163,8,7
"['1', '1100010', '101', '0001101', '1100']",1,5,11,11,2,22,5.158441558441559,38,28
"['010', '001', '101010', '101000', '100101', '1110100', '01100']",1,7,20,16,5,36,13.123737373737374,59,56
"['0', '1110111', '1100', '10010']",1,4,7,10,0,17,2.6954545454545453,23,12
"['01', '100', '001', '0001111']",1,4,8,7,2,15,3.311111111111111,19,16
"['0010', '01', '1111010', '0000111', '1101']",1,5,11,13,4,24,5.332611832611833,39,26
"['10111', '1', '01100']",1,3,4,7,2,11,1.2666666666666666,11,4
"['010', '1', '100101', '1001111', '01100']",1,5,10,12,0,22,5.0003996003996,36,20
"['1', '111010', '00001', '0111111', '0000010']",1,5,13,13,2,26,4.011988011988012,44,25
"['11', '10000', '1111001', '01010', '0001011']",1,5,13,13,4,26,5.1079365079365076,39,25
"['01101', '111011', '00', '010111', '10', '1100110', '1011000', '0100']",1,8,18,21,6,39,16.227577977577976,94,71
"['1011', '1001', '10']",1,3,4,6,2,10,2.083333333333333,5,11
"['0101011', '00101', '011000']",1,3,10,8,0,18,1.6736596736596736,8,8
"['1011110', '11000', '0001', '1001', '10111', '1011']",1,6,12,17,5,29,9.147474747474748,40,56
"['0', '000111', '111100']",1,3,6,7,2,13,1.0714285714285714,15,9
"['000011', '000101', '0001101', '00', '1100101', '0111', '000100']",1,7,23,15,5,38,13.104107004107004,64,80
"['1110010', '111100', '1001', '0000', '110101']",1,5,13,14,4,27,6.177855477855478,30,25
"['11001', '110001', '10', '11']",1,4,6,9,2,15,3.551948051948052,16,27
"['001101', '01', '100001', '000001']",1,4,13,7,3,20,3.3333333333333335,18,22
"['01101', '1100100', '1010101']",1,3,9,10,2,19,1.880952380952381,9,8
"['01', '111', '0001', '1010100', '1000', '10011', '0000', '1011']",1,8,18,15,4,33,14.325396825396824,72,85
"['0', '00110', '0101111', '1011100']",1,4,9,11,2,20,2.880952380952381,25,15
"['110', '000001', '111']",1,3,6,6,2,12,1.1111111111111112,11,8
"['0111000', '0101011', '1010', '10100', '01001', '1010010']",1,6,19,16,5,35,10.712698412698412,40,47
"['1110101', '100', '011']",1,3,5,8,2,13,1.3333333333333333,11,7
"['1000010', '101', '1000110', '1010000']",1,4,15,9,3,24,4.085714285714285,18,22
"['01101', '010', '00001', '100', '0111']",1,5,11,9,4,20,5.507142857142857,24,26
"['0', '10', '111001']",1,3,4,5,0,9,1.4523809523809523,10,4
"['00010', '00101', '11']",1,3,7,5,2,12,1.657142857142857,9,5
"['01', '000111', '0010']",1,3,7,5,0,12,1.7666666666666666,9,7
"['1010', '100', '110001']",1,3,7,6,0,13,2.123809523809524,7,7
"['11010', '001', '111', '0011', '1100']",1,5,8,11,4,19,5.988095238095238,23,34
"['0', '0111111', '100']",1,3,4,7,0,11,0.95,14,6
"['0111011', '11', '0110', '01010', '0001000']",1,5,13,12,2,25,5.828282828282828,34,27
"['1', '00101', '0111011', '0001', '100100', '0101001']",1,6,16,14,2,30,7.728438228438228,52,38
"['1011', '0000110', '110', '10']",1,4,8,8,0,16,3.627994227994228,18,16
"['11110', '1001010', '011011', '0000001', '11101', '0111', '0100']",1,7,18,20,6,38,10.864779664779665,68,56
"['0111', '001', '01010', '0100']",1,4,9,7,2,16,3.698412698412698,11,19
"['000000', '10001', '0011100', '01010']",1,4,16,7,2,23,3.472960372960373,20,16
"['0000111', '101', '10']",1,3,6,6,0,12,1.4222222222222223,12,7
"['0000', '10111', '1010', '11']",1,4,7,8,2,15,2.626984126984127,17,14
"['000001', '001', '10']",1,3,8,3,0,11,1.3166666666666667,10,9
"['001', '010000', '1100']",1,3,9,4,0,13,1.615873015873016,10,9
"['0', '110010', '01']",1,3,5,4,0,9,1.4523809523809523,10,6
"['100110', '1101', '0000000']",1,3,11,6,0,17,1.2433566433566434,13,4
"['111100', '1', '00011', '10', '000000']",1,5,12,8,2,20,3.563852813852814,41,26
"['0', '1100', '1100101', '1011110']",1,4,8,11,2,19,2.601298701298701,26,13
"['0', '0110', '0010101']",1,3,7,5,0,12,1.3772727272727274,12,8
"['11011', '11', '100100', '10000', '00']",1,5,11,9,4,20,4.568831168831169,31,29
"['0000011', '1010', '1111110']",1,3,8,10,2,18,1.012987012987013,15,8
"['001', '011', '11111']",1,3,3,8,2,11,1.4166666666666665,8,8
"['001', '010111', '00101', '1']",1,4,7,8,0,15,3.040764790764791,18,15
"['1001', '111100', '11']",1,3,4,8,0,12,1.7666666666666666,10,10
"['0000111', '01011', '0111']",1,3,7,9,0,16,2.0606060606060606,7,12
"['1000', '1011001', '0111']",1,3,7,8,2,15,1.5227272727272727,10,7
"['01', '1011001', '001010', '000000']",1,4,14,7,2,21,2.784188034188034,24,13
"['110010', '0101', '100']",1,3,7,6,0,13,1.838095238095238,8,6
"['0', '10', '011', '111101']",1,4,4,8,0,12,2.7968253968253967,18,11
"['1010', '10000', '1010011']",1,3,9,7,0,16,1.893939393939394,8,11
"['110110', '010', '10', '0111']",1,4,6,9,0,15,3.249206349206349,16,17
"['11001', '110', '10110']",1,3,5,8,2,13,2.1,7,10
"['101010', '00101', '0100', '111011']",1,4,10,11,2,21,3.806060606060606,15,11
"['001', '11', '00100', '1101100', '110011', '100101']",1,6,14,15,2,29,8.616988566988567,49,47
"['100111', '001110', '10', '101111']",1,4,7,13,3,20,3.8333333333333335,17,16
"['1001', '00101', '0111011', '00001']",1,4,11,10,2,21,3.4787878787878785,16,17
"['1', '0100101', '00000']",1,3,9,4,0,13,0.75,14,4
"['1', '111100', '001001', '01011', '0100']",1,5,11,11,2,22,4.962337662337663,34,25
"['001', '1000', '11101', '10011', '1010011', '001100', '0101', '01011', '111001']",1,9,21,24,7,45,22.246159396159396,95,114
"['000011', '0001', '10', '0111', '110101']",1,5,11,11,4,22,4.816666666666666,32,26
"['01', '0111', '0100']",1,3,5,5,2,10,1.8333333333333333,6,9
"['101', '00', '000111', '10']",1,4,7,6,2,13,2.8944444444444444,17,13
"['00110', '11010', '011']",1,3,6,7,2,13,1.85,8,8
"['101011', '1', '011']",1,3,3,7,0,10,1.4523809523809523,10,10
"['11111', '100', '10010', '110']",1,4,6,10,4,16,3.0666666666666664,15,17
"['101000', '10010', '10', '1111001']",1,4,10,10,0,20,3.5251970251970253,21,16
"['0001', '010', '01111', '1100100']",1,4,10,9,0,19,2.9946608946608944,21,15
"['0010001', '1', '001111', '110100', '000001', '101110']",1,6,17,15,4,32,6.674908424908425,60,41
"['011101', '00010', '110', '0']",1,4,8,7,0,15,2.831168831168831,20,15
"['001', '1000101', '10', '0011011', '00010']",1,5,14,10,2,24,6.0246031746031745,33,25
"['010100', '10101', '101111']",1,3,7,10,2,17,1.9545454545454546,8,6
"['001110', '0110', '011', '1011000']",1,4,10,10,0,20,4.266466866466867,16,19
"['110000', '001', '01010', '1110010']",1,4,12,9,0,21,3.3591297591297593,18,16
"['1110111', '001', '101', '111111', '001110']",1,5,7,18,4,25,5.482905982905983,34,31
"['00001', '00', '0010111', '001000']",1,4,14,6,0,20,3.1767121767121766,20,30
"['0001', '1111', '10', '0101', '1001111', '0100']",1,6,11,14,4,25,7.558080808080808,43,39
"['0100001', '1000', '100100', '0000110']",1,4,17,7,2,24,4.017782217782218,18,18
"['0010', '110', '1', '000', '11100']",1,5,9,7,2,16,4.68968253968254,25,25
"['1110000', '100100', '0110', '0000000', '10', '000111', '1100', '0101001']",1,8,27,16,7,43,14.866022866022867,102,87
"['1101001', '1', '000101', '011010', '1100']",1,5,12,12,2,24,5.046137196137196,37,22
"['01', '0110100', '110', '111']",1,4,6,9,2,15,3.111111111111111,18,13
"['01', '10110', '0010100', '10', '0010010']",1,5,14,9,4,23,5.611111111111111,36,30
"['1111010', '00', '100', '0010011']",1,4,10,9,2,19,3.317460317460317,23,18
"['01', '111111', '0111100']",1,3,4,11,0,15,1.3098290598290598,13,5
"['1011101', '001110', '0111', '000', '1101']",1,5,10,14,2,24,5.761871461871462,30,22
"['1111100', '1', '10']",1,3,3,7,0,10,1.3611111111111112,12,6
"['001', '0110', '011001', '1100', '01000']",1,5,13,9,2,22,6.72012987012987,23,32
"['100001', '1110001', '01001', '110', '1110']",1,5,12,13,0,25,6.136474636474636,29,36
"['11010', '111', '101', '1010101', '1111110', '1101110', '1000', '00']",1,8,14,24,5,38,15.333189033189033,90,82
"['000110', '010', '11011', '011', '10101', '0111']",1,6,11,15,4,26,10.002813852813853,35,37
"['1000001', '01111', '0000000', '1111', '001110', '10', '110']",1,7,18,16,2,34,9.640970140970142,82,54
"['110110', '111001', '00001']",1,3,8,9,2,17,1.5757575757575757,10,9
"['101', '001', '100', '0000011']",1,4,10,6,3,16,3.4,18,17
"['101', '11010', '0010111', '1']",1,4,6,10,0,16,2.933333333333333,22,15
"['1101101', '10', '1001111']",1,3,5,11,2,16,1.6031746031746033,12,10
"['010010', '0110', '10']",1,3,7,5,0,12,1.9666666666666668,8,12
"['1110111', '01', '0001110', '1011101', '1001101', '1111', '01001']",1,7,14,25,4,39,12.458152958152958,73,64
"['111', '00100', '101000', '10100', '01000']",1,5,15,9,3,24,6.38989898989899,24,36
"['111', '011011', '10101', '110001', '011101']",1,5,9,17,3,26,6.916666666666666,26,37
"['0', '0001', '11011', '1110010']",1,4,8,9,0,17,2.63989898989899,23,12
"['1011010', '1', '1000', '0111', '0110010', '0100']",1,6,14,13,5,27,8.238961038961039,49,36
"['101', '1010100', '0010100']",1,3,10,7,2,17,2.057142857142857,9,12
"['11010', '001', '00001', '11', '1111110']",1,5,9,13,2,22,4.218253968253968,38,29
"['0001', '10', '11111', '1101', '1100', '01110']",1,6,9,15,5,24,7.984920634920635,39,37
"['1011010', '1110010', '10101', '0010011', '0011011', '0100']",1,6,18,19,4,37,9.372294372294371,42,40
"['0000', '001', '01100', '11']",1,4,9,5,0,14,2.4873015873015873,16,15
"['0001', '011', '11']",1,3,4,5,0,9,1.7047619047619047,6,8
"['0010', '1', '00001', '10111', '0101011']",1,5,11,11,2,22,4.373232323232323,33,20
"['0', '100111', '0100']",1,3,6,5,0,11,1.2857142857142856,12,4
"['01', '00', '11111']",1,3,3,6,2,9,0.7857142857142857,10,4
"['11001', '11010', '001', '100', '10000', '01010']",1,6,15,11,6,26,9.916666666666666,33,40
"['110010', '001010', '10', '110111', '1100110']",1,5,12,15,3,27,6.239316239316239,32,35
"['00', '0101000', '110', '1001111']",1,4,10,9,2,19,2.5174603174603174,26,13
"['00', '110', '100000']",1,3,8,3,0,11,1.3444444444444446,10,8
"['11001', '0011011', '01001', '1111111']",1,4,8,16,4,24,3.3714285714285714,19,22
"['0', '111000', '101001']",1,3,7,6,2,13,1.2380952380952381,12,4
"['11001', '1111', '0110000', '111101', '100111', '0110110']",1,6,13,22,4,35,9.313586413586414,45,48
"['111', '00100', '1100010', '10110', '101110', '01100', '1110']",1,7,16,19,3,35,13.395954045954046,53,63
"['101', '00', '01111', '111001']",1,4,6,10,0,16,3.0796536796536795,19,13
"['101011', '00', '0100101']",1,3,8,7,0,15,1.7136752136752138,12,4
"['1111110', '011101', '00', '0011111', '01100']",1,5,10,17,2,27,5.564269064269064,36,33
"['1111101', '1', '1001100', '1001101', '1100011', '011010', '1001011']",1,7,17,25,5,42,11.909340659340659,79,72
"['1110111', '111000', '100011']",1,3,7,12,2,19,1.8974358974358974,10,16
"['0001100', '1000', '1', '1110']",1,4,9,7,2,16,2.6409090909090907,22,13
"['01001', '00', '1110100']",1,3,8,6,0,14,1.6825396825396823,12,8
"['010', '011100', '11', '00011', '0010011', '00010']",1,6,16,12,2,28,8.57070152070152,47,48
"['1100011', '01001', '10']",1,3,7,7,0,14,1.6825396825396823,11,6
"['111100', '011', '11', '10', '000010', '011000']",1,6,13,12,5,25,7.5055555555555555,50,40
"['0011', '01', '0000']",1,3,7,3,2,10,1.5,7,8
"['110010', '010', '0100111']",1,3,8,8,0,16,1.882051282051282,10,11
"['01', '00001', '10001', '1101', '1001111']",1,5,11,12,2,23,5.877200577200577,30,37
"['0110101', '00101', '11', '101', '1010100', '1101100']",1,6,14,17,3,31,9.540476190476191,50,47
"['1001010', '000100', '000']",1,3,12,4,0,16,2.0358974358974358,9,14
"['011', '0011000', '1000010', '11101', '100000', '1011', '001011']",1,7,21,17,4,38,11.786691086691087,70,63
"['00100', '001', '1100100', '101111']",1,4,11,10,0,21,3.452952602952603,20,20
"['0', '00101', '00001', '1101110', '111101']",1,5,11,13,2,24,4.16018981018981,39,24
"['0010', '000011', '10111', '000101', '1111', '0111']",1,6,13,16,5,29,8.824242424242424,38,47
"['0110', '0010100', '000', '1101', '0011100']",1,5,15,10,4,25,6.20974025974026,30,38
"['0010001', '101', '10000', '10', '0110011']",1,5,14,10,2,24,5.498412698412698,34,25
"['0110111', '1001010', '00011', '10101', '110']",1,5,12,15,4,27,5.838095238095238,32,25
"['0000', '01', '0001', '00001']",1,4,12,3,2,15,4.099206349206349,11,29
"['11001', '010', '111', '100', '0110', '01001', '01110', '110101']",1,8,15,19,6,34,18.33737373737374,63,73
"['01101', '1', '100', '010111', '01100', '0100']",1,6,12,12,2,24,8.632251082251083,40,43
"['011111', '0111000', '101100']",1,3,8,11,2,19,1.8846153846153846,10,10
"['00011', '1001101', '10', '0011100', '111001']",1,5,13,14,2,27,5.652292152292152,37,23
"['110000', '1110011', '0100', '011000']",1,4,13,10,2,23,4.009557109557109,17,17
"['101010', '101', '000', '00001']",1,4,11,6,2,17,3.2803030303030303,16,17
"['0010', '00101', '11', '101', '100010', '10011']",1,6,13,12,2,25,10.124386724386724,35,44
"['100101', '011', '111']",1,3,4,8,2,12,2.0,7,10
"['0110101', '1111101', '1110', '0011110', '00', '010111', '1100011', '01000', '110101']",1,9,21,30,6,51,20.20999000999001,119,105
"['0101111', '0010', '0101', '111110']",1,4,8,13,2,21,3.438111888111888,20,19
"['010', '001010', '10', '1101110']",1,4,9,9,0,18,3.6264957264957265,20,21
"['0100010', '010', '000111']",1,3,10,6,0,16,1.6598290598290597,11,12
"['0100', '10110', '000', '0110011']",1,4,11,8,0,19,3.532034632034632,17,17
"['101010', '1011', '01']",1,3,5,7,0,12,1.9666666666666668,8,8
"['01', '00001', '001000', '100', '1111']",1,5,12,8,0,20,4.224819624819625,32,25
"['0001011', '1', '000']",1,3,7,4,0,11,0.85,13,8
"['000110', '100000', '0000']",1,3,13,3,2,16,2.2666666666666666,7,20
"['00111', '0011', '00', '10', '0001011']",1,5,11,9,2,20,5.695526695526695,29,35
"['1010000', '11110', '01100', '0100']",1,4,12,9,2,21,3.6606060606060606,16,19
"['100111', '01011', '111']",1,3,4,10,0,14,1.893939393939394,8,15
"['100111', '1', '1111011']",1,3,3,11,0,14,1.151098901098901,14,15
"['00', '100100', '111']",1,3,6,5,0,11,0.9444444444444444,11,6
"['110010', '0110', '1001011']",1,3,8,9,0,17,1.9146853146853147,10,6
"['0001', '1001', '011']",1,3,6,5,2,11,1.8928571428571428,5,8
"['0001100', '0010', '01110']",1,3,10,6,0,16,2.0606060606060606,8,15
"['0', '11010', '1010', '110', '01011', '0100']",1,6,11,11,4,22,8.598412698412698,35,43
"['11110', '01', '0111010', '0001']",1,4,8,10,0,18,2.6493506493506493,21,15
"['1001100', '00', '0011000']",1,3,11,5,2,16,1.746031746031746,12,16
"['010001', '11', '101000', '10101', '01011', '0100']",1,6,15,13,4,28,9.77012987012987,38,42
"['11', '0101101', '0011', '10000', '010110']",1,5,12,12,0,24,5.8370740370740375,31,26
"['1011', '110', '10110', '00011']",1,4,7,10,2,17,3.976984126984127,14,21
"['110', '10', '000000']",1,3,8,3,0,11,1.2722222222222221,11,7
"['110010', '010001', '00101', '010111', '10']",1,5,13,12,3,25,6.086580086580087,30,25
"['010000', '1111101', '10', '1001']",1,4,9,10,0,19,3.064257964257964,23,12
"['01001', '100', '111011']",1,3,6,8,0,14,1.7398989898989898,9,6
"['1000', '001', '100101']",1,3,8,5,0,13,2.038095238095238,7,10
"['001101', '11', '000101', '10100', '110', '0111110']",1,6,13,16,2,29,8.361482961482961,48,37
"['0001101', '01', '100']",1,3,7,5,0,12,1.2444444444444445,12,8
"['11110', '1', '0110', '000', '0101']",1,5,8,9,2,17,4.387301587301587,28,21
"['1001', '100101', '1', '110']",1,4,6,8,0,14,3.0015873015873016,17,22
"['1010101', '100', '110100', '0001111', '0101010', '001010', '0000', '1001111']",1,8,25,22,6,47,17.526873126873127,88,84
"['11010', '001', '1110', '00000']",1,4,10,7,2,17,2.5746031746031743,17,16
"['01', '11', '11101', '001010', '000', '000100']",1,6,14,10,4,24,7.118614718614719,48,39
"['001100', '01', '010001', '0010111']",1,4,12,9,2,21,3.1752136752136755,22,17
"['11', '01010', '000', '100010']",1,4,10,6,0,16,3.0335497835497836,17,12
"['0', '10010', '011', '01110']",1,4,7,7,2,14,2.8166666666666664,18,17
"['0', '011', '1110100']",1,3,5,6,0,11,1.15,13,7
"['100', '1100000', '01111', '0010111']",1,4,11,11,2,22,2.5357142857142856,27,19
"['0', '101', '011', '0101001']",1,4,7,7,2,14,3.1166666666666667,20,12
"['00100', '0001', '010', '1011100']",1,4,12,7,0,19,3.618398268398268,18,20
"['10101', '10111', '00', '0110']",1,4,7,9,2,16,3.4349206349206347,15,10
"['0', '00010', '1101011']",1,3,7,6,0,13,1.0833333333333333,14,4
"['01', '10110', '0110']",1,3,5,6,0,11,2.126984126984127,6,10
"['1011', '1000', '011', '1101']",1,4,6,9,3,15,3.4642857142857144,12,19
"['1110001', '00', '10110']",1,3,7,7,0,14,1.6825396825396823,12,4
"['111', '00100', '0100101', '0011100', '0100']",1,5,15,11,2,26,6.1505772005772,31,36
"['110010', '001', '100100', '0001010', '0110010', '0101001', '111001']",1,7,24,18,6,42,14.880586080586081,60,61
"['000110', '000111', '0110']",1,3,9,7,2,16,2.2333333333333334,6,15
"['00', '1111000', '0111', '11']",1,4,6,9,2,15,2.4343434343434343,21,18
"['1010', '11110', '1', '0010']",1,4,6,8,2,14,2.772222222222222,16,14
"['110010', '111', '0011', '011101', '0000', '1100', '01011']",1,7,15,17,5,32,11.61154401154401,57,63
"['101010', '0', '1110', '11111']",1,4,5,11,0,16,2.297835497835498,20,15
"['101010', '110000', '1', '0000010']",1,4,13,7,2,20,2.565018315018315,25,15
"['00111', '10001', '111010']",1,3,7,9,2,16,1.690909090909091,10,8
"['010011', '11011', '10110', '011']",1,4,7,12,2,19,4.421212121212121,14,21
"['0001', '1', '001011']",1,3,6,5,0,11,1.2857142857142856,10,7
"['1101101', '10', '0100']",1,3,6,7,0,13,1.6565656565656566,11,4
"['1000001', '11011', '11', '110001', '10011', '00010']",1,6,15,15,3,30,8.957398157398158,44,60
"['010', '0100110', '11']",1,3,6,6,0,12,1.4444444444444444,11,7
"['000110', '11110', '101', '000']",1,4,9,8,2,17,2.7398989898989896,19,16
"['10101', '001010', '0110011', '11']",1,4,9,11,0,20,3.5251970251970253,21,12
"['00111', '1100010', '1011', '0101', '01100']",1,5,12,13,4,25,6.092424242424242,30,23
"['0', '001110', '10110', '1101110']",1,4,8,11,0,19,3.198884448884449,21,22
"['0001001', '1110010', '0001110', '111100', '1000']",1,5,17,14,3,31,6.1214785214785215,36,33
"['1', '111000', '010101', '000011']",1,4,10,9,3,19,2.357142857142857,27,15
"['1011010', '11', '0110', '1010', '111101']",1,5,8,15,2,23,6.451554001554001,29,27
"['0', '10001', '1001', '00001']",1,4,10,5,2,15,3.422222222222222,15,19
"['101', '11010', '11100']",1,3,5,8,2,13,2.05,7,7
"['110100', '0100', '1010', '0111111', '011000']",1,5,13,14,4,27,6.233682983682984,31,32
"['010', '001', '1', '1100011', '101111']",1,5,8,12,2,20,4.706654456654457,37,22
"['00', '001110', '101110']",1,3,7,7,2,14,1.8333333333333335,9,14
"['01', '100101', '1001010']",1,3,8,7,0,15,1.8675213675213675,10,12
"['00', '10', '0100']",1,3,6,2,2,8,1.8333333333333333,5,10
"['11011', '001', '01011', '1']",1,4,5,9,2,14,2.966666666666667,16,18
"['1101', '0011101', '01000', '0100']",1,4,11,9,2,20,3.4242424242424243,17,19
"['101011', '1', '110111']",1,3,3,10,2,13,1.4047619047619047,12,14
"['100', '01', '00', '1100']",1,4,7,4,2,11,3.557142857142857,10,18
"['111', '10001', '110100', '00', '0111', '01001']",1,6,12,13,2,25,8.283838383838384,43,40
"['1000110', '110001', '0000100', '101110']",1,4,15,11,4,26,3.82967032967033,19,13
"['110010', '0110110', '00011', '00', '0110001']",1,5,15,12,2,27,5.925185925185925,34,29
"['0001100', '1000', '0110']",1,3,10,5,2,15,1.7727272727272727,10,11
"['101011', '0001', '0101', '10']",1,4,8,8,2,16,3.2,15,14
"['1011', '1100', '1']",1,3,3,6,2,9,1.3,9,9
"['10111', '00', '010', '11']",1,4,5,7,2,12,2.557142857142857,15,10
"['01001', '1', '0000010', '011001']",1,4,12,7,0,19,2.8935231435231437,22,14
"['1', '10101', '0001', '0111', '0100001']",1,5,11,10,2,21,4.933838383838384,32,28
"['100110', '11110', '001111']",1,3,6,11,2,17,2.121212121212121,8,11
"['1000', '001', '1', '0000000']",1,4,12,3,0,15,2.416883116883117,23,17
"['01001', '001', '0011101', '1011000']",1,4,12,10,2,22,3.488095238095238,20,20
"['10111', '00', '11']",1,3,3,6,2,9,0.8571428571428571,9,6
"['0010', '001', '1101', '11']",1,4,6,7,2,13,3.3285714285714283,13,15
"['010', '10', '01100']",1,3,6,4,0,10,2.1214285714285714,6,10
"['01', '000111', '111']",1,3,4,7,0,11,1.5666666666666667,9,10
"['0', '0101', '01001', '0111001']",1,4,9,8,0,17,3.432828282828283,19,21
"['11', '00', '1111000', '1011100']",1,4,8,10,4,18,2.634920634920635,24,17
"['011', '00001', '10001', '0000011', '0101']",1,5,15,9,2,24,6.413708513708514,25,31
"['1001', '1011001', '11']",1,3,5,8,0,13,1.8383838383838382,10,16
"['0001', '1001', '111110', '0001000', '0100']",1,5,15,10,3,25,5.3076923076923075,33,28
"['0010', '0101011', '1111101']",1,3,7,11,2,18,1.3376623376623376,12,5
"['100100', '1', '0000011']",1,3,9,5,0,14,0.9972527472527473,15,7
"['1001110', '0101', '01001', '000100', '11100']",1,5,15,12,2,27,6.146386946386946,30,26
"['101101', '00011', '100', '10100', '00', '01011', '0100']",1,7,17,13,3,30,13.354761904761904,53,66
"['0011', '01111', '11']",1,3,3,8,0,11,1.9047619047619047,7,11
"['01', '00', '011', '0111110']",1,4,6,8,2,14,3.188888888888889,18,18
"['1000', '111110', '011', '101001']",1,4,8,11,2,19,2.7301587301587302,20,14
"['0010101', '00', '1001011', '0111100']",1,4,12,11,3,23,2.9047619047619047,25,15
"['1001110', '0101', '1001', '10110']",1,4,9,11,2,20,3.9393939393939394,16,20
"['10111', '11', '001000']",1,3,6,7,0,13,1.185064935064935,12,6
"['011100', '11', '000001', '0011011', '101001']",1,5,14,13,3,27,4.89957264957265,36,25
"['11', '100', '0110', '10100', '01001', '111000', '101110']",1,7,15,16,4,31,13.35974025974026,55,53
"['1000000', '0010', '0101001', '11']",1,4,13,7,2,20,2.3376623376623376,25,11
"['101011', '00', '100000']",1,3,9,5,2,14,1.5,11,7
"['1', '0101101', '0011', '100101', '1110100', '00010']",1,6,15,15,2,30,7.595104895104895,54,34
"['11001', '101100', '001', '100', '000001']",1,5,14,9,4,23,5.994949494949495,30,34
"['00100', '1000', '1', '001101']",1,4,10,6,0,16,2.812987012987013,20,16
"['110110', '1', '110111', '0010101']",1,4,7,13,2,20,2.8855311355311355,24,19
"['0111101', '001', '0110011']",1,3,7,10,2,17,1.7142857142857144,11,9
"['101000', '11011', '0000']",1,3,9,6,0,15,1.3676767676767676,9,8
"['1', '1001011', '0011000']",1,3,8,7,2,15,1.0714285714285714,16,4
"['01', '10111', '10101', '01111', '10000']",1,5,9,13,4,22,5.4,29,30
"['0100000', '01101', '010', '10', '011001', '1101']",1,6,15,12,0,27,9.647635697635698,42,43
"['001', '111', '0100100']",1,3,7,6,2,13,1.3333333333333333,11,5
"['0011', '01', '00101', '1010']",1,4,8,7,2,15,3.96031746031746,12,15
"['0100010', '01', '100', '1110000']",1,4,12,7,2,19,2.980952380952381,24,14
"['0011', '01', '011010', '11']",1,4,6,8,2,14,3.433333333333333,16,13
"['11001', '000', '111', '0111']",1,4,6,9,2,15,3.0595238095238093,15,17
"['001', '0110111', '10111', '001110', '010110', '11111']",1,6,11,21,4,32,8.776029526029527,39,43
"['001', '111', '0111110']",1,3,4,9,2,13,1.3333333333333333,11,4
"['00', '001', '0001000']",1,3,10,2,0,12,1.8444444444444446,10,16
"['01', '0011000', '101', '0010101', '100110']",1,5,14,11,2,25,6.108302808302808,36,26
"['011110', '1000', '111', '1001011']",1,4,8,12,0,20,2.941192141192141,21,14
"['0010001', '100', '1101101', '011001', '01001', '0000110', '101110']",1,7,22,19,5,41,13.52066267066267,67,57
"['110011', '101', '01', '1001111']",1,4,6,12,0,18,3.7803418803418802,20,22
"['1110110', '11100', '11']",1,3,4,10,0,14,1.8492063492063493,10,13
"['1001110', '001', '0101101', '10', '001011']",1,5,12,13,2,25,5.7083028083028085,37,25
"['011011', '101', '00110', '1101011']",1,4,8,13,0,21,3.92983682983683,19,14
"['110110', '11101', '00101']",1,3,6,10,2,16,1.8727272727272726,9,9
"['11010', '010', '00011', '1010', '00', '1011000']",1,6,15,11,2,26,9.388383838383838,42,48
"['100110', '00', '1']",1,3,5,4,0,9,0.7857142857142857,11,4
"['1011', '011010', '110', '011000']",1,4,9,10,2,19,3.938095238095238,16,15
"['0101111', '111', '0110', '10', '0000']",1,5,9,11,2,20,4.424963924963925,33,24
"['0010111', '100', '001110', '0000', '1101', '111001']",1,6,15,15,4,30,8.292313242313242,50,41
"['01100', '1011010', '0111011']",1,3,8,11,2,19,2.071428571428571,8,8
"['0', '11', '10111', '1101000', '010011']",1,5,9,12,0,21,4.227577977577978,39,27
"['01', '01010', '1100', '0111']",1,4,7,8,2,15,3.4047619047619047,15,16
"['0011001', '0110', '0000']",1,3,10,5,2,15,1.9545454545454546,8,10
"['01', '0101000', '100110', '01010', '0000', '111101']",1,6,17,13,2,30,8.210977910977912,51,42
"['001', '10111', '11000', '1110110', '00', '1101']",1,6,11,15,2,26,8.2002886002886,46,42
"['001100', '11100', '011001']",1,3,9,8,2,17,2.287878787878788,6,10
"['011', '10011', '101101']",1,3,5,9,0,14,2.143939393939394,7,11
"['01', '110', '10', '1111110']",1,4,4,10,2,14,2.966666666666667,20,17
"['100001', '101', '1111', '1000010', '1000', '000010', '000000', '111000']",1,8,27,15,6,42,16.092313242313242,85,97
"['010000', '011', '0011', '101000', '010101', '1011']",1,6,16,13,5,29,9.386507936507936,40,44
"['0', '101', '111001']",1,3,4,6,0,10,1.4523809523809523,10,5
"['0', '0011110', '1000101', '001001']",1,4,12,9,2,21,2.741758241758242,27,13
"['1011', '00010', '1']",1,3,5,5,0,10,1.1777777777777778,10,4
"['00111', '1100101', '000', '011001', '00010']",1,5,15,11,2,26,6.2697358197358195,29,27
"['11001', '1101001', '11', '10', '001011']",1,5,9,13,2,22,5.5259185259185255,33,39
"['11000', '01', '00', '1010000']",1,4,11,5,2,16,3.079365079365079,20,18
"['10111', '10100', '1', '1110000']",1,4,8,10,2,18,2.683333333333333,24,19
"['0', '0110', '10010', '10011', '1010011']",1,5,11,11,2,22,5.495454545454545,32,26
"['0', '10111', '0110111']",1,3,4,9,0,13,1.4166666666666667,12,8
"['001111', '1011001', '0001100', '1000', '0000111', '101110']",1,6,19,18,5,37,9.14918414918415,49,47
"['11001', '11', '1101101', '1000', '000010', '101001']",1,6,15,15,2,30,8.542796092796092,46,48
"['0', '1011', '0100000', '011']",1,4,9,6,0,15,2.770779220779221,22,13
"['1010', '100', '000', '0001111']",1,4,10,7,2,17,3.4588744588744587,18,20
"['1101', '001', '111101']",1,3,4,9,0,13,1.8158730158730159,8,14
"['100110', '0101', '10110', '10']",1,4,8,9,0,17,3.913852813852814,17,20
"['0010', '000011', '11000', '11101', '001110']",1,5,14,12,4,26,5.959595959595959,31,30
"['0', '10001', '100000', '011']",1,4,10,5,0,15,2.5685425685425685,21,13
"['010000', '0010111', '0011000', '0110', '10010', '000', '110']",1,7,22,13,4,35,12.543395493395494,65,79
"['1010', '110', '011', '0111']",1,4,5,9,4,14,3.738095238095238,11,18
"['1101', '0101111', '110', '111']",1,4,4,13,2,17,3.9264069264069263,16,26
"['0010', '111', '00100', '111110', '01010', '0101001', '1110']",1,7,16,18,4,34,11.714690864690864,57,69
"['0', '101', '100', '0110']",1,4,6,5,2,11,3.2095238095238097,13,11
"['1111010', '10', '01000', '11']",1,4,7,9,2,16,2.746031746031746,22,13
"['1000000', '0101', '0101011']",1,3,11,7,2,18,1.5194805194805194,13,9
"['100001', '011', '11', '00100', '0000', '11100']",1,6,15,10,2,25,7.711544011544011,43,40
"['0110010', '0110110', '01100']",1,3,10,9,2,19,2.5238095238095237,5,23
"['010', '001', '0110001']",1,3,8,5,2,13,1.8666666666666667,10,9
"['0101000', '10000', '1001101', '10', '0111101']",1,5,15,13,3,28,5.428571428571428,38,28
"['1011110', '0001010', '0010']",1,3,10,8,2,18,1.6623376623376624,10,13
"['1100', '000101', '1', '00000']",1,4,11,5,0,16,2.2574314574314576,22,17
"['01', '0100000', '00', '01011']",1,4,11,5,2,16,3.0317460317460316,21,20
"['001', '101', '1010100', '1011', '011010', '1100', '1101010']",1,7,16,18,6,34,13.4000555000555,58,58
"['0', '100001', '10110', '01110']",1,4,9,8,2,17,2.6614718614718615,23,13
"['01', '010', '11010', '00', '01110']",1,5,9,8,4,17,6.485714285714286,21,33
"['0', '01101', '011100']",1,3,6,6,0,12,1.3463203463203464,11,10
"['01', '0001', '01000', '11']",1,4,8,5,2,13,3.0238095238095237,15,14
"['1101', '01101', '1']",1,3,3,7,0,10,1.6222222222222222,8,11
"['0010', '010', '100001', '0011', '10011']",1,5,13,9,2,22,6.605844155844156,22,25
"['0001010', '10101', '00001']",1,3,11,6,2,17,1.7333333333333334,7,7
"['01', '111', '11000', '0011', '0001']",1,5,9,9,2,18,5.237301587301587,26,30
"['01', '010001', '011110']",1,3,7,7,2,14,1.5,12,10
"['110000', '11001', '01', '111', '010011', '000100']",1,6,15,13,3,28,7.749206349206349,49,44
"['1110111', '0000100', '11', '1010', '110']",1,5,10,13,2,23,5.081385281385281,37,27
"['1010', '1100', '111001']",1,3,6,8,2,14,2.15,7,7
"['11110', '0001100', '000', '001001', '01110']",1,5,15,11,2,26,5.661655011655012,32,39
"['01', '0000000', '0110000', '1010011', '1011', '01001']",1,6,20,12,3,32,7.5894660894660895,56,40
"['0010010', '1110010', '110', '10011']",1,4,11,11,2,22,3.5476190476190474,19,19
"['00100', '000', '1011', '1001011', '0100']",1,5,14,9,2,23,5.97987012987013,27,30
"['0001', '001111', '1110']",1,3,6,8,2,14,1.45,10,9
"['00', '001', '1101']",1,3,5,4,0,9,1.7047619047619047,6,7
"['0010', '1010010', '0111110', '0011100']",1,4,13,12,3,25,3.571428571428571,20,26
"['0101', '100', '01010']",1,3,7,5,0,12,2.2103174603174605,5,9
"['100101', '1100', '110100', '00001']",1,4,12,9,2,21,3.2535353535353533,16,19
"['010', '0111010', '011', '00011', '0001111', '1001101', '0010010']",1,7,20,19,6,39,13.183333333333334,69,62
"['10110', '000011', '110101']",1,3,8,9,2,17,1.7727272727272727,11,7
"['01', '0101110', '0001000', '1111']",1,4,10,10,2,20,2.520923520923521,25,11
"['110111', '1111110', '0111100', '11']",1,4,5,17,2,22,3.1800976800976803,22,19
"['0111010', '00000', '101', '10', '0111', '0100']",1,6,14,11,2,25,7.462409812409812,45,39
"['001', '101', '100', '11101', '0000', '0110001', '1110']",1,7,15,14,5,29,11.525829725829725,56,57
"['011001', '00101', '1010010', '11101', '10', '0000', '0100011']",1,7,20,16,4,36,11.22932622932623,65,50
"['010100', '11110', '10001', '0010011', '0111111', '10']",1,6,14,18,4,32,7.277955377955378,57,37
"['0101', '1001', '00101', '10']",1,4,8,7,2,15,3.96031746031746,12,18
"['0', '11010', '0001110', '00100', '0110000', '011110', '0101100']",1,7,22,16,5,38,11.226623376623376,74,92
"['1111', '0110010', '10010', '1111011']",1,4,8,15,2,23,3.479076479076479,19,22
"['0', '01001', '011011', '01010']",1,4,9,8,2,17,3.206926406926407,19,18
"['1001110', '1', '1101000', '000101', '110100']",1,5,14,13,4,27,4.604395604395604,39,29
"['11101', '101010', '111000', '011']",1,4,8,12,2,20,3.55050505050505,16,17
"['1010', '0010', '111']",1,3,5,6,2,11,1.6071428571428572,6,6
"['01', '0101010', '00', '0111011']",1,4,9,9,4,18,2.992063492063492,23,17
"['101011', '00', '10']",1,3,5,5,2,10,1.5,9,5
"['0100110', '111', '1001010', '000011', '0101101', '00111', '1110101']",1,7,19,23,4,42,13.535636585636585,65,60
"['011101', '001', '1110100']",1,3,7,9,0,16,1.6136752136752137,11,8
"['11011', '10', '101110', '01110']",1,4,6,12,2,18,3.879220779220779,17,17
"['001101', '111010', '10111', '0110', '10100', '00']",1,6,13,15,4,28,9.069264069264069,41,38
"['000110', '1000', '101110']",1,3,9,7,2,16,1.8666666666666667,8,11
"['11101', '01011', '0111', '111']",1,4,4,13,2,17,4.04047619047619,11,29
"['010', '1010100', '100', '001100', '1010010', '111101', '1110']",1,7,18,18,6,36,12.08099678099678,63,59
"['0', '111111', '0110111']",1,3,3,11,0,14,0.7115384615384616,14,8
"['1010001', '1001', '10110', '101111']",1,4,9,13,0,22,4.003263403263404,16,30
"['01', '1011001', '00000', '1000111', '0000110']",1,5,17,11,3,28,5.285714285714286,40,24
"['01000', '110100', '011', '01100']",1,4,11,8,2,19,3.948989898989899,14,23
"['01', '00000', '11', '10010', '1110']",1,5,10,8,4,18,4.195238095238095,29,21
"['01', '00000', '1110011', '10', '010011']",1,5,12,10,2,22,4.426517926517927,38,24
"['1011010', '010000', '111001', '1110', '0110011']",1,5,14,16,4,30,6.302397602397603,30,25
"['01', '011101', '10', '000100', '11100']",1,5,11,10,4,21,5.12987012987013,33,25
"['0101', '001001', '101', '1']",1,4,7,7,0,14,3.287301587301587,16,18
"['011', '11', '0001', '0000', '1101']",1,5,9,8,3,17,4.728571428571429,23,28
"['001110', '1000', '1', '110100']",1,4,9,8,2,17,2.6714285714285713,23,13
"['1000111', '01', '0001', '0011000']",1,4,12,8,2,20,3.3997113997113995,24,14
"['001010', '0011111', '01100', '11']",1,4,9,11,0,20,2.994893994893995,21,16
"['100', '10', '00011']",1,3,6,4,0,10,1.5857142857142859,8,8
"['0010', '1', '101000', '00', '0110001']",1,5,13,7,0,20,4.461510711510711,37,23
"['0', '001100', '010']",1,3,7,3,0,10,1.4523809523809523,10,12
"['101', '1010', '011', '0100']",1,4,7,7,4,14,3.988095238095238,11,13
"['1011', '00', '1000', '111']",1,4,6,7,2,13,2.357142857142857,14,15
"['00111', '001', '1001101']",1,3,7,8,0,15,2.1833333333333336,8,9
"['111', '100110', '0000', '0001011', '01110']",1,5,13,12,0,25,5.208818958818959,31,26
"['0011', '01', '0010010', '00']",1,4,10,5,2,15,3.4494949494949494,18,20
"['010000', '100011', '10', '0001010', '0001000']",1,5,20,8,4,28,6.181929181929182,34,34
"['0001', '01001', '0000000']",1,3,13,3,0,16,1.7676767676767675,9,12
"['1110111', '010', '1000101', '00011', '00000', '000001', '11111', '1011', '1100', '01011']",1,10,25,26,8,51,23.36059496059496,140,144
"['101', '110111', '0111']",1,3,3,10,0,13,2.038095238095238,7,12
"['0011', '1010110', '001010']",1,3,9,8,0,17,2.1426573426573428,7,9
"['000110', '0010111', '1']",1,3,7,7,0,14,1.151098901098901,13,5
"['1101101', '01000', '1001']",1,3,8,8,0,16,1.893939393939394,9,5
"['1111100', '0011', '11']",1,3,4,9,0,13,1.4747474747474747,12,12
"['0111000', '1000001', '00001', '00000', '1000', '0110011']",1,6,24,11,5,35,9.657142857142857,44,58
"['0', '110010', '111', '1110011', '110001', '1101']",1,6,10,17,2,27,8.710972360972361,46,60
"['1010', '111', '0100101']",1,3,6,8,0,14,1.7168831168831167,9,6
"['111100', '1001000', '01111', '010101', '110', '0110001']",1,6,16,18,4,34,8.587634587634588,48,41
"['00100', '0111', '0001100']",1,3,10,6,0,16,1.823232323232323,9,13
"['0110111', '100100', '00', '1000', '0111']",1,5,12,11,2,23,4.946891996891997,36,32
"['010000', '100', '011']",1,3,8,4,2,12,1.4444444444444444,10,8
"['0', '1101111', '100', '01111', '1101']",1,5,6,14,0,20,4.70981240981241,33,28
"['0010', '010001', '1110', '1111']",1,4,8,10,3,18,2.9,17,15
"['00101', '010110', '1']",1,3,6,6,0,12,1.3463203463203464,12,4
"['010', '11', '001000', '0000', '1101', '1100']",1,6,14,9,3,23,7.464285714285714,39,42
"['10101', '001001', '010101', '0110111']",1,4,11,13,2,24,4.520979020979021,13,19
"['010', '0101', '011']",1,3,5,5,2,10,2.380952380952381,3,10
"['1000', '011', '01100']",1,3,7,5,0,12,1.7023809523809523,7,9
"['100001', '100', '0001100', '00010', '110101']",1,5,17,10,2,27,6.436829836829837,31,27
"['000110', '01', '111', '0011', '01010', '110']",1,6,11,12,2,23,8.652669552669552,37,39
"['0000100', '011', '11', '0100010', '1110101', '10100', '000', '1011011']",1,8,22,19,6,41,14.84126984126984,103,75
"['010100', '01', '1']",1,3,5,4,0,9,1.4523809523809523,10,5
"['01', '11100', '010110']",1,3,6,7,0,13,1.512987012987013,11,7
"['0011', '1000', '1', '001000']",1,4,10,5,2,15,2.9857142857142858,19,18
"['1100010', '1110110', '001']",1,3,8,9,2,17,1.7142857142857144,11,8
"['01101', '1', '01110']",1,3,4,7,2,11,1.4666666666666668,10,6
"['011111', '01', '000101', '111001']",1,4,8,12,3,20,3.1666666666666665,22,18
"['110111', '00100', '10']",1,3,6,7,0,13,1.435064935064935,11,4
"['0', '10001', '01110']",1,3,6,5,2,11,1.0666666666666667,12,4
"['0', '10001', '111100', '10011']",1,4,8,9,2,17,2.843290043290043,22,13
"['111', '0011000', '1010011']",1,3,8,9,2,17,1.3714285714285714,13,6
"['1111001', '00101', '10011', '0000']",1,4,11,10,2,21,3.4414141414141413,20,14
"['1000100', '1110010', '100']",1,3,10,7,2,17,1.9142857142857141,11,10
"['1001110', '101', '100', '1111', '0100']",1,5,9,12,4,21,5.493290043290043,27,24
"['01', '1111101', '00001', '001110', '10', '110', '111101']",1,7,12,19,4,31,11.076917526917526,71,60
"['0011', '01', '11011']",1,3,4,7,0,11,1.9047619047619047,7,9
"['10100', '1000', '1000101', '11']",1,4,10,8,0,18,3.243145743145743,18,20
"['1', '0000100', '10111', '1101000', '1001', '10110', '100100', '0000010', '101110']",1,9,27,21,7,48,19.21097236097236,123,108
"['0', '101101', '110001', '101110', '1110']",1,5,9,14,3,23,5.457142857142857,34,26
"['011', '00011', '101000', '1001', '01110', '010011', '0011100']",1,7,19,17,4,36,13.2001776001776,62,58
"['1100001', '10000', '00110', '1011100', '11111']",1,5,14,15,5,29,5.071428571428571,34,24
"['1110111', '00', '1', '0011000']",1,4,8,9,2,17,1.5952380952380951,30,12
"['011101', '0011', '1000', '1011']",1,4,8,10,3,18,3.35,16,16
"['10111', '0100000', '101', '1111']",1,4,8,11,0,19,2.903246753246753,21,18
"['01', '001101', '000']",1,3,7,4,0,11,1.5666666666666667,9,9
"['00', '1', '1110', '1001101']",1,4,6,8,0,14,2.155050505050505,22,10
"['01', '0100111', '1100101', '001100', '000100']",1,5,16,12,4,28,5.898046398046398,35,26
"['011', '1100100', '00110', '001100', '0101', '01110']",1,6,16,14,2,30,9.954345654345655,39,52
"['0', '11010', '0100']",1,3,6,4,0,10,1.4,9,8
"['100', '1001', '10', '11']",1,4,5,6,2,11,3.8904761904761904,9,18
"['1101', '111', '11010']",1,3,3,9,0,12,2.496031746031746,4,15
"['0110100', '1111010', '10', '0000', '01001']",1,5,14,11,2,25,4.846320346320346,36,26
"['01', '010', '111']",1,3,3,5,2,8,1.5333333333333334,5,5
"['010001', '11', '000101', '010111', '1101']",1,5,11,13,3,24,5.766666666666667,29,33
"['010100', '0010001', '11110', '1011001', '0111011', '10', '111001']",1,7,18,22,5,40,12.208125208125209,68,56
"['101', '11011', '001', '111']",1,4,4,10,3,14,3.6666666666666665,11,23
"['0', '1111101', '1001010', '0111', '0111101']",1,5,9,17,3,26,4.968181818181818,41,28
"['11001', '01', '10001', '000101']",1,4,10,8,2,18,3.7155844155844155,16,21
"['0', '0111111', '000100']",1,3,7,7,0,14,0.8434065934065934,16,8
"['010001', '010', '0110100', '0001', '1111', '01010', '01110', '1110']",1,8,19,19,5,38,16.18789543789544,73,91
"['0110101', '001', '011', '0110', '0010010']",1,5,13,11,4,24,6.464069264069264,29,33
"['11010', '01010', '0000']",1,3,9,5,2,14,1.911111111111111,6,11
"['011101', '1101001', '110001']",1,3,8,11,2,19,2.2051282051282053,7,14
"['111', '1001', '10000', '00110', '10']",1,5,10,9,2,19,5.264285714285714,27,24
"['1110110', '011', '1111']",1,3,3,11,0,14,1.8987012987012988,9,13
"['0011', '0010', '00000']",1,3,10,3,2,13,1.8611111111111112,6,14
"['00100', '11110', '111', '0111100']",1,4,8,12,2,20,3.5,18,17
"['0111000', '101', '1110']",1,3,6,8,0,14,1.6987012987012986,10,4
"['0010', '010001', '11', '1010', '0100']",1,5,12,8,3,20,6.083333333333333,25,24
"['100', '01010', '0000', '01001', '11100']",1,5,14,8,3,22,6.3769841269841265,23,30
"['100', '10000', '00110', '000', '1100111', '11100']",1,6,16,12,5,28,9.1,43,50
"['11', '10111', '000101', '10', '0100']",1,5,9,10,2,19,5.2327561327561325,29,22
"['0011', '010', '1001010']",1,3,8,6,0,14,1.8987012987012988,9,8
"['0', '11101', '000001', '1111']",1,4,7,9,0,16,2.0715728715728714,23,15
"['1011', '01001', '100', '001']",1,4,8,7,2,15,3.9761904761904763,12,16
"['11001', '01101', '1', '000001', '0111', '000', '1011000', '0100']",1,8,20,15,4,35,14.091769341769341,87,75
"['1001', '10110', '100010', '00', '0001000', '0111100']",1,6,19,12,2,31,8.88069708069708,52,43
"['0110010', '010', '100111', '00']",1,4,10,8,0,18,3.404273504273504,22,15
"['0', '0110111', '10001', '0110', '001011', '1101010']",1,6,14,16,2,30,7.48057498057498,55,35
"['110110', '1110000', '0111011', '0000', '111000', '0100']",1,6,18,16,6,34,9.042990342990343,47,59
"['0111011', '0101101', '1011101', '100', '01111', '00', '0110010', '110', '101001']",1,9,20,27,6,47,22.074087024087024,114,93
"['1000100', '1', '100100', '1000000', '100111', '1100110', '1011', '00010']",1,8,25,18,5,43,16.092180042180043,90,88
"['0001', '111011', '1111010', '011110', '0000', '0001011', '000111']",1,7,19,21,7,40,11.993722943722943,70,76
"['0', '11010', '011100', '1010', '1011011']",1,5,10,13,0,23,5.494533244533245,35,24
"['0000101', '0001001', '1010101', '01110']",1,4,15,11,3,26,3.4761904761904763,18,17
"['1101', '10110', '0110', '01000']",1,4,9,9,4,18,4.016666666666667,14,14
"['010', '001', '1110000', '101011', '10001', '1101000', '0001', '1100111']",1,8,22,20,5,42,16.60118215118215,91,84
"['0111000', '11110', '0000111', '11']",1,4,9,12,2,21,3.198412698412698,27,18
"['1001', '01111', '111011']",1,3,4,11,0,15,1.5898989898989897,8,11
"['011001', '101', '0011', '0110', '11111']",1,5,8,14,2,22,5.671645021645022,27,24
"['01', '010011', '11010', '11']",1,4,6,9,2,15,3.188311688311688,18,18
"['1011', '10010', '111', '01000']",1,4,8,9,2,17,3.2325396825396826,15,13
"['0', '110', '1100101']",1,3,5,6,0,11,1.35,12,6
"['1010010', '0110000', '010', '01100']",1,4,14,8,2,22,4.164285714285715,18,27
"['0010110', '0', '1000', '010111', '1010001']",1,5,14,11,2,25,4.671628371628372,40,20
"['1011110', '1010101', '00', '010110', '001011']",1,5,13,15,4,28,6.35958485958486,33,24
"['01', '101010', '100', '1101011', '0111', '1001001', '110']",1,7,14,18,4,32,11.634132534132533,65,57
"['0001100', '111111', '00', '10']",1,4,8,9,2,17,1.9465811965811965,27,14
"['101', '00', '111010']",1,3,5,6,0,11,1.5666666666666667,9,4
"['001', '00011', '11', '0001', '010010']",1,5,12,8,0,20,6.494733044733045,23,27
"['010', '00001', '000', '000111', '0011100']",1,5,16,8,2,24,6.2242812742812745,30,44
"['00', '110', '100011', '111']",1,4,6,8,2,14,2.4555555555555557,17,15
"['011', '110100', '1111']",1,3,4,9,0,13,1.615873015873016,9,11
"['0', '111', '010100']",1,3,5,5,0,10,0.7301587301587301,12,4
"['0001011', '01', '100111']",1,3,7,8,0,15,1.7136752136752138,11,7
"['111', '100', '10', '000', '1110110']",1,5,8,10,3,18,4.644444444444445,29,26
"['010', '1', '1001010']",1,3,6,5,0,11,1.35,12,6
"['110000', '1000100', '11', '101', '10100', '1010010', '1110']",1,7,18,16,2,34,12.954118104118104,60,66
"['110110', '0010010', '10011', '1111']",1,4,9,13,0,22,3.6174048174048172,17,16
"['11010', '01110', '00001']",1,3,8,7,3,15,1.4,10,7
"['1000', '100100', '011']",1,3,8,5,0,13,1.53015873015873,9,9
"['001', '11000', '111011', '0111', '011001', '1011111']",1,6,11,20,2,31,8.657753357753357,46,49
"['11001', '0010', '0001111', '10', '010110', '0000']",1,6,16,12,2,28,8.106510156510156,49,41
"['1110000', '00000', '010011', '0101', '01000']",1,5,18,9,2,27,5.760528360528361,28,42
"['1', '11110', '010111', '000010']",1,4,8,10,2,18,2.313852813852814,24,13
"['010', '001', '1111101', '1111001', '000010', '1011']",1,6,13,17,4,30,7.8783216783216785,54,38
"['1001', '1100', '1101010']",1,3,7,8,2,15,2.2045454545454546,8,8
"['1111101', '011', '1110']",1,3,3,11,0,14,1.6987012987012986,10,10
"['1000010', '10100', '010', '11']",1,4,10,7,0,17,3.265873015873016,19,13
"['01', '10011', '101001']",1,3,6,7,0,13,1.7987012987012987,9,10
"['00100', '000010', '0011100', '1011']",1,4,14,8,0,22,3.565889665889666,18,22
"['00101', '111', '10011']",1,3,5,8,2,13,1.8,7,10
"['0101', '1001111', '11']",1,3,4,9,0,13,1.6565656565656566,11,10
"['0', '001101', '0011000', '101010', '101011', '001110']",1,6,17,15,4,32,7.995421245421245,51,47
"['0010', '10110', '10']",1,3,6,5,0,11,1.9047619047619047,7,10
"['10010', '1', '110111']",1,3,4,8,0,12,1.1645021645021645,12,8
"['110010', '010', '00011', '1100100', '100111', '011010', '1110']",1,7,18,19,3,37,13.03164613164613,61,66
"['0110101', '001100', '111', '100010']",1,4,11,11,2,22,3.54017094017094,22,10
"['1', '0000100', '1001010', '0001', '10100', '010110']",1,6,19,11,2,30,7.795726495726496,52,38
"['00111', '01101', '011']",1,3,5,8,2,13,2.3,6,9
"['001111', '111', '0101100']",1,3,6,10,0,16,1.682051282051282,10,9
"['0', '1111101', '101', '111111', '110111']",1,5,4,19,2,23,4.785286935286935,34,43
"['101', '1111', '1000', '10', '001100', '0111101', '0100']",1,7,14,16,3,30,11.471589521589522,63,50
"['0111', '110', '1110100', '01110']",1,4,7,12,0,19,4.022438672438672,16,21
"['11001', '1000101', '111', '0110', '000101', '0111', '1011']",1,7,14,19,3,33,13.211965811965811,54,67
"['0', '010', '0101111']",1,3,5,6,0,11,1.35,12,10
"['00', '0100011', '0010111', '0000011']",1,4,14,9,3,23,3.4761904761904763,21,23
"['110110', '11', '101011', '1001', '10110', '100110', '00', '1110']",1,8,14,21,7,35,17.57720057720058,70,90
"['110110', '1101', '0000']",1,3,7,7,2,14,1.4500000000000002,9,7
"['0100010', '010011', '100100', '00001']",1,4,16,8,2,24,4.1573426573426575,15,16
"['1111100', '101', '100']",1,3,5,8,2,13,1.6666666666666665,10,9
"['10100', '010000', '10', '0100']",1,4,12,5,0,17,4.154256854256854,14,23
"['1001110', '0111010', '00101', '0001', '100', '0110', '1111']",1,7,16,18,5,34,11.84033189033189,61,52
"['0010001', '0010', '00111', '101', '1100000', '111011']",1,6,17,15,2,32,7.917449217449217,53,45
"['11011', '010000', '00001', '00111', '1001', '0101011', '0111']",1,7,18,18,5,36,12.275990675990675,57,64
"['0', '101111', '1110']",1,3,3,8,0,11,1.2857142857142856,11,6
"['1001', '11100', '011', '11']",1,4,5,9,0,14,3.776190476190476,14,19
"['1010', '10100', '01101', '1001011']",1,4,10,11,2,21,3.701010101010101,16,17
"['0010110', '01', '001']",1,3,7,5,0,12,1.8444444444444446,10,9
"['00010', '110', '10']",1,3,6,4,0,10,1.8714285714285714,7,9
"['1110111', '01', '0001110', '011', '01010', '0110110']",1,6,13,18,3,31,9.254761904761905,51,43
"['010', '11', '100', '0000', '1001100']",1,5,12,7,2,19,4.9812409812409815,30,26
"['1100010', '0000001', '01000', '1111']",1,4,14,9,2,23,2.6875901875901875,24,14
"['1000011', '0011111', '1101', '10']",1,4,8,12,2,20,2.813852813852814,25,18
"['1111100', '100110', '01', '010111']",1,4,8,13,2,21,2.965811965811966,24,15
"['0010001', '0001', '01011', '1100011']",1,4,13,10,2,23,3.9466089466089467,17,19
"['1101001', '011011', '10000', '1101110', '110011', '111111', '10', '011111', '0101']",1,9,17,32,6,49,19.933966033966033,115,122
"['11001', '010001', '0011001', '0001', '10']",1,5,14,10,0,24,6.191164391164391,28,36
"['11101', '00', '100', '111']",1,4,5,8,2,13,2.669047619047619,15,16
"['11110', '11010', '001', '011']",1,4,6,10,4,16,3.0166666666666666,15,16
"['011111', '0110000', '01111']",1,3,7,11,0,18,1.8706293706293706,9,17
"['01', '000101', '10']",1,3,6,4,2,10,1.5,10,7
"['011', '010101', '001010', '10', '001001']",1,5,13,10,3,23,6.4,29,26
"['0111011', '0101100', '11']",1,3,6,10,2,16,1.6031746031746033,13,7
"['10100', '1100101', '11010']",1,3,8,9,2,17,2.1333333333333333,7,8
"['101101', '10000', '1000', '00', '100101', '0000011']",1,6,19,11,2,30,9.033200133200133,44,53
"['0100010', '1011', '1', '011001']",1,4,9,9,0,18,2.8503996003996006,23,11
"['111000', '011', '10']",1,3,5,6,0,11,1.3444444444444446,10,7
"['001', '1111', '10100', '100111', '0000010', '0100']",1,6,16,13,2,29,7.641408591408591,49,39
"['01', '11', '1100010', '100100', '110']",1,5,10,10,2,20,5.402564102564103,32,27
"['1', '1011101', '1010', '000', '1100']",1,5,9,10,2,19,4.615584415584416,33,22
"['110000', '01', '0111', '00011']",1,4,9,8,0,17,3.10021645021645,21,18
"['010100', '00100', '0']",1,3,9,3,0,12,1.528138528138528,10,16
"['011101', '10110', '1111001', '11']",1,4,6,14,0,20,3.679043179043179,20,17
"['01', '0010', '0000011', '11111']",1,4,9,9,0,18,2.4978354978354975,24,13
"['0001', '010000', '1', '01010']",1,4,11,5,0,16,2.790764790764791,19,14
"['1011101', '1', '01011', '000']",1,4,7,9,0,16,2.15,24,10
"['110', '100001', '10']",1,3,6,5,0,11,1.7444444444444445,9,8
"['0111000', '111010', '00011', '011011', '100', '010110', '11100', '1111111']",1,8,18,27,7,45,16.17965922965923,90,88
"['0', '11110', '11010']",1,3,4,7,2,11,1.2666666666666666,9,8
"['1001', '01111', '1011100']",1,3,6,10,0,16,1.6565656565656566,10,7
"['111010', '111', '1100000', '10', '1001100']",1,5,12,13,2,25,5.211599511599512,37,30
"['11000', '1', '0000']",1,3,7,3,0,10,1.0,10,8
"['101', '1110', '11111']",1,3,2,10,0,12,1.7380952380952381,7,12
"['1110100', '11', '011', '0000']",1,4,8,8,0,16,2.2937950937950937,22,17
"['101', '0011', '011000']",1,3,7,6,0,13,1.615873015873016,10,5
"['1011110', '101', '11']",1,3,3,9,0,12,1.8444444444444446,10,10
"['01', '11', '1001', '1010', '100000', '11100']",1,6,12,11,4,23,8.352597402597402,42,40
"['0', '111000', '1001']",1,3,6,5,0,11,1.2857142857142856,11,4
"['01101', '1', '01010', '1010000', '1100']",1,5,12,10,2,22,5.343939393939394,33,20
"['10000', '1010', '000001', '1110']",1,4,12,7,2,19,2.9383838383838383,17,17
"['00011', '11000', '10010', '100101', '01010', '001100']",1,6,19,13,6,32,10.118181818181817,38,41
"['1', '00110', '100101', '1011', '0110010']",1,5,11,12,0,23,5.244338994338994,35,18
"['00010', '100111', '000011', '11']",1,4,10,9,2,19,3.225108225108225,19,17
"['010', '001000', '10101', '0110', '00', '0111', '001001', '1100']",1,8,20,14,5,34,17.405266955266956,70,83
"['11110', '11011', '010', '0101101', '00']",1,5,9,13,2,22,5.349206349206349,32,23
"['101010', '0010', '000']",1,3,9,4,0,13,2.123809523809524,6,12
"['01', '011', '0110', '11101', '010111']",1,5,7,13,0,20,6.374025974025974,25,30
"['11010', '0011001', '0001', '1010111', '110', '01100']",1,6,15,16,4,31,8.764646464646464,47,38
"['01', '10000', '001001', '1100', '101110', '101111']",1,6,14,15,3,29,7.673593073593073,49,41
"['1', '01111', '0110', '1010', '0000111', '1100']",1,6,11,14,3,25,7.528282828282828,50,36
"['110000', '110010', '001010', '110100']",1,4,14,10,4,24,4.333333333333333,14,24
"['101', '00110', '001001', '011']",1,4,9,8,2,17,3.977272727272727,15,13
"['0', '1110010', '11', '0011010', '0101']",1,5,10,11,2,21,4.442568542568543,39,22
"['0', '11110', '1010110', '1101111', '111111', '011111']",1,6,7,25,4,32,7.775058275058275,49,63
"['111011', '10010', '111001', '11']",1,4,6,13,2,19,3.6774891774891776,18,28
"['100011', '10', '000']",1,3,7,4,0,11,1.5666666666666667,9,5
"['1101', '1000', '00001']",1,3,8,5,2,13,1.6111111111111112,7,9
"['1100111', '01', '000101', '10']",1,4,8,9,2,17,3.0042735042735043,23,13
"['010', '001000', '11', '10000', '110111', '10']",1,6,13,11,4,24,7.342496392496392,49,35
"['1100011', '1001', '1', '10110']",1,4,7,10,0,17,2.8772727272727274,22,19
"['111', '01010', '1011000']",1,3,7,8,0,15,1.5666666666666667,10,4
"['0000110', '111', '0100']",1,3,8,6,0,14,1.0493506493506493,12,5
"['01', '10', '01110']",1,3,4,5,2,9,1.6428571428571428,8,8
"['11001', '10001', '1']",1,3,5,6,2,11,1.4666666666666668,9,14
"['00011', '0101101', '101010', '0110', '1010010', '1100', '101110']",1,7,19,20,6,39,14.19101454101454,56,60
"['011011', '101011', '100', '011101', '1011', '1110']",1,6,10,19,5,29,9.365079365079366,39,50
"['1000001', '0110010', '01']",1,3,10,6,2,16,1.4603174603174602,14,6
"['0100111', '0110111', '11', '0101011', '0000101', '10']",1,6,14,18,6,32,8.34126984126984,54,45
"['0', '101100', '001', '010011', '01110']",1,5,11,10,2,21,4.955266955266955,35,24
"['01', '001', '0000000', '0100']",1,4,13,3,0,16,3.023953823953824,20,21
"['0010110', '0001', '100110', '10', '01100', '1111011']",1,6,15,16,2,31,8.097169497169498,54,37
"['001', '11', '1001', '0110', '1101']",1,5,7,10,3,17,6.3999999999999995,19,26
"['11101', '11100', '000', '011000']",1,4,10,9,2,19,3.4893939393939393,16,20
"['11', '00', '000111', '1011100', '0101', '0100']",1,6,13,12,4,25,7.86033411033411,48,42
"['11011', '100001', '00000', '0010100', '1001011', '11111', '1100', '01000']",1,8,24,20,6,44,15.103640803640804,85,84
"['101101', '10000', '10100', '0000', '0110110']",1,5,16,11,2,27,6.0874125874125875,27,31
"['01', '1000', '11']",1,3,4,4,2,8,1.1666666666666665,7,6
"['0010', '110001', '110', '0100']",1,4,10,7,2,17,3.7595238095238095,16,14
"['00111', '001', '0101011']",1,3,7,8,0,15,1.8166666666666667,8,9
"['0000110', '011', '11']",1,3,6,6,0,12,1.8444444444444446,10,6
"['11010', '0010', '111100', '10110', '010110', '0111', '001011']",1,7,16,20,7,36,13.381818181818181,51,67
"['01111', '0110010', '1']",1,3,5,8,0,13,1.25,13,6
"['0101110', '101', '10010', '100001']",1,4,11,10,0,21,3.5516317016317016,19,16
"['0001', '0010', '0100', '1111']",1,4,9,7,4,16,2.75,15,13
"['11001', '111', '0011', '1010', '1000']",1,5,9,11,3,20,5.928571428571429,23,29
"['11000', '100', '111', '1001']",1,4,7,8,2,15,3.6785714285714284,12,19
"['011100', '0011', '100010', '10', '0111']",1,5,11,11,4,22,5.316666666666666,31,27
"['1010', '1011111', '110101']",1,3,5,12,0,17,1.9608391608391609,9,11
"['101', '011', '0000001']",1,3,8,5,2,13,1.4666666666666668,12,7
"['11001', '1011001', '001', '001111']",1,4,9,12,0,21,4.0108391608391605,18,25
"['10001', '00', '111', '0100']",1,4,8,6,0,14,2.6904761904761902,17,10
"['010', '110', '011001', '00000']",1,4,11,6,2,17,3.1136363636363633,17,16
"['110011', '101', '0010', '10']",1,4,7,8,0,15,3.8047619047619046,15,12
"['010', '001', '101', '1111', '00']",1,5,7,8,3,15,5.142857142857142,21,19
"['100', '001', '011', '111110']",1,4,6,9,3,15,2.7777777777777777,19,14
"['0011', '101', '00100', '10100', '001011', '101001']",1,6,16,13,4,29,9.874963924963925,34,54
"['001', '01101', '111', '001000', '1101011', '100011']",1,6,14,16,4,30,8.238344988344988,48,43
"['1010111', '100', '110']",1,3,5,8,2,13,1.6666666666666665,9,8
"['1011', '010', '100100']",1,3,7,6,0,13,1.838095238095238,8,5
"['01101', '1', '01011']",1,3,4,7,2,11,1.2666666666666666,10,7
"['0001001', '0010', '0010111', '00', '111000']",1,5,16,10,2,26,5.747463647463648,38,41
"['0000111', '10100', '1100100', '11']",1,4,11,10,2,21,3.0555555555555554,24,22
"['011', '01000', '1001101']",1,3,8,7,0,15,1.7666666666666666,11,5
"['010', '1100', '011']",1,3,5,5,2,10,1.8095238095238093,6,8
"['001010', '000', '0111100']",1,3,10,6,0,16,1.3743589743589744,10,17
"['0', '0110100', '100', '100111', '101110']",1,5,11,12,2,23,5.472710622710623,37,24
"['0011001', '0000', '01', '1101110']",1,4,11,9,2,20,2.8845598845598843,25,15
"['11000', '01001', '00', '1111111']",1,4,8,11,2,19,2.4095238095238094,25,14
"['01', '001111', '011100', '0100010', '010010', '1111000', '0000', '01110']",1,8,24,19,5,43,16.290331890331892,92,110
"['01', '010', '00', '001110', '11111', '01011']",1,6,10,13,4,23,7.867965367965368,43,39
"['0', '00100', '0101000', '110110']",1,4,12,7,0,19,2.8632201132201134,23,20
"['0101000', '100001', '111010', '0011001', '10111', '100', '10']",1,7,19,17,4,36,12.227050727050727,72,55
"['1000100', '101110', '0110110']",1,3,10,10,2,20,1.9560439560439562,10,9
"['100', '100010', '10', '111']",1,4,7,7,2,14,3.1444444444444444,16,17
"['1000110', '0111001', '101111']",1,3,8,12,2,20,1.9560439560439562,11,7
"['111', '0010000', '011', '101', '10001', '000']",1,6,14,10,4,24,7.433333333333334,44,36
"['1111', '110', '110111', '0100']",1,4,5,12,2,17,3.0595238095238093,16,21
"['0110101', '001111', '001011']",1,3,8,11,2,19,2.371794871794872,6,9
"['00', '0101', '0111', '11111']",1,4,5,10,2,15,2.861111111111111,16,15
"['110011', '001100', '01110', '1101010']",1,4,11,13,2,24,3.824009324009324,19,14
"['1010', '001110', '11']",1,3,5,7,0,12,1.5666666666666667,9,5
"['0', '1000100', '11011', '0101000', '110111', '0111110']",1,6,15,18,3,33,6.745171495171495,61,35
"['0000100', '11', '0011110', '10100', '1000', '0000', '01100']",1,7,22,12,6,34,11.183477633477633,66,84
"['011', '1100000', '01111', '00', '1100101', '01110']",1,6,14,15,4,29,7.993650793650794,55,45
"['110011', '101', '101110']",1,3,5,10,2,15,1.8333333333333333,9,10
"['00', '111100', '1101', '00001']",1,4,9,8,0,17,2.8128427128427127,21,17
"['0001010', '110', '000']",1,3,9,4,2,13,1.3333333333333333,10,13
"['11000', '1101000', '0101000', '1']",1,4,12,8,2,20,3.357142857142857,21,23
"['111010', '1001011', '111']",1,3,5,11,0,16,1.682051282051282,10,15
"['0001100', '0000', '1011', '0101', '110']",1,5,13,9,3,22,5.346753246753247,29,25
"['1010111', '10111', '1']",1,3,3,10,0,13,1.4166666666666667,12,18
"['1001', '111100', '0100']",1,3,7,7,2,14,1.95,9,6
"['11011', '00101', '1110', '00000']",1,4,10,9,3,19,2.7333333333333334,18,14
"['0001101', '101000', '0110', '000']",1,4,13,7,0,20,3.426906426906427,19,24
"['0001011', '11110', '11101', '11']",1,4,6,13,2,19,3.2206349206349207,22,24
"['0101010', '010', '0110']",1,3,8,6,0,14,2.1844155844155844,8,20
"['10001', '011101', '100101', '1011', '1010010']",1,5,13,15,2,28,6.612587412587413,26,38
"['11001', '010011', '1']",1,3,5,7,0,12,1.3463203463203464,11,9
"['111', '00', '01010', '111000', '001011']",1,5,11,11,2,22,4.788600288600288,32,30
"['01', '11000', '1101000', '1101100', '1111010']",1,5,13,15,3,28,6.071428571428571,31,35
"['01101', '10', '1011100']",1,3,6,8,0,14,1.6825396825396823,11,7
"['001', '10000', '1110101', '1010', '1000', '011110', '000000', '000111', '110', '0100']",1,10,28,20,8,48,24.162176712176713,140,136
"['01', '1001', '01110']",1,3,5,6,0,11,1.6825396825396823,9,6
"['1101001', '1110110', '0001', '00000']",1,4,13,10,2,23,3.1385281385281383,22,17
"['001', '11', '011101', '1010', '001110', '0000011', '001100', '0001000']",1,8,24,17,5,41,15.734854034854035,93,85
"['11110', '01001', '10']",1,3,5,7,2,12,1.5428571428571427,10,7
"['0010111', '1', '111010']",1,3,5,9,0,14,0.9972527472527473,15,8
"['001', '10001', '00', '010101', '1100101']",1,5,13,10,0,23,6.286308136308136,28,29
"['01101', '0001110', '111', '00111', '10', '1100']",1,6,11,15,2,26,8.996248196248196,44,39
"['0', '0111110', '011100', '0100']",1,4,9,9,0,18,3.0503996003996003,22,31
"['11010', '10', '111101']",1,3,4,9,0,13,1.7987012987012987,9,8
"['0010', '1111101', '11', '00100', '1000000', '1000']",1,6,17,12,4,29,7.0436507936507935,56,43
"['11110', '111', '1110011', '0001101', '00010']",1,5,11,16,4,27,5.671428571428572,35,35
"['11110', '1010', '00', '11011']",1,4,6,10,2,16,2.949206349206349,16,13
"['0001', '1100', '011']",1,3,6,5,2,11,1.6428571428571428,8,8
"['110011', '11010', '1000011', '0000']",1,4,12,10,0,22,3.401554001554002,18,18
"['1001110', '101', '1111', '1010', '1010000', '111000', '01100']",1,7,17,19,4,36,12.597746697746697,64,59
"['01', '0001110', '011100', '1111', '000001', '00010', '0111110']",1,7,19,18,4,37,11.203818403818405,73,67
"['01100', '01', '01110']",1,3,6,6,2,12,1.9428571428571428,7,12
"['1011110', '101', '1001', '0001101', '1010', '10010', '11111']",1,7,14,21,6,35,13.273160173160173,59,71
"['010000', '100', '000101', '011101', '100110', '00', '0110010']",1,7,22,14,4,36,12.502564102564103,67,67
"['0010001', '11110', '1100101']",1,3,9,10,2,19,1.5476190476190477,11,8
"['0010001', '1100', '011', '1100110']",1,4,11,10,2,21,3.6155844155844155,22,18
"['1101', '1', '0100']",1,3,4,5,2,9,1.3,8,4
"['01', '0100110', '00111', '100', '100000']",1,5,14,9,0,23,5.078227328227328,36,26
"['000100', '10111', '01001', '1001']",1,4,11,9,2,20,3.8464646464646464,16,14
"['0', '1111100', '100011', '1110']",1,4,7,11,0,18,2.5245254745254746,26,14
"['01', '011', '0001', '010010', '111000']",1,5,12,9,2,21,5.965873015873016,30,27
"['00101', '111010', '111', '101', '0011100']",1,5,10,14,2,24,6.231351981351981,30,27
"['11000', '1111101', '0011100']",1,3,8,11,2,19,1.7380952380952381,10,7
"['0101', '1000', '001', '011100']",1,4,10,7,2,17,3.287301587301587,16,17
"['0', '101', '1100', '1101110']",1,4,6,9,0,15,3.0487012987012987,20,12
"['0', '1101001', '0100011', '10110']",1,4,10,10,2,20,2.7142857142857144,26,11
"['010100', '1100001', '010110', '000', '01011']",1,5,16,11,2,27,6.091064491064491,28,33
"['1101', '11010', '0010', '0011100']",1,4,10,10,2,20,3.994949494949495,17,18
"['0010', '1', '0011001', '000', '1110', '110101']",1,6,13,12,2,25,7.264973914973915,49,35
"['01101', '1', '101010', '1110101', '00']",1,5,9,12,0,21,4.366272616272616,37,20
"['11001', '100', '010010']",1,3,8,6,0,14,2.143939393939394,7,4
"['101010', '111', '0']",1,3,4,6,0,10,0.9523809523809523,11,4
"['00111', '01', '10', '11']",1,4,4,7,3,11,2.9285714285714284,14,14
"['01001', '10', '1101']",1,3,5,6,0,11,1.6825396825396823,7,7
"['100', '10', '0000']",1,3,7,2,0,9,1.7047619047619047,6,9
"['010', '00011', '0100010', '0010100', '10100']",1,5,18,9,4,27,6.254761904761905,31,38
"['0', '10111', '1001', '0000010', '1101', '01011']",1,6,13,13,4,26,7.675757575757576,49,31
"['101000', '111100', '11']",1,3,6,8,2,14,1.6666666666666665,10,9
"['10100', '0010', '01010', '011110']",1,4,11,9,2,20,3.824242424242424,13,24
"['011111', '1', '01000']",1,3,5,7,0,12,0.9826839826839826,13,5
"['111', '00011', '0001', '100100', '0111101']",1,5,12,13,0,25,5.18967698967699,33,28
"['010', '1101101', '10', '0111100']",1,4,8,11,2,19,3.4603174603174605,22,12
"['1111100', '11000', '110', '1']",1,4,6,10,0,16,3.1,21,17
"['0', '11000', '0001', '011110', '01001', '0110011']",1,6,15,13,2,28,8.245349095349095,49,41
"['0001', '100100', '1001', '11111']",1,4,9,10,2,19,3.18030303030303,17,20
"['0010', '11011', '01101', '010', '0101011']",1,5,11,13,2,24,6.497041847041847,24,28
"['000110', '11101', '10', '111']",1,4,6,10,0,16,3.211327561327561,19,15
"['001', '0011001', '100010', '1010', '0000', '0011011', '00010', '110']",1,8,24,15,6,39,17.443972693972693,78,94
"['01', '01111', '01011']",1,3,4,8,2,12,1.7428571428571429,7,10
"['0100010', '00111', '000101', '000', '01010']",1,5,17,9,2,26,6.6737762237762235,28,37
"['1011110', '1010', '01', '0111110']",1,4,7,13,2,20,3.5036075036075034,21,21
"['011100', '1', '000011']",1,3,7,6,2,13,1.0714285714285714,15,5
"['101010', '1011', '00', '00101']",1,4,9,8,0,17,3.5987012987012985,16,14
"['010', '0010100', '0000']",1,3,11,3,0,14,1.8987012987012988,9,16
"['000110', '101', '100', '110', '0100']",1,5,11,8,3,19,5.955555555555556,23,25
"['0', '101100', '001000', '1100100', '0000110']",1,5,18,9,4,27,4.782051282051282,39,37
"['10101', '00', '110', '011']",1,4,6,7,2,13,3.288095238095238,13,11
"['110', '00111', '1101010', '000101', '1111001', '111111', '1100', '0100']",1,8,17,25,6,42,15.765506715506715,91,93
"['01', '1010110', '01110']",1,3,6,8,0,14,1.6825396825396823,10,9
"['00011', '0011000', '11']",1,3,8,6,0,14,1.6825396825396823,12,9
"['0011001', '01', '00']",1,3,7,4,2,11,1.3888888888888888,11,9
"['110000', '11110', '0010', '110001', '111111', '1100101', '001010', '00010']",1,8,22,23,6,45,16.24965034965035,82,95
"['1011', '010', '11', '111001']",1,4,5,10,0,15,3.1825396825396823,17,17
"['0001100', '1010110', '111101', '0111100']",1,4,12,15,3,27,3.6923076923076925,17,14
"['010', '111110', '110111']",1,3,4,11,2,15,1.3888888888888888,10,8
"['0', '1011', '100100']",1,3,6,5,0,11,1.2857142857142856,11,5
"['100000', '00010', '1', '1010011']",1,4,12,7,0,19,2.7245254745254743,23,13
"['00100', '10110', '11']",1,3,6,6,2,12,1.457142857142857,9,4
"['0', '00110', '0110010', '0010']",1,4,11,6,0,17,3.2661616161616163,20,31
"['01', '1110010', '11', '10110', '000001']",1,5,11,11,2,22,4.773587523587524,37,24
"['111', '00111', '0110', '100000', '10', '111000', '110']",1,7,14,15,4,29,11.740043290043289,61,63
"['1', '101', '1001', '0010011', '0000101']",1,5,12,10,2,22,5.444155844155844,35,32
"['0001011', '01', '1']",1,3,5,5,0,10,1.3611111111111112,12,6
"['0011110', '0110', '10']",1,3,6,7,0,13,1.8383838383838382,10,12
"['1001000', '000', '0111', '01000', '0100']",1,5,16,7,2,23,5.964718614718615,26,47
"['1000100', '00', '100', '11']",1,4,9,5,2,14,2.688888888888889,19,18
"['0010', '010', '00011', '11', '0110010']",1,5,12,9,0,21,5.766955266955267,29,31
"['00100', '00', '1000111']",1,3,9,5,0,14,1.5158730158730158,12,8
"['0', '0011', '1111', '00001']",1,4,7,7,2,14,2.1222222222222222,19,13
"['0', '0111', '111011']",1,3,3,8,0,11,1.2857142857142856,11,7
"['1101', '1010010', '1000']",1,3,8,7,2,15,1.7727272727272727,8,7
"['101', '0101110', '0110', '11']",1,4,6,10,0,16,3.8098124098124098,18,11
"['00111', '101', '10001', '11100', '101001']",1,5,11,13,3,24,6.216666666666667,27,37
"['000110', '0110', '0010011']",1,3,10,7,0,17,2.114685314685315,9,12
"['01011', '011', '10']",1,3,4,6,0,10,1.7214285714285715,7,9
"['0010', '111100', '010110']",1,3,8,8,2,16,1.6666666666666665,9,10
"['1000101', '10', '010110', '00010', '01011']",1,5,14,11,2,25,6.257231657231657,29,26
"['0011', '110', '10', '01000']",1,4,8,6,0,14,3.2206349206349207,16,15
"['00001', '1001', '1101101', '111011', '1101100', '1010', '110']",1,7,15,21,4,36,12.473815073815073,64,70
"['1010', '11100', '01010']",1,3,7,7,2,14,2.1555555555555554,6,9
"['00', '10', '101001']",1,3,6,4,2,10,1.5,9,5
"['01', '0110110', '1010011']",1,3,7,9,2,16,1.3174603174603174,13,5
"['00', '0101', '0001']",1,3,7,3,2,10,1.8333333333333333,5,9
"['01001', '1000', '0011100']",1,3,10,6,0,16,1.8787878787878787,10,8
"['0011', '001111', '000001', '10']",1,4,10,8,2,18,2.7333333333333334,21,18
"['101', '1010010', '10', '011']",1,4,7,8,2,15,3.511111111111111,18,17
"['010', '1101111', '0011000', '11', '1000111', '11100', '1011111']",1,7,14,24,4,38,10.93015873015873,83,69
"['00011', '0001', '001101', '11']",1,4,9,8,0,17,3.6209235209235207,15,20
"['10', '1110', '1101110']",1,3,4,9,0,13,1.8383838383838382,10,12
"['100', '0110000', '11101', '110', '0110011']",1,5,12,13,4,25,6.197619047619048,31,26
"['0110000', '001', '100111', '1111']",1,4,9,11,0,20,2.7775557775557775,23,15
"['0001', '10010', '0010']",1,3,9,4,2,13,2.3055555555555554,5,10
"['1011001', '1111000', '0000100', '11']",1,4,12,11,3,23,2.825396825396825,27,15
"['1000', '11101', '11100', '000']",1,4,9,8,2,17,3.518253968253968,14,20
"['0', '10100', '010', '11']",1,4,6,5,0,11,2.5547619047619046,15,10
"['010', '11101', '011', '111011']",1,4,5,12,2,17,3.686868686868687,15,20
"['1101101', '1101', '1010101', '01110']",1,4,8,15,2,23,3.6298701298701297,17,22
"['11', '101', '1110001', '1100101', '10', '10011']",1,6,10,16,4,26,9.327777777777778,46,66
"['1000101', '011', '101', '10000', '11111']",1,5,10,13,4,23,5.15,33,35
"['101', '000100', '0101011', '11']",1,4,9,9,0,18,3.154273504273504,22,12
"['01001', '0111010', '110', '01000']",1,4,11,9,2,20,3.4,17,20
"['111000', '1', '0100011']",1,3,7,7,0,14,1.151098901098901,15,7
"['0', '11', '00100', '101101']",1,4,7,7,0,14,1.95021645021645,22,8
"['10100', '11011', '1100', '0010000']",1,4,12,9,2,21,3.701010101010101,18,19
"['00101', '0110100', '101', '011101', '000', '011001', '000111', '0111110']",1,8,21,22,7,43,17.16813186813187,83,90
"['0', '010', '1111']",1,3,3,5,0,8,0.7857142857142857,9,4
"['1000101', '0110', '100010', '1001111', '111101']",1,5,13,17,4,30,6.092607392607393,30,35
"['1011', '00', '1100', '1110']",1,4,6,8,3,14,3.083333333333333,14,15
"['0', '101100', '111100', '101', '0011011']",1,5,10,13,2,23,4.942796092796093,37,26
"['1000001', '0101', '1', '100']",1,4,9,6,0,15,2.866883116883117,21,17
"['1000100', '110010', '010010']",1,3,12,7,2,19,2.371794871794872,6,10
"['01101', '0011', '111111', '001001']",1,4,8,13,2,21,3.4727272727272727,17,17
"['11011', '0001110', '111', '000000', '11100', '101111']",1,6,14,18,4,32,7.7489510489510485,53,51
"['1101', '010', '1000101']",1,3,7,7,0,14,1.8987012987012988,9,6
"['0', '1010', '11100', '101110']",1,4,7,9,0,16,3.212987012987013,18,15
"['10101', '00', '1101']",1,3,5,6,0,11,1.5714285714285714,7,6
"['1100010', '100', '011001']",1,3,9,7,0,16,2.0358974358974358,10,6
"['1001001', '100', '1001111', '111011']",1,4,9,14,2,23,3.5894993894993896,20,28
"['0110111', '000011', '011000']",1,3,10,9,2,19,1.576923076923077,10,12
"['001000', '011110', '11']",1,3,7,7,2,14,1.25,12,4
"['10100', '1', '111010']",1,3,5,7,0,12,1.3463203463203464,11,6
"['001101', '0010001', '110', '10']",1,4,10,8,0,18,3.5803418803418805,20,16
"['01011', '1100001', '10000', '00001']",1,4,14,8,3,22,3.6,16,20
"['0111', '000000', '1010', '1110']",1,4,10,8,3,18,2.55,20,15
"['0110101', '11011', '00101', '0100', '0111111', '01010', '101001', '110101']",1,8,19,26,7,45,18.835730935730936,70,82
"['0001101', '10', '11']",1,3,5,6,2,11,1.3888888888888888,11,6
"['100', '111', '1001']",1,3,4,6,2,10,1.7619047619047619,5,10
"['0000111', '0110111', '11']",1,3,6,10,2,16,1.6031746031746033,12,13
"['011', '01011', '1000111', '0100']",1,4,9,10,0,19,3.80021645021645,18,18
"['11110', '1', '00001', '1000', '01010', '001100']",1,6,15,11,3,26,6.881673881673882,49,35
"['10100', '001', '10101', '000000']",1,4,13,6,2,19,2.971717171717172,17,19
"['0011', '01001', '0110']",1,3,7,6,2,13,2.083333333333333,6,7
"['001', '1', '11101', '00000']",1,4,8,6,2,14,2.033333333333333,21,13
"['0', '1111001', '1111', '1100111', '1011']",1,5,6,17,4,23,4.477922077922078,37,44
"['010', '001101', '001000', '11', '0010101', '1010', '1100111']",1,7,18,17,4,35,12.672788322788323,69,55
"['0101111', '00', '1001', '110']",1,4,7,9,0,16,2.846176046176046,20,11
"['101010', '0101011', '11']",1,3,6,9,0,15,1.7136752136752138,11,8
"['1010', '00110', '0001', '11']",1,4,8,7,2,15,3.1825396825396823,15,12
"['01', '110', '001010']",1,3,6,5,0,11,1.3444444444444446,9,7
"['1000001', '1001010', '0011000', '0011', '000010', '0110010']",1,6,25,13,4,38,9.914685314685315,46,47
"['001', '101', '1010101', '1101011', '111111']",1,5,8,18,4,26,5.4212454212454215,33,42
"['1011', '10', '1111011']",1,3,3,10,0,13,1.8383838383838382,10,13
"['010100', '0100010', '11011', '1']",1,4,10,9,0,19,2.52988677988678,24,10
"['0100010', '101', '110101']",1,3,8,8,0,16,1.682051282051282,10,6
"['110011', '111111', '00', '10', '011010']",1,5,8,14,5,22,4.583333333333333,36,21
"['000110', '0000100', '11', '00001', '1101000', '011010', '0100']",1,7,24,13,4,37,11.462426462426462,69,74
"['01', '00110', '1010', '0010100']",1,4,11,7,0,18,3.90981240981241,17,18
"['0', '1010', '0101101']",1,3,6,6,0,12,1.3772727272727274,12,6
"['0', '1101000', '001111', '0111']",1,4,8,10,0,18,2.742707292707293,26,17
"['1110101', '001100', '10101', '1000111']",1,4,11,14,2,25,3.7047952047952046,19,19
"['000110', '00010', '1010010', '1']",1,4,12,7,0,19,3.380702630702631,21,18
"['011111', '1010100', '0110100', '1111']",1,4,9,15,2,24,3.824975024975025,19,22
"['0010', '11', '101010', '000', '01110']",1,5,11,9,0,20,5.058874458874459,26,26
"['001', '11000', '0101010', '10', '0100']",1,5,13,8,0,21,5.614574314574314,29,28
"['01001', '010', '0110', '1111']",1,4,7,9,2,16,3.503968253968254,13,15
"['10111', '0010101', '01010', '000', '01100']",1,5,14,11,3,25,5.933333333333334,28,26
"['1000001', '1000100', '101011', '0001', '00010', '011010']",1,6,22,13,4,35,9.747663447663447,43,41
"['001', '001111', '00000', '101', '100', '10100', '11100']",1,7,17,13,6,30,11.428282828282828,60,71
"['100', '1101101', '001110', '0011111', '110']",1,5,10,16,4,26,5.57997557997558,37,30
"['1001', '0101011', '1', '001000']",1,4,10,8,0,18,2.8783716283716285,23,10
"['111', '00101', '101010', '0001', '100', '10110', '010101', '0111']",1,8,17,19,8,36,16.91868686868687,65,74
"['111010', '011101', '100111', '100101', '000', '1110100', '0001011', '1011111']",1,8,20,28,7,48,16.63040293040293,89,89
"['1100010', '1111011', '1110', '1011000']",1,4,10,15,3,25,3.857142857142857,18,19
"['1010', '11110', '0101111', '11111']",1,4,5,16,2,21,3.5676767676767676,15,28
"['1001110', '001', '000', '1111']",1,4,8,9,2,17,2.6978354978354977,19,12
"['1000', '0010', '011', '101101']",1,4,9,8,2,17,3.223809523809524,16,12
"['11001', '010', '111', '100', '111001', '000', '01110', '011000']",1,8,17,17,8,34,16.69090909090909,71,73
"['1101', '0001', '110111', '111001']",1,4,7,13,4,20,3.7666666666666666,16,30
"['1001110', '001', '11', '100', '10110']",1,5,9,11,2,20,5.765873015873016,29,27
"['1010', '10101', '0101110', '0100']",1,4,10,10,2,20,4.4267676767676765,14,16
"['1101001', '0010001', '1011110', '10000', '00']",1,5,16,12,3,28,5.142857142857142,40,26
"['11001', '101100', '0011', '0000101', '0110010']",1,5,16,13,2,29,6.545054945054945,32,23
"['11010', '000101', '00110', '111110', '1011011']",1,5,12,17,4,29,5.7072261072261075,30,26
"['0101', '11101', '00011']",1,3,6,8,2,14,1.7333333333333334,8,9
"['1011', '11010', '011']",1,3,4,8,0,12,2.0238095238095237,6,10
"['10001', '100', '0001', '11101', '1011']",1,5,10,11,4,21,6.159523809523809,21,37
"['101010', '1101', '000111', '1101011']",1,4,9,14,2,23,3.811888111888112,18,21
"['1101101', '110', '0100']",1,3,6,8,0,14,1.7168831168831167,10,6
"['010100', '0', '101011', '10001', '100111', '1001100']",1,6,16,15,3,31,8.107142857142858,52,40
"['0101', '1010110', '000100', '111']",1,4,10,10,0,20,3.1363081363081364,20,10
"['001', '1011101', '10110', '10100', '1000', '00110', '0001010', '11100']",1,8,22,19,6,41,17.46154401154401,75,88
"['111000', '1110000', '00100', '0110', '0111111', '0111101', '1110']",1,7,17,23,5,40,12.815223665223666,66,77
"['0010', '001', '101', '0110', '01110']",1,5,10,9,4,19,6.5436507936507935,19,29
"['10111', '11101', '11111']",1,3,2,13,3,15,2.0,4,22
"['10', '011', '01000', '0101100']",1,4,10,7,0,17,3.3492063492063493,19,19
"['100', '10010', '111']",1,3,5,6,2,11,1.5833333333333333,7,8
"['1110010', '0111010', '100', '0101100', '101111']",1,5,13,17,3,30,6.53015873015873,34,26
"['0', '1010', '1001110', '111']",1,4,6,9,0,15,2.5487012987012987,21,12
"['101', '0011', '011001', '11']",1,4,6,9,0,15,3.8047619047619046,15,17
"['0', '10100', '001', '11101']",1,4,7,7,2,14,2.7666666666666666,18,12
"['0010000', '0110100', '01110']",1,3,12,7,2,19,2.0476190476190474,8,16
"['0', '11000', '111110', '10', '1101']",1,5,7,11,0,18,5.235930735930736,30,23
"['001', '0011', '101', '110011', '101111']",1,5,8,14,4,22,6.606349206349206,25,38
"['11011', '111', '011100', '100', '1000000', '0111']",1,6,13,15,2,28,7.848334998334998,50,47
"['001', '00101', '10001', '0110010', '000100', '01110']",1,6,19,12,3,31,9.802564102564103,42,43
"['1110011', '1001', '001']",1,3,6,8,0,14,2.1844155844155844,8,10
"['11110', '11010', '01', '0001', '100', '001100']",1,6,13,12,2,25,8.051298701298702,42,39
"['001101', '110001', '111111', '000000', '110']",1,5,13,14,4,27,4.5,37,27
"['001101', '00101', '10']",1,3,7,6,0,13,1.9805194805194803,8,10
"['001', '010', '011100', '101101', '0110', '100111', '0000011', '110101']",1,8,20,21,6,41,17.051803751803753,87,66
"['010100', '0101010', '00', '1100101', '10011', '0111', '1100', '1110']",1,8,19,20,5,39,16.314652014652015,82,78
"['00010', '00', '1011000', '11']",1,4,10,6,2,16,2.246031746031746,23,16
"['010', '0011', '00', '111110', '11100']",1,5,9,11,0,20,5.375685425685425,30,32
"['1011110', '1101', '1100', '1111001']",1,4,7,15,4,22,4.009740259740259,18,19
"['0110101', '0111000', '0010', '1001010', '1000110', '10101', '01011', '00010', '001011', '0100']",1,10,32,25,9,57,30.299295149295148,123,137
"['0001', '1001', '10101', '01000']",1,4,11,7,4,18,4.016666666666667,11,17
"['011', '0011010', '1111110', '1010', '1000']",1,5,11,14,4,25,5.035714285714286,34,28
"['0101111', '001110', '0110', '11']",1,4,7,12,0,19,3.7257964257964256,19,15
"['011', '11', '110001', '00110', '10', '010011', '01000']",1,7,15,14,6,29,12.055050505050504,61,55
"['1110111', '11010', '010', '0011110', '0000011']",1,5,13,16,3,29,5.2214285714285715,39,28
"['1101001', '100', '10010', '1100000']",1,4,13,9,2,22,3.9976190476190476,18,17
"['0', '010', '0011110', '01011', '1110']",1,5,9,11,0,20,5.243145743145743,32,34
"['010011', '1011011', '11010']",1,3,7,11,0,18,1.8275058275058274,8,10
"['0100000', '011', '111', '01000', '1110001', '1110']",1,6,15,14,4,29,8.052020202020202,50,49
"['001101', '11', '00000', '100', '11101', '000010']",1,6,16,11,4,27,7.022438672438672,50,44
"['11001', '100100', '000', '1011', '0101']",1,5,12,10,2,22,5.812193362193362,26,23
"['0110101', '1100001', '1010101', '10011', '0101', '01000']",1,6,18,17,5,35,9.766666666666666,43,49
"['1010', '1', '1111110', '0001111']",1,4,6,13,2,19,2.1987012987012986,28,16
"['00', '1010101', '1100101', '110010']",1,4,11,11,2,22,3.6416361416361416,20,18
"['0', '10', '101101']",1,3,4,5,0,9,1.4523809523809523,10,5
"['1', '00001', '000101', '1000111', '000001', '01110', '01000']",1,7,22,13,5,35,11.109074259074259,67,58
"['1000000', '0001', '000001']",1,3,14,3,0,17,2.114685314685315,8,17
"['001', '100010', '0110000', '10', '01100']",1,5,15,8,0,23,5.630558330558331,34,31
"['0101011', '101111', '0100']",1,3,7,10,0,17,1.7426573426573428,9,7
"['10110', '0110000', '11101', '10', '010011', '0101', '1111111']",1,7,14,22,4,36,10.931135531135531,74,55
"['101110', '110111', '0101000', '10011']",1,4,10,14,2,24,3.8648018648018647,17,13
"['0011', '0101', '1111101']",1,3,5,10,2,15,1.6590909090909092,11,9
"['001', '00111', '0001', '1101000', '00']",1,5,13,8,0,21,6.035137085137085,30,39
"['1110111', '1101001', '111100', '1010', '001100']",1,5,12,18,4,30,6.1613719613719615,32,29
"['0011', '0001', '100110', '00', '01100']",1,5,13,8,2,21,6.393145743145743,26,31
"['11011', '111', '1001010', '1010011', '1100111', '0110010', '101111']",1,7,15,27,4,42,14.221228771228771,61,90
"['010', '1', '100010', '000', '1001001']",1,5,13,7,2,20,5.004945054945055,34,20
"['0101', '1010', '110001', '000']",1,4,10,7,2,17,3.5595238095238093,15,11
"['1001', '0000000', '0111']",1,3,10,5,2,15,1.0454545454545454,14,4
"['0', '0111000', '00001', '1110001', '0000110']",1,5,17,10,3,27,5.083333333333333,43,31
"['11110', '100001', '00101', '101', '000100']",1,5,14,11,4,25,5.427777777777778,31,25
"['01', '1011001', '000', '1011', '110']",1,5,9,10,2,19,4.828860028860029,29,23
"['101', '10001', '1000010', '0100100', '1011']",1,5,15,11,2,26,6.779004329004329,29,30
"['01', '1001', '0001111', '100010', '10011', '0011011']",1,6,15,16,2,31,9.555300255300255,48,45
"['101', '0111101', '10']",1,3,4,8,0,12,1.8444444444444446,10,9
"['1110111', '0001', '100', '000', '110']",1,5,10,10,3,20,4.944588744588744,30,27
"['0101101', '010', '001', '1']",1,4,7,7,2,14,2.9166666666666665,20,13
"['010', '0011000', '1111', '1001100', '111000', '101110']",1,6,16,17,4,33,8.970984570984571,47,42
"['1101001', '101', '1010', '100']",1,4,8,9,2,17,4.308225108225108,14,19
"['0010', '10110', '0110001']",1,3,9,7,0,16,1.8787878787878787,10,7
"['11001', '01', '011', '0000100', '1000']",1,5,13,8,0,21,5.0470418470418466,33,24
"['11110', '111', '1010', '00', '01100']",1,5,8,11,2,19,5.056349206349206,26,25
"['0100001', '0011', '001', '01110']",1,4,11,8,0,19,3.6692640692640692,18,17
"['10', '000000', '11']",1,3,7,3,2,10,0.75,12,4
"['00111', '100010', '11']",1,3,6,7,0,13,1.6168831168831168,10,8
"['11100', '1101', '1', '110010']",1,4,6,10,0,16,3.212987012987013,18,18
"['101', '1111', '1000', '100000', '10011']",1,5,11,11,2,22,5.243867243867244,27,40
"['1000', '110', '110100', '100010']",1,4,11,8,2,19,3.749206349206349,15,19
"['0010', '010', '1110', '11']",1,4,6,7,2,13,3.3285714285714283,12,16
"['100101', '00', '1100']",1,3,7,5,0,12,1.7666666666666666,9,6
"['100001', '00011', '110001', '110100', '10']",1,5,14,11,3,25,5.770562770562771,31,31
"['1011', '1101', '0010010', '1100100']",1,4,11,11,4,22,3.8279220779220777,20,15
"['0', '0100011', '01010']",1,3,8,5,0,13,1.25,13,10
"['0', '01', '0110110']",1,3,5,5,0,10,1.3611111111111112,12,9
"['00', '100001', '0111']",1,3,7,5,0,12,1.2333333333333334,11,4
"['101', '01001', '001', '1111']",1,4,6,9,2,15,3.4682539682539684,13,18
"['0101', '100000', '11']",1,3,7,5,0,12,1.3166666666666667,11,6
"['1010110', '00110', '0101011', '101110']",1,4,11,14,2,25,4.469030969030969,13,21
"['010', '011010', '01100', '0100']",1,4,11,7,0,18,4.671789321789322,10,37
"['01', '1101', '111']",1,3,2,7,0,9,1.9238095238095236,5,11
"['001', '001110', '011', '0111']",1,4,7,9,2,16,4.228571428571429,12,17
"['0000101', '001', '10', '0100']",1,4,11,5,0,16,3.2279942279942277,19,16
"['001', '011', '1110']",1,3,4,6,2,10,1.5238095238095237,6,7
"['00', '0101111', '0001', '1111']",1,4,7,10,2,17,2.452020202020202,21,18
"['1011010', '0010', '1110000', '10111', '1111', '111101']",1,6,12,21,4,33,8.902436452436453,44,56
"['110110', '11', '100', '000101', '0000']",1,5,12,9,2,21,4.782539682539682,33,27
"['0', '0001101', '010010', '11']",1,4,9,7,0,16,2.2493894993894994,25,10
"['10001', '100', '111001', '00', '0000011', '1111011']",1,6,15,15,2,30,8.308041958041958,53,46
"['0', '100', '01110']",1,3,5,4,0,9,1.3333333333333333,9,8
"['111', '0011001', '0001100', '0000010', '1100']",1,5,17,11,3,28,5.732467532467532,36,32
"['1010000', '10010', '0000001']",1,3,14,5,2,19,1.7380952380952381,10,10
"['01', '00101', '11000', '1111', '00', '1011', '110101']",1,7,12,16,6,28,10.987878787878788,58,62
"['0', '0101110', '01000']",1,3,8,5,0,13,1.25,13,14
"['1011', '000', '1110']",1,3,5,6,2,11,1.0714285714285714,8,5
"['001111', '10', '0000']",1,3,7,5,0,12,0.9833333333333334,12,8
"['11001', '110000', '01', '010001', '111100', '111', '00001', '101']",1,8,18,18,7,36,15.763564213564214,83,95
"['01', '11', '1100010', '10100', '0000', '01110']",1,6,14,11,4,25,7.19076479076479,48,34
"['0', '0010', '1101111']",1,3,5,7,0,12,1.0136363636363637,14,4
"['001', '1', '0000001']",1,3,8,3,0,11,1.35,12,9
"['100101', '0111101', '1', '01110']",1,4,7,12,0,19,2.6814019314019313,24,15
"['010', '11', '100', '10000', '0100011']",1,5,12,8,2,20,5.313492063492063,31,25
"['11001', '0101', '111010', '11101']",1,4,7,13,2,20,4.369696969696969,11,24
"['11001', '101', '1110011', '00', '110']",1,5,8,12,2,20,6.015873015873016,28,27
"['001', '11', '11000', '010010', '100101', '0101100', '0111', '0011011']",1,8,20,20,4,40,16.786979686979688,88,73
"['0011011', '0111101', '0111100', '0100']",1,4,11,14,3,25,3.9220779220779223,19,25
"['0', '1010001', '1100', '111010']",1,4,9,9,0,18,3.0783716283716283,22,11
"['0', '1001', '1110000', '0011000']",1,4,12,7,2,19,2.705194805194805,26,13
"['010', '0010111', '100001', '1']",1,4,9,8,0,17,2.5416971916971915,25,10
"['01', '00', '100011']",1,3,6,4,2,10,1.5,9,4
"['11110', '0100110', '11', '10111', '110001']",1,5,9,16,2,25,5.726928626928626,32,32
"['110010', '11011', '0001110', '001110', '00010']",1,5,15,14,4,29,6.345221445221445,28,40
"['0', '11110', '1100101', '10']",1,4,6,9,0,15,2.765873015873016,22,12
"['000011', '101', '1100001', '1101110', '10100', '011010']",1,6,17,17,4,34,9.172166722166722,51,37
"['110011', '100000', '0111']",1,3,8,8,2,16,1.3,11,8
"['1100001', '010101', '1101', '0000']",1,4,12,9,2,21,3.51993006993007,17,16
"['10100', '001', '1']",1,3,5,4,0,9,1.3333333333333333,9,7
"['1100', '0000011', '10', '1011111']",1,4,9,11,2,20,2.489177489177489,27,17
"['011101', '011111', '100', '0110100']",1,4,9,13,2,22,3.4846153846153847,19,21
"['101010', '100', '110']",1,3,6,6,2,12,1.7777777777777777,7,8
"['0', '101', '110010', '000001']",1,4,10,6,2,16,2.6825396825396823,23,11
"['11000', '010', '0101111']",1,3,7,8,0,15,1.4333333333333333,12,9
"['0010', '00', '001', '01011']",1,4,9,5,0,14,4.061904761904762,11,20
"['1000001', '101100', '0001', '111000', '1101010']",1,5,17,13,4,30,6.111055611055611,32,29
"['0', '1010', '011001']",1,3,6,5,0,11,1.2857142857142856,12,6
"['101010', '0101101', '110010', '10010']",1,4,12,12,2,24,4.033799533799534,13,21
"['100', '001110', '000']",1,3,8,4,2,12,1.7777777777777777,8,13
"['01111', '000', '001000']",1,3,9,5,0,14,1.2803030303030303,11,14
"['101', '0001', '001001', '01011', '101111']",1,5,11,13,2,24,6.053751803751804,25,30
"['0011', '10101', '0101111']",1,3,6,10,0,16,2.0606060606060606,8,7
"['1001101', '100000', '1100', '01100', '0110011']",1,5,16,13,2,29,6.598279498279498,30,30
"['10000', '10', '0100100']",1,3,10,4,0,14,1.8492063492063493,10,8
"['0', '11110', '01', '011']",1,4,4,7,0,11,3.085714285714286,15,14
"['00010', '110', '01011']",1,3,7,6,2,13,1.6,8,8
"['0', '0011', '0101100']",1,3,7,5,0,12,1.3772727272727274,12,9
"['01', '0110111', '111', '000011', '100', '000', '001001']",1,7,16,14,5,30,10.121367521367521,68,60
"['001', '01101', '10110', '01010']",1,4,9,9,3,18,3.9000000000000004,13,15
"['1001010', '0011000', '100', '110100', '100111']",1,5,16,13,4,29,6.527838827838828,31,32
"['1001110', '1111100', '0']",1,3,6,9,2,15,1.2142857142857144,15,6
"['011011', '10011', '111101', '11']",1,4,5,14,2,19,3.329004329004329,19,28
"['0001001', '1010110', '001', '1', '010101']",1,5,13,11,2,24,4.84004884004884,39,25
"['01', '01101', '10100', '1110', '1111011']",1,5,8,15,2,23,5.525685425685426,31,25
"['1111010', '10', '0100101']",1,3,7,9,2,16,1.4603174603174602,14,7
"['001', '1', '1010101', '0110', '1110']",1,5,8,11,2,19,4.2844155844155845,30,21
"['1', '110001', '1101110', '111110', '100111']",1,5,8,18,3,26,5.081501831501831,37,37
"['10111', '1111', '1010', '101001', '111001']",1,5,8,17,4,25,6.739393939393939,21,52
"['0011110', '111010', '1101101', '000001']",1,4,12,14,4,26,3.058608058608059,23,14
"['01', '001', '011011', '110001', '00']",1,5,10,9,4,19,5.877777777777778,28,26
"['0111101', '0010', '100']",1,3,7,7,0,14,1.516883116883117,11,7
"['010', '1000101', '0010101', '00', '1000']",1,5,15,8,2,23,6.113997113997113,32,29
"['0010001', '010', '1', '011001', '10001', '110100', '0000']",1,7,20,12,2,32,10.521295371295372,68,52
"['110000', '0101110', '0010111', '00', '0111111', '0111', '011110', '01001', '1110']",1,9,20,28,7,48,20.298662448662448,118,127
"['1110010', '111', '100', '10110', '10', '01000']",1,6,12,13,4,25,8.503968253968253,43,39
"['10001', '110', '01100']",1,3,7,6,2,13,1.85,8,4
"['01', '1010', '0100']",1,3,6,4,2,10,2.083333333333333,6,7
"['01', '00', '1011', '00010', '110']",1,5,9,7,2,16,4.958730158730159,24,22
"['0010010', '0100000', '01011', '1110']",1,4,14,9,2,23,3.0526695526695526,22,19
"['0000', '011011', '101101']",1,3,8,8,2,16,1.6333333333333333,10,4
"['001011', '011', '101101', '01010', '110', '1001111', '1110']",1,7,13,21,4,34,13.13925518925519,59,58
"['11110', '001', '010001', '00111', '0110', '010010', '1011100', '10', '0000', '0101']",1,10,25,21,7,46,25.495632145632147,128,130
"['101110', '000', '11']",1,3,5,6,0,11,0.9444444444444444,11,4
"['00110', '0111001', '11']",1,3,6,8,0,14,1.5158730158730158,11,4
"['001100', '1110110', '0000110', '01100']",1,4,14,11,2,25,4.198468198468198,18,29
"['10100', '1', '001000']",1,3,8,4,0,12,1.3463203463203464,11,6
"['11010', '0100110', '00', '1101', '0101', '111001']",1,6,13,15,2,28,9.136813186813187,43,38
"['01', '00101', '010011', '011010', '011000']",1,5,14,11,3,25,6.071428571428571,29,32
"['1100111', '0010', '011', '1001100', '011110', '1011000', '011111', '101110']",1,8,19,27,6,46,17.95810855810856,88,81
"['0010', '1000101', '11', '110001', '0010101', '001110', '10']",1,7,18,16,6,34,11.961993561993562,72,56
"['0', '000100', '1001011']",1,3,9,5,0,14,1.151098901098901,14,4
"['000100', '0001100', '1001']",1,3,12,5,0,17,2.0685314685314684,8,11
"['010010', '011', '000']",1,3,8,4,2,12,1.6666666666666665,8,9
"['01', '1001101', '100000', '0000110', '1101010']",1,5,17,12,3,29,5.2976190476190474,39,25
"['0000110', '0001', '1', '100000']",1,4,13,5,0,18,3.0322177822177823,23,17
"['0', '010001', '101', '111110', '110101']",1,5,9,13,3,22,4.412698412698412,37,23
"['0', '001100', '1111010', '10']",1,4,8,8,0,16,2.762210012210012,24,15
"['00', '110', '111101']",1,3,4,7,0,11,1.3166666666666667,10,5
"['011111', '0110101', '10', '110010']",1,4,8,13,2,21,3.0662393162393164,23,16
"['11110', '011', '00101', '00001', '10101', '10000', '1100100', '111011', '100011', '010011']",1,10,26,27,8,53,26.62039627039627,127,143
"['0', '001001', '1110']",1,3,6,5,0,11,1.0857142857142859,12,6
"['11', '010', '100', '00011']",1,4,7,6,2,13,3.038095238095238,15,13
"['1', '110', '001111', '01000']",1,4,7,8,0,15,2.427128427128427,22,12
"['0010', '1101011', '111']",1,3,5,9,0,14,1.431168831168831,11,8
"['010100', '00110', '1100000', '10101']",1,4,14,9,2,23,3.66993006993007,18,13
"['1110101', '010', '1111001']",1,3,6,11,2,17,1.8571428571428572,11,7
"['111000', '000001', '000011']",1,3,12,6,3,18,1.8333333333333335,10,14
"['10111', '0011010', '00', '110', '01100', '0100']",1,6,14,12,2,26,8.601803751803752,42,47
"['101', '01', '1101110']",1,3,4,8,0,12,1.8444444444444446,10,7
"['1', '0110', '011110']",1,3,4,7,0,11,1.4857142857142858,10,8
"['01', '001', '0000100', '111', '011', '0100010', '10001', '0111']",1,8,19,15,5,34,16.34004329004329,82,72
"['1000011', '010', '0111100']",1,3,9,8,2,17,1.4285714285714286,15,5
"['00100', '11000', '100']",1,3,9,4,2,13,2.1,7,12
"['11', '10101', '100000', '0000', '1100111', '1110110']",1,6,15,16,2,31,7.198185148185148,56,46
"['1110101', '00', '01110', '11']",1,4,6,10,2,16,2.698412698412698,21,10
"['0', '010011', '1001', '000011']",1,4,10,7,2,17,3.204761904761905,19,13
"['010101', '0110', '001011', '11']",1,4,8,10,2,18,3.9,17,13
"['000110', '010', '101011', '111011', '0100011']",1,5,13,15,3,28,6.5316239316239315,30,28
"['11011', '00110', '000100', '000000']",1,4,15,7,4,22,3.2515151515151515,18,22
"['010001', '011', '00', '100000', '01010', '011110', '0000110']",1,7,22,13,3,35,12.141941391941392,70,73
"['100110', '110', '0000']",1,3,8,5,0,13,1.5523809523809522,9,8
"['0010001', '100001', '111', '1001000', '10', '0101']",1,6,17,12,2,29,8.385914085914086,50,42
"['100111', '000', '1101', '0101', '1100']",1,5,10,11,3,21,5.673015873015872,25,26
"['01', '10001', '100100', '001']",1,4,10,6,0,16,4.0153679653679655,15,19
"['1011001', '1', '1111011']",1,3,4,11,2,15,1.0714285714285714,14,12
"['0010', '1010', '1100', '01000', '0100']",1,5,14,7,4,21,7.138888888888888,18,38
"['11001', '11', '0111', '101110', '0101001']",1,5,9,15,0,24,6.370651570651571,32,31
"['000110', '01', '010']",1,3,7,4,0,11,1.9666666666666668,8,10
"['1111100', '10000', '100110', '00', '10']",1,5,12,10,2,22,5.374403374403374,34,30
"['101000', '01111', '010010', '10']",1,4,10,9,2,19,3.0281385281385282,21,15
"['00', '10011', '00001']",1,3,8,4,2,12,1.7428571428571429,8,6
"['110110', '011', '0000']",1,3,7,6,0,13,1.3523809523809525,10,7
"['101', '0001', '1001', '110111', '000']",1,5,10,10,4,20,5.829365079365079,24,29
"['1101000', '01101', '0101011']",1,3,9,10,2,19,1.7380952380952381,9,8
"['0', '00111', '101010']",1,3,6,6,0,12,1.1645021645021645,12,6
"['10001', '1101011', '10000', '010111', '10', '011001', '1101', '1110']",1,8,17,22,6,39,16.896975246975245,81,85
"['0', '101000', '010011', '001110']",1,4,11,8,3,19,2.5238095238095237,24,15
"['0', '0000101', '1010110', '1111']",1,4,9,10,2,19,1.7987012987012987,28,10
"['010100', '01', '01110']",1,3,7,6,0,13,1.7987012987012987,9,11
"['110000', '1', '1000111', '0000010', '1011000']",1,5,17,11,3,28,4.607142857142857,44,27
"['001', '1010', '00', '000111', '01011']",1,5,11,9,0,20,6.07012987012987,25,26
"['11', '101011', '1001100', '001100', '0101', '110']",1,6,13,15,2,28,9.498079698079698,45,40
"['1010', '0010', '1111']",1,3,5,7,3,12,1.5,6,6
"['0100000', '001', '111', '0011', '10', '000']",1,6,14,8,3,22,6.541414141414141,45,42
"['00111', '00100', '11000', '0011']",1,4,11,8,3,19,3.5999999999999996,17,28
"['1010', '110001', '01100']",1,3,8,7,0,15,1.993939393939394,9,4
"['101', '01', '1001', '11']",1,4,4,7,2,11,4.29047619047619,8,22
"['11110', '00011', '10000', '1000', '01010', '11111', '0110110']",1,7,17,19,5,36,11.234343434343435,59,63
"['111', '100100', '1001', '100010', '100101']",1,5,13,12,3,25,7.026984126984127,24,43
"['00', '1010100', '00001']",1,3,10,4,0,14,1.349206349206349,12,11
"['000110', '001010', '10110']",1,3,10,7,2,17,2.287878787878788,6,14
"['1100', '1001000', '010110']",1,3,10,7,0,17,1.760839160839161,10,7
"['1100011', '101100', '01', '1']",1,4,7,9,0,16,2.762210012210012,25,14
"['010100', '01', '1000110', '01111', '10110', '000', '1010000']",1,7,20,15,4,35,11.477306027306026,70,61
"['1011', '011', '011000', '1111']",1,4,6,11,2,17,3.595238095238095,15,18
"['1101', '10110', '101110']",1,3,5,10,0,15,2.175757575757576,7,11
"['0111000', '110010', '001', '1001', '10110', '000', '0000110', '0111100']",1,8,24,18,5,42,16.923210123210122,91,90
"['0', '1000011', '00011']",1,3,8,5,0,13,1.4166666666666667,12,8
"['11110', '10101', '001']",1,3,5,8,2,13,1.15,9,7
"['10100', '100', '00', '11']",1,4,7,5,2,12,3.092857142857143,13,17
"['0011', '10', '000']",1,3,6,3,0,9,1.3047619047619048,7,8
"['010001', '0101011', '0110000', '10', '1011']",1,5,14,12,2,26,5.8953157953157955,35,26
"['1', '010010', '00', '010101', '000010']",1,5,14,7,3,21,4.523809523809524,35,27
"['011', '0000101', '111111', '100101', '000100']",1,5,14,14,3,28,5.335042735042735,34,27
"['01', '1', '1001111']",1,3,3,7,0,10,1.3611111111111112,12,8
"['001', '0001110', '10', '011000']",1,4,11,7,0,18,2.8504273504273505,23,19
"['0', '0010', '11011', '1100001', '100100']",1,5,13,10,0,23,5.04029859029859,36,20
"['1011001', '11', '00011', '1110100', '10', '110']",1,6,11,15,4,26,7.982539682539683,54,44
"['101', '01', '1011101']",1,3,4,8,0,12,1.8444444444444446,10,14
"['01', '101011', '1000', '11101']",1,4,7,10,0,17,2.9946608946608944,18,17
"['11110', '111100', '0000100', '000101', '10011', '1011']",1,6,16,17,4,33,8.03986013986014,47,46
"['0001', '111101', '0111']",1,3,5,9,2,14,1.5,9,9
"['1101111', '0010111', '1001010', '111100', '1011']",1,5,11,20,3,31,5.938461538461539,32,37
"['0001', '1010101', '0110']",1,3,8,7,2,15,1.2272727272727273,9,5
"['0010', '11', '101', '0110', '110101']",1,5,8,11,2,19,6.059523809523809,25,21
"['0001101', '0011011', '010110']",1,3,10,10,2,20,2.3956043956043955,7,7
"['0111000', '1000101', '1', '1011001', '00100', '0000101', '1111011']",1,7,21,20,5,41,10.297619047619047,86,54
"['1110010', '010', '01010', '111110']",1,4,9,12,0,21,3.2734654234654235,18,27
"['0111001', '11', '000001', '1011100', '1100']",1,5,13,13,2,26,5.44032079032079,37,29
"['001', '111000', '111011']",1,3,6,9,2,15,1.5555555555555554,10,11
"['100101', '001101', '1']",1,3,6,7,2,13,1.4047619047619047,12,10
"['0', '01', '01101', '001111']",1,4,6,8,0,14,3.0844155844155843,19,14
"['0011', '010101', '01011']",1,3,7,8,0,15,2.397979797979798,4,11
"['11001', '0011010', '00', '10', '0000111']",1,5,13,10,4,23,5.079365079365079,40,25
"['1101', '011', '1011000']",1,3,6,8,0,14,1.7168831168831167,10,7
"['101000', '100100', '0110']",1,3,10,6,2,16,1.6333333333333333,8,8
"['011011', '001', '1111110']",1,3,5,11,0,16,1.105982905982906,12,7
"['0', '001001', '111000', '0001011']",1,4,12,8,2,20,2.552197802197802,26,17
"['010000', '011', '011100', '00000', '0110', '10010', '01010', '101110']",1,8,24,16,6,40,17.58946608946609,69,108
"['000', '11010', '10', '0010000']",1,4,12,5,0,17,3.015873015873016,21,21
"['11', '10101', '0011101', '0100']",1,4,8,10,0,18,2.8795093795093796,20,13
"['00100', '1101', '11']",1,3,5,6,0,11,1.3968253968253967,9,6
"['0', '11110', '110000', '11100']",1,4,8,9,2,17,3.025108225108225,19,17
"['0', '110', '1101111']",1,3,3,8,0,11,1.35,12,7
"['00100', '11011', '100', '0110110']",1,4,10,10,2,20,3.75,18,13
"['00', '0101000', '0001', '0110001']",1,4,14,6,2,20,3.6854256854256855,21,24
"['100110', '01', '0111']",1,3,5,7,0,12,1.7666666666666666,9,7
"['0010', '00000', '100', '0001100', '1011000']",1,5,19,7,2,26,6.258441558441558,30,52
"['0110101', '101100', '110010', '00111', '1001101', '10100', '0110110']",1,7,20,23,7,43,14.695038295038295,58,56
"['01', '010', '100100', '110', '01000']",1,5,12,7,2,19,6.0264790764790765,25,28
"['1010111', '0001', '001', '1']",1,4,7,8,0,15,2.770779220779221,20,17
"['010001', '0100010', '1010101', '1101', '110', '1101010']",1,6,17,17,3,34,9.331357531357531,43,48
"['0000100', '10110', '011', '10']",1,4,10,7,0,17,3.0658730158730156,21,14
"['0', '11000', '101']",1,3,5,4,0,9,1.3333333333333333,9,4
"['01101', '001', '1111', '0001100', '00']",1,5,11,10,0,21,4.898556998556998,32,27
"['0000111', '10001', '00101', '01']",1,4,11,8,2,19,3.5206349206349206,19,16
"['00010', '010', '1', '100111']",1,4,8,7,0,15,2.8589466089466087,20,10
"['01101', '000111', '0100']",1,3,8,7,0,15,1.793939393939394,9,8
"['0011', '00101', '1110', '111']",1,4,6,10,2,16,3.761904761904762,13,21
"['1001111', '1', '0010100']",1,3,7,8,2,15,0.9285714285714286,16,4
"['0100110', '11', '101', '111011', '1010']",1,5,8,14,0,22,6.095759795759796,29,27
"['10100', '1111100', '01', '1']",1,4,6,9,0,15,2.71031746031746,23,14
"['100000', '01001', '110']",1,3,9,5,0,14,1.4898989898989898,10,6
"['1110001', '11000', '01', '0111111']",1,4,8,13,2,21,2.9126984126984126,25,18
"['0', '11010', '10101', '10011', '1011', '000100']",1,6,13,13,3,26,8.166522366522367,43,34
"['011', '10', '0100']",1,3,5,4,0,9,1.638095238095238,6,7
"['000011', '11111', '1011', '1110', '0100']",1,5,9,14,3,23,4.596969696969697,30,31
"['111111', '0001', '0110110']",1,3,6,11,0,17,1.1790209790209791,12,4
"['1', '000', '0101100']",1,3,7,4,0,11,0.65,13,6
"['001', '010', '1001', '0110', '10000']",1,5,12,7,4,19,6.134920634920634,23,25
"['1000011', '00010', '011', '1111']",1,4,9,10,0,19,2.923953823953824,20,16
"['101', '11101', '01011', '001000']",1,4,9,10,2,19,3.4535353535353535,18,13
"['001', '00100', '10101', '10000', '100011', '0100001']",1,6,20,11,3,31,9.752564102564103,38,43
"['1', '0001100', '010111', '01010', '011111', '00010']",1,6,15,15,4,30,7.513503163503163,50,43
"['10000', '00', '011']",1,3,7,3,0,10,1.2214285714285715,9,8
"['1011001', '011', '111010', '001000', '101', '1010000']",1,6,17,15,6,32,8.696336996336996,50,39
"['11001', '0001001', '00101', '1111', '00', '111110', '01010', '0100011']",1,8,20,21,5,41,14.705067155067155,95,78
"['00110', '00', '10', '011000']",1,4,10,5,2,15,3.37012987012987,18,24
"['11010', '11', '10011', '10', '000000']",1,5,11,9,4,20,4.162987012987013,34,25
"['11000', '1010', '0110', '101111']",1,4,8,11,2,19,3.396969696969697,17,14
"['010001', '10001', '1101110', '111011', '00', '10010', '1010001', '011000']",1,8,23,21,7,44,17.30702075702076,89,75
"['10010', '010111', '01010', '1011111']",1,4,9,14,2,23,3.641958041958042,17,18
"['110011', '010', '110', '10000']",1,4,9,8,2,17,3.323232323232323,17,14
"['0001101', '1011', '1101']",1,3,6,9,2,15,2.0227272727272725,9,12
"['11000', '00', '100', '10']",1,4,8,4,2,12,3.992857142857143,11,18
"['0000101', '101', '1']",1,3,6,5,0,11,1.35,12,10
"['01', '1110000', '100', '00110', '1110', '0100']",1,6,14,11,2,25,8.106060606060606,44,45
"['1001001', '1110010', '001', '110']",1,4,10,10,4,20,3.2476190476190476,22,16
"['00100', '0011110', '100001']",1,3,11,7,0,18,1.6736596736596736,11,7
"['110011', '0001', '1', '01110']",1,4,7,9,0,16,2.6089466089466087,22,10
"['0', '0001100', '001111']",1,3,8,6,0,14,1.151098901098901,14,10
"['1011001', '0011', '111011', '111111', '10']",1,5,7,18,2,25,4.983488733488733,34,38
"['0', '100011', '000001', '11111']",1,4,9,9,2,18,1.7835497835497836,25,12
"['11001', '0001001', '01101', '100', '10']",1,5,12,10,2,22,6.37063492063492,29,27
"['111', '1110011', '0000001', '10100', '10011']",1,5,13,14,4,27,5.161904761904762,35,41
"['11010', '10', '11111']",1,3,3,9,2,12,1.457142857142857,9,9
"['00', '1101', '11111']",1,3,3,8,0,11,1.0,10,6
"['010100', '1110111', '1001']",1,3,7,10,0,17,1.606993006993007,11,4
"['101100', '0000000', '1100100', '0111']",1,4,15,9,2,24,2.8217782217782217,23,19
"['0101000', '011', '101101', '10', '110101']",1,5,11,13,2,24,5.6752136752136755,33,23
"['111', '0011', '100', '0101', '0100101']",1,5,10,11,4,21,6.023593073593074,27,28
"['0101111', '0101110', '0111', '110']",1,4,7,14,2,21,3.883116883116883,18,25
"['0001101', '10001', '1001000']",1,3,12,7,2,19,1.7619047619047619,9,11
"['0', '1101001', '11010', '1111', '01010', '01001']",1,6,12,15,3,27,8.066161616161617,46,43
"['01', '0101110', '0000001', '1011000']",1,4,14,9,3,23,2.761904761904762,27,16
"['00', '0100100', '10', '0111']",1,4,9,6,2,15,2.6010101010101008,21,17
"['0', '11000', '1001', '000101', '0011010', '1000011']",1,6,18,12,2,30,8.047119547119546,55,34
"['0100011', '1', '000']",1,3,7,4,0,11,0.85,13,4
"['101', '10001', '011100']",1,3,7,7,0,14,1.7398989898989898,10,6
"['011011', '0101', '001', '1111']",1,4,6,11,2,17,3.4015873015873015,13,16
"['0011', '001', '1001011']",1,3,7,7,0,14,2.1844155844155844,8,10
"['110010', '010000', '0010', '000011', '1100000', '010010', '1010111', '000', '1010011', '010011']",1,10,35,23,8,58,29.43941613941614,122,162
"['00', '00010', '110', '1111101']",1,4,8,9,0,17,2.626984126984127,23,14
"['101', '000101', '0110000', '11101', '1001011', '111001']",1,6,16,18,4,34,9.248501498501499,49,51
"['1110000', '111010', '100', '0110', '1111010', '001010', '1100', '001011', '01000']",1,9,25,23,7,48,22.62273282273282,102,127
"['0', '010', '11111', '110', '1110']",1,5,5,11,2,16,4.911904761904761,25,29
"['10100', '1001', '0001', '001001']",1,4,12,7,2,19,3.9883838383838386,12,23
"['01', '111110', '0100110', '1101']",1,4,7,12,0,19,3.121950271950272,22,15
"['00111', '001100', '010']",1,3,8,6,0,14,1.893939393939394,8,12
"['0011000', '1001010', '00000', '00110', '001100', '010011']",1,6,24,12,6,36,10.310789210789212,38,73
"['11', '0000010', '1010001', '110', '1110']",1,5,12,11,2,23,5.232034632034632,36,27
"['001', '0001110', '00001', '10110', '111101']",1,5,13,13,2,26,5.552253302253302,33,28
"['1001100', '01101', '1010100', '110']",1,4,11,11,2,22,3.3452380952380953,18,15
"['010', '11', '100110', '1010', '0111110', '01100']",1,6,12,15,0,27,9.295976245976245,44,43
"['1', '11100', '0110111']",1,3,4,9,0,13,1.0833333333333333,14,8
"['0011011', '01001', '010', '00000']",1,4,13,7,2,20,3.25,18,18
"['1', '00011', '1101100', '11101', '0000', '01011']",1,6,13,14,3,27,6.58030303030303,53,42
"['011101', '11010', '00', '1101']",1,4,7,10,0,17,3.820923520923521,16,16
"['1011010', '111111', '111110', '000010', '110', '1111011']",1,6,11,24,5,35,8.352625152625153,47,61
"['11', '1001', '110', '0000']",1,4,7,6,2,13,2.8238095238095235,14,12
"['11011', '0001110', '101101', '101011', '10101', '100', '1111', '0000011', '000', '0111']",1,10,22,28,10,50,25.90992895992896,134,144
"['1000100', '01', '110']",1,3,7,5,0,12,1.2444444444444445,11,6
"['11111', '00010', '001', '00011']",1,4,9,9,3,18,3.15,16,17
"['01011', '1100100', '1111011']",1,3,7,12,2,19,1.7380952380952381,11,13
"['0100001', '01111', '00101', '0']",1,4,10,8,2,18,2.683333333333333,23,14
"['110000', '10101', '0000110', '000']",1,4,14,7,0,21,3.260839160839161,21,21
"['101110', '101011', '10001', '111']",1,4,7,13,2,20,3.55050505050505,16,24
"['0', '10100', '01111']",1,3,5,6,2,11,1.0666666666666667,12,6
"['101100', '011', '10', '0000']",1,4,9,6,0,15,2.585714285714286,18,15
"['0', '11110', '000011', '101000', '0101011', '01000', '01110']",1,7,19,16,5,35,10.096953046953047,72,67
"['101', '0001', '100']",1,3,6,4,2,10,1.8095238095238093,5,9
"['000110', '010', '1', '001', '0111']",1,5,9,8,2,17,5.428571428571429,27,21
"['0101111', '11011', '1011001', '011', '00']",1,5,9,15,2,24,5.572222222222222,35,25
"['010', '10101', '100110', '111000', '110', '0111110']",1,6,13,17,4,30,9.064607614607615,46,40
"['101010', '01', '0110', '111']",1,4,6,9,0,15,3.204761904761905,15,12
"['1010110', '00101', '100100', '10', '011110']",1,5,13,13,2,26,5.673215673215673,32,28
"['0101', '010', '0110']",1,3,6,5,2,11,2.4642857142857144,4,13
"['0', '1110100', '0111', '111001']",1,4,7,11,0,18,2.8503996003996006,23,17
"['0110100', '0000100', '11', '011', '110011', '1110001', '110101']",1,7,18,20,5,38,12.17008547008547,75,68
"['11110', '0011001', '00100', '010010', '011101', '111000']",1,6,18,17,5,35,9.523543123543124,42,43
"['10100', '1100', '1']",1,3,5,5,0,10,1.6222222222222222,8,8
"['1101111', '1010111', '00110', '000', '1110']",1,5,10,16,2,26,5.417099567099567,35,28
"['0011', '0100000', '001111']",1,3,10,7,0,17,1.4713286713286715,12,12
"['111000', '1', '01010', '100010']",1,4,10,8,2,18,2.662337662337662,22,12
"['00', '1111110', '01010']",1,3,6,8,0,14,1.126984126984127,13,9
"['0', '101100', '110001', '0101010', '111110', '00010']",1,6,16,15,3,31,6.92066267066267,55,36
"['10000', '000', '01010', '1001001', '01011']",1,5,16,9,3,25,6.566666666666666,28,27
"['0010110', '101000', '000011', '0010011']",1,4,16,10,4,26,4.126373626373627,15,24
"['10100', '111000', '1']",1,3,6,6,0,12,1.3463203463203464,11,7
"['100101', '101', '00', '110']",1,4,7,7,2,14,3.0777777777777775,16,13
"['101100', '001', '100001', '10010', '10']",1,5,13,9,2,22,5.605266955266956,29,31
"['1100001', '000', '010011', '101110', '0100']",1,5,15,11,2,26,5.749361749361749,32,24
"['010100', '111010', '0011001', '00100', '0010011', '100110', '10011']",1,7,23,19,7,42,14.325274725274726,58,67
"['0', '0010', '0110', '1010000', '1110']",1,5,12,8,3,20,4.904545454545454,31,31
"['110000', '000110', '0010', '1', '1011001', '1000', '0111100']",1,7,20,15,6,35,10.897252747252747,75,53
"['0010101', '01000', '0000']",1,3,12,4,0,16,2.0606060606060606,7,15
"['0011', '01', '1100101', '111101']",1,4,7,12,0,19,3.3537684537684536,20,21
"['110110', '111', '00111', '10011', '011110', '01001']",1,6,11,19,5,30,9.41969696969697,39,42
"['00', '01101', '1110100']",1,3,7,7,0,14,1.6825396825396823,11,8
"['01101', '01', '001']",1,3,5,5,0,10,1.8714285714285714,6,10
"['0101010', '0001110', '11100', '101']",1,4,11,11,2,22,3.238095238095238,21,12
"['101000', '1101', '1010']",1,3,7,7,2,14,2.15,7,9
"['1110001', '0101', '1', '011000']",1,4,9,9,0,18,2.8503996003996006,23,12
"['110110', '01', '010000', '1111']",1,4,8,10,2,18,2.8333333333333335,21,13
"['110010', '0010', '101', '10100', '0101100', '000100', '01000']",1,7,23,13,4,36,14.284521034521035,52,72
"['01111', '1001', '1']",1,3,3,7,0,10,1.1777777777777778,10,8
"['111010', '00111', '10111', '010010', '10', '011010']",1,6,13,17,5,30,8.445021645021646,43,48
"['100', '1', '01011']",1,3,4,5,0,9,1.3333333333333333,9,6
"['0001', '10', '1101']",1,3,5,5,2,10,1.5,7,7
"['0111000', '0010111', '11', '1101', '00010']",1,5,12,13,2,25,5.1147186147186146,39,25
"['0010', '11', '1010101', '00010', '0111101']",1,5,12,13,2,25,4.916305916305916,35,22
"['0001001', '01', '0010', '00000', '1111000', '00110', '000010']",1,7,25,11,4,36,12.714463314463314,67,92
"['010', '001110', '10', '0111']",1,4,7,8,0,15,3.6714285714285713,15,18
"['1011001', '1', '00110', '1010', '000']",1,5,11,9,0,20,4.7653679653679655,32,21
"['0', '0011', '1110000']",1,3,7,5,0,12,1.0136363636363637,14,8
"['0', '1010', '100011']",1,3,6,5,0,11,1.2857142857142856,11,5
"['1011110', '101', '01', '0001']",1,4,7,9,0,16,3.446176046176046,19,17
"['0010001', '01', '0011010']",1,3,10,6,2,16,1.6031746031746033,13,9
"['0001001', '10101', '1110100', '0110110']",1,4,13,13,3,26,3.8571428571428568,20,12
"['1000001', '0001001', '1']",1,3,10,5,2,15,1.0714285714285714,14,10
"['01001', '010', '000', '00011']",1,4,11,5,4,16,3.966666666666667,12,20
"['1011110', '0011', '11']",1,3,4,9,0,13,1.6565656565656566,11,8
"['0001101', '001001', '1', '000']",1,4,11,6,0,17,2.5716117216117214,23,18
"['11001', '010', '1110']",1,3,5,7,0,12,1.7380952380952381,7,6
"['1110010', '010010', '0010000']",1,3,13,7,2,20,2.10989010989011,7,12
"['110110', '1101101', '100001']",1,3,8,11,2,19,2.0384615384615383,8,14
"['101', '010101', '11']",1,3,4,7,0,11,1.9666666666666668,8,10
"['110', '0000011', '10', '00001']",1,4,11,6,0,17,2.791269841269841,23,17
"['1110111', '101', '110', '1110']",1,4,4,13,2,17,4.022510822510823,16,24
"['0010', '10', '111010']",1,3,6,6,0,12,1.7666666666666666,9,10
"['11001', '10001', '11']",1,3,5,7,2,12,1.9428571428571428,7,16
"['110011', '1', '0110']",1,3,4,7,0,11,1.2857142857142856,12,4
"['01', '0010000', '0001', '10000', '1001101', '0001111', '1011100', '1101']",1,8,24,19,6,43,14.975468975468974,99,90
"['101100', '001', '1011001', '00110', '000', '0101']",1,6,16,12,2,28,9.327550227550228,38,47
"['00111', '010011', '0101', '1001101']",1,4,10,12,0,22,4.523776223776224,14,17
"['00100', '1010', '001']",1,3,8,4,0,12,1.9880952380952381,6,9
"['1010', '0111111', '000', '010']",1,4,8,9,2,17,3.0588744588744587,20,17
"['00111', '0011110', '111']",1,3,5,10,0,15,2.1833333333333336,8,12
"['1011', '0110010', '1100', '101011']",1,4,9,12,2,21,3.4342657342657343,19,17
"['110000', '0010', '0100']",1,3,10,4,2,14,1.75,8,11
"['0', '100011', '1001111']",1,3,6,8,0,14,1.304945054945055,13,7
"['100001', '111', '110001', '10000', '0001100', '0101', '011000']",1,7,22,15,3,37,12.763852813852814,64,58
"['001', '0010011', '00', '011001', '0100001']",1,5,16,9,2,25,6.308302808302808,33,33
"['1001', '111', '1001011', '00000']",1,4,10,9,0,19,2.6431457431457432,21,17
"['001', '00011', '00111', '101', '100', '10011']",1,6,12,12,6,24,10.15,31,49
"['101', '101000', '100100', '1100011', '110']",1,5,13,12,4,25,6.306837606837607,31,30
"['0110100', '11000', '100101', '10011', '01011']",1,5,14,14,3,28,6.612354312354313,27,27
"['110000', '1', '1000111', '10010', '0110011']",1,5,13,13,2,26,5.124708624708624,39,27
"['0', '0011', '00010', '01011']",1,4,9,6,2,15,3.2222222222222223,16,17
"['0', '001100', '000101', '1001111']",1,4,11,9,2,20,2.718864468864469,24,12
"['1', '10011', '110100', '00001']",1,4,9,8,2,17,2.4614718614718614,22,16
"['0', '0011', '1110110', '10000']",1,4,9,8,0,17,2.473232323232323,24,14
"['00', '0111010', '010101']",1,3,8,7,0,15,1.7136752136752138,11,9
"['00', '011', '1111']",1,3,3,6,0,9,0.9714285714285714,8,6
"['0', '0010', '110010', '01111', '010101', '0111', '110']",1,7,13,16,4,29,11.364790764790765,60,62
"['0', '101011', '0001111', '10010', '00010', '1100']",1,6,15,13,2,28,7.531906981906982,51,40
"['1000100', '00110', '00']",1,3,10,4,0,14,1.6825396825396823,11,13
"['1110001', '0001', '01010', '11']",1,4,9,9,0,18,3.020923520923521,20,15
"['11110', '00101', '01111', '01010', '110']",1,5,9,14,4,23,5.85,24,30
"['1101', '011', '1111']",1,3,2,9,2,11,1.8928571428571428,5,13
"['01', '100001', '1111', '010011', '101111']",1,5,9,15,3,24,5.266666666666667,33,38
"['10101', '0110', '10100', '01001', '11111', '1101']",1,6,11,17,6,28,9.216666666666667,32,40
"['1111', '1011100', '000', '110', '1001011']",1,5,10,14,4,24,4.3852813852813854,34,26
"['1', '01111', '1101100', '10011', '0100100', '0000']",1,6,15,14,4,29,6.429004329004329,57,36
"['0011', '0010', '010', '0110100']",1,4,11,7,2,18,4.051298701298701,15,25
"['0', '110', '0010101']",1,3,6,5,0,11,1.15,12,6
"['010', '111', '0011000', '1010', '111110']",1,5,10,13,2,23,5.28000888000888,32,26
"['0110', '010110', '111']",1,3,5,8,0,13,1.8158730158730159,7,8
"['11001', '00000', '1000111', '1010', '101111']",1,5,13,14,2,27,5.319735819735819,33,28
"['01', '11010', '001', '0010000']",1,4,11,6,0,17,3.4158730158730157,20,16
"['0011000', '1011110', '100', '10010', '110', '101001']",1,6,16,15,4,31,9.136735486735487,46,42
"['111011', '0', '101101']",1,3,4,9,2,13,1.4047619047619047,12,4
"['100', '111110', '0101011', '110']",1,4,7,12,2,19,3.085470085470085,20,17
"['0001101', '101', '001010']",1,3,9,7,0,16,2.0358974358974358,10,7
"['0010110', '00', '010']",1,3,8,4,0,12,1.8444444444444446,10,15
"['0010001', '10111', '000', '11']",1,4,9,8,0,17,2.365873015873016,23,14
"['101011', '010011', '01100']",1,3,8,9,2,17,2.106060606060606,9,7
"['0001', '000100', '100111', '01110']",1,4,12,9,2,21,3.617171717171717,17,14
"['1000011', '011111', '0101100']",1,3,9,11,2,20,1.3516483516483517,12,6
"['01', '001', '010000', '0001', '1011000', '0011011']",1,6,18,11,2,29,8.65024975024975,50,49
"['0001011', '001', '000001', '1011111']",1,4,12,11,2,23,3.161172161172161,22,19
"['11001', '10', '00000']",1,3,8,4,2,12,1.2571428571428571,10,4
"['0001101', '10', '000', '1001111', '1110', '0100']",1,6,14,13,4,27,7.693650793650793,50,39
"['01111', '110001', '001', '0101011']",1,4,9,12,0,21,2.737995337995338,19,18
"['0100000', '111110', '11']",1,3,7,8,0,15,1.0299145299145298,15,6
"['010', '0011', '1000', '1011100', '101111', '01110', '0100']",1,7,16,17,3,33,12.87024087024087,57,61
"['000011', '0101010', '00', '000010', '0111']",1,5,16,9,2,25,5.261460761460762,32,38
"['11110', '01001', '11111']",1,3,4,11,3,15,1.6,8,12
"['1', '0011', '10100', '010101', '000', '0001011']",1,6,15,11,0,26,7.375363525363525,48,41
"['1100001', '1101', '0100011', '01010']",1,4,12,11,2,23,3.6385281385281383,18,17
"['00100', '110001', '1100100', '01010', '0110110']",1,5,17,13,4,30,6.98981018981019,28,30
"['00', '0001', '0110', '011110']",1,4,9,7,2,16,3.533333333333333,17,24
"['110000', '001', '1', '1111000']",1,4,9,8,0,17,2.6493894993894993,24,17
"['0101111', '1011100', '0100100']",1,3,10,11,3,21,1.8571428571428572,9,10
"['11110', '0010111', '0010000', '100', '0110', '1111']",1,6,14,16,4,30,7.635642135642136,51,49
"['111', '0011', '00', '10', '1001111']",1,5,7,11,2,18,4.687590187590187,30,28
"['0010', '010', '101', '011101', '1110101', '00110', '11111', '111000']",1,8,16,23,6,39,16.857942057942058,82,76
"['000100', '10001', '1001', '01010', '0101', '11100']",1,6,17,12,5,29,9.972222222222221,38,38
"['1101', '0010100', '1111']",1,3,6,9,2,15,1.6590909090909092,10,6
"['0100000', '100', '0100011']",1,3,12,5,2,17,1.9142857142857141,10,11
"['1111100', '0010', '010000', '111011', '0001111', '10100', '1010', '110', '0100']",1,9,23,23,7,46,20.47844932844933,116,115
"['01', '11011', '10']",1,3,3,6,2,9,1.6428571428571428,8,6
"['0', '100111', '010110']",1,3,6,7,2,13,1.2380952380952381,13,4
"['001111', '111010', '100001', '00', '110', '01011']",1,6,13,15,3,28,8.011832611832611,51,38
"['0', '0111000', '011', '101', '0001']",1,5,10,8,2,18,5.004978354978355,32,23
"['0010', '11101', '01010', '001100', '0110110']",1,5,14,13,2,27,6.598523698523699,26,32
"['11', '011011', '10000', '1011111', '10', '01100', '0100']",1,7,14,17,4,31,11.047707847707848,68,55
"['001101', '10', '0', '1010011']",1,4,8,8,0,16,2.762210012210012,24,11
"['110010', '0111001', '0010010', '0111101', '0100']",1,5,16,15,3,31,6.896703296703297,30,33
"['010001', '111100', '111011', '1001001', '1101', '1001111', '1101010']",1,7,17,26,6,43,12.977156177156177,63,81
"['01', '011010', '00']",1,3,6,4,2,10,1.5,9,9
"['001100', '010', '100']",1,3,8,4,2,12,2.0,8,11
"['0001', '0101', '0101001']",1,3,9,6,2,15,1.9545454545454546,7,13
"['11', '001000', '11000', '1001', '000000']",1,5,16,7,2,23,4.927489177489178,31,32
"['0011', '001111', '110101']",1,3,6,10,2,16,1.9,9,12
"['000110', '1110110', '1011010']",1,3,9,11,2,20,1.9450549450549453,8,11
"['110011', '101', '100001']",1,3,7,8,2,15,2.0,8,14
"['01011', '100110', '011']",1,3,6,8,0,14,2.143939393939394,8,9
"['1110111', '110000', '100', '10011', '101111']",1,5,10,17,2,27,5.764607614607614,33,42
"['1011001', '110', '011']",1,3,5,8,2,13,1.8666666666666667,10,7
"['00', '0101', '011']",1,3,5,4,0,9,1.9238095238095236,5,7
"['0011', '100', '100010', '10', '1011', '000100']",1,6,15,10,4,25,9.05952380952381,41,44
"['010100', '0100', '111011']",1,3,8,8,2,16,1.7000000000000002,10,9
"['1011', '111', '0011000']",1,3,6,8,0,14,1.516883116883117,10,6
"['01', '0011', '00', '111001']",1,4,7,7,2,14,3.433333333333333,17,14
"['0010', '01101', '0110100', '011', '0000111', '1100']",1,6,16,14,4,30,9.361255411255412,47,50
"['1011110', '1110011', '0110', '001110', '0001010', '1101']",1,6,15,20,5,35,9.836313686313686,50,39
"['10100', '10', '10000']",1,3,8,4,2,12,1.7428571428571429,7,10
"['1110010', '101', '100', '1000', '1110']",1,5,10,11,4,21,6.3926406926406925,24,29
"['0110010', '11010', '10110', '1000101']",1,4,12,12,4,24,3.980952380952381,16,15
"['0001', '110', '10', '0000000']",1,4,12,4,0,16,2.386724386724387,23,17
"['01', '111100', '10000', '1111', '0000', '01001', '001001', '1010011']",1,8,21,18,6,39,14.208929958929959,89,84
"['0011', '11010', '110']",1,3,5,7,0,12,1.7658730158730158,8,11
"['00100', '1011011', '1010010']",1,3,10,9,2,19,1.880952380952381,9,6
"['01', '1000', '001011']",1,3,7,5,0,12,1.2333333333333334,11,7
"['011111', '11000', '110', '1100101']",1,4,8,13,0,21,3.452952602952603,20,22
"['11001', '11010', '0100111', '110100', '1010111', '11101', '01001', '1010010', '110']",1,9,21,29,7,50,24.05995670995671,95,127
"['0101', '0100', '11']",1,3,5,5,2,10,1.75,6,6
"['0100010', '1010', '010', '11001']",1,4,11,8,0,19,3.8359307359307357,17,18
"['01', '1101', '1110']",1,3,3,7,2,10,1.75,7,8
"['10110', '010010', '1111', '00110', '10', '0101']",1,6,12,14,4,26,8.819624819624819,39,39
"['1011111', '010', '01000', '11']",1,4,7,10,0,17,2.6134920634920635,23,12
"['0101', '0111', '11']",1,3,3,7,2,10,2.083333333333333,5,9
"['00111', '00', '11011', '01100']",1,4,8,9,3,17,3.2285714285714286,19,17
"['11010', '0101', '0100']",1,3,7,6,2,13,2.083333333333333,5,8
"['00111', '000110', '01', '0']",1,4,8,6,0,14,3.0844155844155843,19,15
"['01101', '1100101', '1001']",1,3,7,9,0,16,1.8383838383838382,8,12
"['0100111', '101011', '1110011', '0110', '000']",1,5,12,15,2,27,5.75952935952936,34,24
"['01', '001111', '00011', '011011', '11', '1100111']",1,6,10,18,4,28,8.689088689088688,48,55
"['110000', '101', '11100']",1,3,7,7,0,14,1.6717171717171717,9,8
"['110010', '001', '010', '011', '00100', '1000110', '10000', '0001111']",1,8,23,16,7,39,16.61968586968587,87,80
"['001', '101', '0110', '0001111', '1011']",1,5,9,12,4,21,6.079004329004329,28,23
"['00', '10', '01010', '1000011', '0100']",1,5,13,7,2,20,5.799422799422799,30,26
"['11', '001', '10010', '0000']",1,4,9,5,0,14,2.9595238095238097,15,12
"['0', '00100', '100100']",1,3,9,3,0,12,1.528138528138528,10,13
"['110011', '01000', '11']",1,3,6,7,0,13,1.331168831168831,11,8
"['001', '0010101', '0010011', '000', '01010', '01110']",1,6,18,12,6,30,9.64047619047619,42,52
"['0', '00001', '011111', '1101', '110']",1,5,8,11,0,19,4.278715728715729,33,23
"['01', '110', '01011', '11']",1,4,4,8,2,12,3.342857142857143,13,18
"['0', '1011001', '0101100', '111100']",1,4,10,11,2,21,3.1813186813186816,23,13
"['1010111', '01011', '00', '10000']",1,4,10,9,2,19,3.3206349206349204,21,14
"['0001010', '00', '11011']",1,3,8,6,0,14,1.2301587301587302,13,6
"['111101', '1110011', '010000', '110100']",1,4,11,14,3,25,3.5128205128205128,17,17
"['0', '11010', '111010', '11', '101110']",1,5,7,13,2,20,4.597402597402597,32,29
"['11110', '1', '111001', '0001111']",1,4,6,13,0,19,2.8783716283716285,26,21
"['01001', '000011', '11']",1,3,7,6,0,13,1.7987012987012987,9,8
"['110110', '01101', '001', '0001', '00']",1,5,11,9,0,20,5.911399711399711,26,29
"['01', '100111', '1111111']",1,3,3,12,0,15,1.1837606837606838,13,12
"['1010', '110', '0110']",1,3,5,6,2,11,1.9285714285714284,4,10
"['11001', '101000', '0110100', '110101']",1,4,12,12,2,24,4.508158508158508,14,14
"['01', '001', '1001111', '11']",1,4,5,9,2,14,3.188888888888889,18,17
"['01', '001', '100', '1111000', '1101', '011010']",1,6,12,13,2,25,8.47036297036297,45,36
"['00', '1010101', '00101']",1,3,8,6,0,14,1.6825396825396823,10,9
"['10101', '00', '10011', '11']",1,4,6,8,4,14,3.0857142857142854,16,15
"['011', '11100', '10', '000000']",1,4,10,6,0,16,2.307287157287157,22,15
"['001101', '1010101', '10100', '1000', '010110', '0100001', '1101']",1,7,21,18,6,39,13.425008325008324,56,60
"['0110101', '101', '010']",1,3,6,7,2,13,1.8666666666666667,10,7
"['11001', '00010', '011']",1,3,7,6,2,13,1.6,9,5
"['00111', '100', '0110', '011101', '1000', '1100', '0100101']",1,7,17,16,3,33,13.348884448884448,58,58
"['010', '111010', '11', '00', '1101']",1,5,7,10,2,17,5.238095238095238,25,23
"['0', '1101', '100000']",1,3,7,4,0,11,1.0857142857142859,12,4
"['11100', '110111', '1']",1,3,3,9,0,12,1.1645021645021645,12,11
"['0101101', '000111', '10', '101111']",1,4,8,13,2,21,3.3995726495726495,20,15
"['00111', '0', '1111011']",1,3,4,9,0,13,1.0833333333333333,14,7
"['0', '11011', '110001', '0100']",1,4,8,8,0,16,2.790764790764791,20,11
"['01', '001000', '001010', '10', '100111']",1,5,13,9,5,22,5.5,34,24
"['001', '10', '000', '11']",1,4,6,4,4,10,2.3666666666666667,11,12
"['01', '111', '00111', '0100010', '000101', '100010', '101110']",1,7,18,17,3,35,12.429120879120878,66,55
"['0', '11110', '011010', '111111']",1,4,5,13,2,18,2.3917748917748916,22,17
"['0001100', '1001', '1']",1,3,7,5,0,12,1.1954545454545453,13,4
"['11000', '10', '000']",1,3,7,3,0,10,1.7214285714285715,7,10
"['110010', '01', '111', '101101', '1101100', '011101', '110011', '0000010', '0000011', '0101100']",1,10,28,29,8,57,25.116605616605618,157,137
"['000001', '0000111', '1101', '0101', '01110']",1,5,14,12,2,26,5.591958041958042,32,27
"['1100111', '0100111', '1100']",1,3,7,11,2,18,2.1298701298701297,8,17
"['00111', '01001', '0010101']",1,3,9,8,2,17,2.2666666666666666,7,9
"['010', '1', '000011', '1010100', '1001100', '1001011']",1,6,17,14,3,31,7.175763125763126,59,39
"['010100', '111010', '101', '000', '110', '1111111']",1,6,11,17,5,28,7.056410256410256,53,36
"['10001', '0111010', '00']",1,3,8,6,0,14,1.5158730158730158,12,4
"['011', '0100010', '00100', '1101101', '1000', '0110001', '0110011']",1,7,22,18,4,40,12.993073593073593,66,58
"['010000', '1001010', '101000', '1101', '011101', '00', '100000', '0001010', '01001', '01100']",1,10,34,20,8,54,27.346930846930846,133,144
"['0', '010', '011100', '1011110', '10100', '0001011']",1,6,15,14,2,29,7.931851481851481,55,44
"['0010000', '001', '10', '0111']",1,4,10,6,0,16,2.7128427128427126,21,15
"['01', '11010', '1001', '011110', '010011']",1,5,10,13,2,23,5.695670995670995,29,24
"['0010', '100', '1101111']",1,3,6,8,0,14,1.335064935064935,12,5
"['0', '0110111', '100001']",1,3,7,7,0,14,0.8434065934065934,15,4
"['00011', '001101', '0001111']",1,3,9,9,0,18,2.3298368298368297,6,13
"['10001', '110', '1101000', '1101']",1,4,9,10,0,19,4.017748917748918,16,22
"['101011', '110001', '1']",1,3,5,8,2,13,1.2380952380952381,13,13
"['0000100', '101010', '100100', '00', '100111', '1100', '0110011']",1,7,22,16,5,38,12.712531912531912,70,66
"['11', '10010', '010110', '1101', '11100']",1,5,9,13,2,22,6.115584415584415,27,24
"['010000', '00011', '0011', '10110', '10', '011110', '01011']",1,7,17,16,5,33,12.36089466089466,57,64
"['10111', '00010', '111']",1,3,5,8,2,13,1.4,9,8
"['010', '100', '111010']",1,3,6,6,2,12,2.0,8,8
"['010', '011010', '0001110', '000']",1,4,12,7,2,19,3.9692307692307693,18,33
"['010', '101', '00', '001001', '01100', '110101']",1,6,14,11,4,25,9.475974025974025,41,36
"['111', '10001', '00', '100011', '0110010']",1,5,12,11,0,23,5.251459651459651,32,22
"['0', '0000110', '001110']",1,3,9,5,0,14,1.304945054945055,13,15
"['010', '00001', '10001', '01111', '10110', '01000', '1010', '110111', '110', '101111']",1,10,21,26,9,47,25.976046176046175,122,128
"['01', '1100000', '001010', '0111110']",1,4,12,10,2,22,2.672161172161172,27,17
"['1111100', '110', '1', '000101']",1,4,7,10,0,17,2.387851037851038,26,14
"['010', '11011', '111', '0011', '011010']",1,5,8,13,2,21,6.053463203463203,24,28
"['001', '111', '110011', '0101010', '000111']",1,5,11,14,4,25,5.897435897435897,31,29
"['101000', '0001', '0101', '101110', '1110']",1,5,12,12,5,24,5.316666666666666,28,28
"['0000', '1010100', '000101', '1111']",1,4,12,9,2,21,2.7244755244755243,20,17
"['01', '11011', '0110', '1101', '101001']",1,5,8,13,2,21,6.637590187590187,24,28
"['000110', '0001110', '011', '00000', '0111', '01110']",1,6,17,13,2,30,9.839815739815739,38,70
"['00111', '1010101', '101010', '0111']",1,4,9,13,0,22,4.351359751359752,14,20
"['11011', '110001', '1111110', '110', '01100']",1,5,9,17,2,26,6.282750582750583,30,32
"['01', '1000000', '11000']",1,3,10,4,0,14,1.1746031746031744,13,8
"['010', '11', '100', '0001011', '0111110', '01110', '0110011']",1,7,15,19,5,34,11.678571428571429,74,64
"['1011', '0010', '010000', '10']",1,4,10,6,2,16,3.333333333333333,17,13
"['0101', '100', '01011', '111']",1,4,6,9,2,15,3.365079365079365,12,17
"['010', '00101', '11', '00001', '10101', '01001']",1,6,14,11,4,25,9.15,33,40
"['110', '1', '0100']",1,3,4,4,0,8,1.4714285714285715,7,4
"['01', '11', '10100', '1011000', '01000']",1,5,12,9,4,21,5.855555555555555,30,26
"['10001', '110010', '010101', '011110']",1,4,11,12,3,23,3.484848484848485,18,13
"['110000', '00', '110', '100011']",1,4,10,7,2,17,3.1777777777777776,20,16
"['1101001', '010001', '11', '0001', '1001', '0100011', '0101']",1,7,18,16,5,34,14.043967143967144,55,80
"['100001', '1000', '110111', '0101', '1110']",1,5,11,13,5,24,5.4,30,29
"['1011001', '011', '01100', '11']",1,4,7,10,0,17,3.999206349206349,17,14
"['11001', '1000000', '10100']",1,3,11,6,2,17,1.8,9,8
"['011110', '1011', '01010', '000']",1,4,9,9,0,18,3.474098124098124,16,14
"['101', '1101', '01101']",1,3,4,8,0,12,2.496031746031746,4,15
"['1', '0001', '0110', '011001', '01001', '0100101']",1,6,15,12,2,27,9.290803640803642,42,49
"['000110', '0110100', '1000', '110', '0111110']",1,5,14,13,2,27,5.892241092241092,32,38
"['0010', '11', '111011', '1010011', '00010', '0110001', '110101']",1,7,17,20,4,37,11.88034188034188,70,59
"['0111000', '0', '01', '0011', '111110']",1,5,9,11,0,20,4.524331224331224,38,25
"['101100', '011011', '11000', '00', '0111']",1,5,11,12,2,23,5.688600288600289,31,30
"['1101', '01111', '001111', '0010011']",1,4,8,14,0,22,3.654778554778555,15,23
"['11001', '01', '10011']",1,3,5,7,2,12,1.9428571428571428,8,10
"['1111100', '00100', '000', '011010', '1110']",1,5,13,12,0,25,5.716755466755467,30,38
"['11110', '0001', '100', '1000', '10', '0000', '01011']",1,7,16,11,5,27,11.148412698412699,52,62
"['11110', '001111', '1101']",1,3,4,11,0,15,1.793939393939394,8,11
"['1101', '001', '1111111', '110101']",1,4,5,15,0,20,3.1767121767121766,20,29
"['111010', '0011', '10001', '100', '0000', '11111']",1,6,13,14,4,27,7.56002886002886,44,42
"['1001110', '0101', '011']",1,3,6,8,0,14,2.0025974025974023,9,7
"['0010001', '01', '1001', '110111', '1001100', '1011']",1,6,14,16,4,30,9.055039405039405,47,48
"['0', '1011', '0110']",1,3,4,5,2,9,1.55,8,4
"['1011010', '00', '01101', '10']",1,4,8,8,2,16,3.365079365079365,19,14
"['0', '1111100', '10100', '10010', '000010', '110']",1,6,15,12,2,27,7.293911643911644,52,43
"['0', '101011', '001', '111100']",1,4,7,9,2,16,2.4603174603174605,24,12
"['0', '01', '001011']",1,3,5,4,0,9,1.4523809523809523,10,6
"['1000011', '1001', '111']",1,3,6,8,0,14,1.6987012987012986,9,16
"['101', '001010', '0100']",1,3,8,5,0,13,2.038095238095238,7,5
"['0010001', '110110', '010010', '010101', '0110001', '111001']",1,6,20,18,6,38,9.767399267399268,41,45
"['110', '10010', '10']",1,3,5,5,0,10,1.8714285714285714,6,10
"['0110000', '01', '011001', '1010']",1,4,11,8,0,19,3.525796425796426,21,19
"['101', '1100110', '0101001']",1,3,8,9,2,17,1.9142857142857141,12,7
"['0101', '0100111', '110', '11']",1,4,6,10,0,16,3.6098124098124096,18,19
"['001', '111', '1000', '00', '1011100']",1,5,10,9,2,19,4.647041847041847,30,28
"['01', '0100111', '1', '000111', '111001']",1,5,9,13,2,22,4.971001221001221,40,32
"['0011011', '0111001', '01111', '11']",1,4,7,14,2,21,3.5555555555555554,19,20
"['0', '11100', '1110111', '100101']",1,4,7,12,0,19,2.6965534465534464,24,15
"['0100001', '0100111', '110', '0']",1,4,10,8,2,18,2.5142857142857142,26,16
"['10111', '01', '01100']",1,3,5,7,2,12,1.7428571428571429,9,5
"['1110001', '1', '0010']",1,3,6,6,0,12,1.1954545454545453,14,4
"['1011010', '10100', '1']",1,3,6,7,0,13,1.25,12,8
"['0010', '111100', '111', '011', '101011', '1101']",1,6,9,17,6,26,8.207936507936507,41,48
"['0000100', '10101', '0000101', '10', '0111', '1100', '01011']",1,7,19,15,6,34,11.784848484848485,67,58
"['00100', '00', '111011']",1,3,7,6,0,13,1.185064935064935,12,8
"['010', '111', '100011', '110', '01100']",1,5,9,11,3,20,5.545454545454545,26,23
"['1101001', '111100', '001101', '1111', '1110001']",1,5,11,19,4,30,6.673226773226773,27,47
"['11100', '00110', '10100', '0001100', '110']",1,5,14,11,3,25,6.566666666666666,24,38
"['001', '1000101', '1001010', '101', '1111', '100010', '00']",1,7,17,15,4,32,11.886391386391386,65,62
"['01', '00100', '0001', '0000000', '01011', '110101']",1,6,19,10,2,29,7.768731268731268,50,43
"['1010111', '1', '01010']",1,3,5,8,0,13,1.25,13,4
"['010100', '00', '100', '111']",1,4,8,6,2,14,2.7444444444444445,17,16
"['01101', '1', '0000']",1,3,6,4,0,10,0.7777777777777777,11,4
"['1', '1100100', '1010', '0110010', '1100', '01110']",1,6,14,14,4,28,8.594011544011543,48,39
"['0001110', '10100', '100101', '10', '0001010']",1,5,16,11,2,27,5.747530247530247,32,29
"['0', '0100010', '001001', '111']",1,4,10,7,0,17,2.1493894993894993,26,10
"['0110101', '011', '1011110', '101011', '11101', '10010', '110']",1,7,13,23,6,36,13.066072816072817,60,63
"['001000', '0011', '100010', '000000', '11111']",1,5,17,10,3,27,4.423232323232323,34,31
"['00101', '0001', '0110', '111111', '000000', '01001', '0100011']",1,7,21,16,6,37,10.767210567210567,66,58
"['0101', '1001', '001101', '1100110']",1,4,10,11,2,21,3.941958041958042,17,16
"['0101', '1', '000001']",1,3,7,4,0,11,1.0857142857142859,11,7
"['0', '1111010', '00001']",1,3,7,6,0,13,0.9166666666666666,15,6
"['00010', '0100111', '100', '11']",1,4,9,8,0,17,2.8968253968253967,21,13
"['0011', '100010', '01111', '00001']",1,4,11,9,2,20,3.4242424242424243,16,14
"['0111001', '101', '100100', '1000', '001010', '000']",1,6,18,11,4,29,9.084282384282384,44,44
"['001', '00111', '1000110', '100', '0101011', '0011010']",1,6,17,15,5,32,9.626190476190477,48,44
"['00101', '0001', '010010', '1000', '0000011', '0100']",1,6,21,9,3,30,10.045687645687646,38,49
"['0101111', '1', '000101', '110100', '0011011']",1,5,12,15,4,27,4.747252747252747,40,26
"['01', '10', '1001111', '1111']",1,4,4,11,2,15,2.782828282828283,21,21
"['0110010', '1111001', '0000']",1,3,10,8,2,18,1.6233766233766234,11,4
"['001', '1', '011', '00011', '101011']",1,5,8,10,2,18,5.624098124098124,26,29
"['010100', '1010', '010000', '1110010']",1,4,14,9,2,23,3.7170163170163173,16,19
"['1', '1101110', '001110', '1001100', '011000']",1,5,13,14,4,27,5.232600732600733,38,25
"['11', '00100', '100101', '100111', '0100011', '1001011']",1,6,16,17,4,33,9.712898212898214,44,55
"['0010', '010010', '0011000']",1,3,12,5,0,17,2.2965034965034965,8,18
"['1000', '110', '000010', '01100']",1,4,12,6,0,18,3.396176046176046,16,19
"['11101', '10010', '1']",1,3,4,7,2,11,1.2666666666666666,11,8
"['0110100', '1000111', '10011', '000', '1001100', '001100', '1101']",1,7,21,18,3,39,13.338861138861139,66,66
"['0010001', '11', '0011', '110001', '11100']",1,5,12,12,0,24,5.95076035076035,32,39
"['01', '0010', '1111101', '0110100', '1001000', '100110', '1101']",1,7,18,19,5,37,12.599134199134198,70,52
"['10011', '10', '1001010']",1,3,7,7,0,14,1.8492063492063493,10,12
"['00110', '00011', '1100', '0111100']",1,4,11,10,2,21,3.805050505050505,19,23
"['1001110', '0000', '0110001', '11']",1,4,11,9,2,20,2.5512265512265513,26,10
"['01001', '1', '1101000', '011000']",1,4,11,8,0,19,3.0322177822177823,22,14
"['010', '0011', '1010101', '1001', '000001']",1,5,14,10,2,24,5.717721167721168,30,24
"['1001110', '00', '001']",1,3,7,5,0,12,1.8444444444444446,10,8
"['101', '1100', '010111', '001000']",1,4,10,9,2,19,3.1825396825396823,20,13
"['010', '110001', '001000']",1,3,10,5,2,15,1.7777777777777777,10,4
"['01', '10', '010010']",1,3,6,4,2,10,1.5,10,8
"['0', '010001', '001110', '11']",1,4,8,7,2,15,2.071428571428571,24,10
"['01', '1011010', '0001', '11100']",1,4,9,9,0,18,3.038239538239538,21,14
"['00111', '1', '011']",1,3,3,6,0,9,1.5833333333333333,8,7
"['010', '111', '01000', '0000']",1,4,10,5,2,15,2.571428571428571,15,18
"['110011', '10100', '1000', '11']",1,4,8,9,0,17,3.398701298701299,17,20
"['0000', '0100110', '10', '110101']",1,4,11,8,0,19,2.8386169386169384,23,11
"['0110100', '00111', '101', '10', '1011', '11100']",1,6,11,15,2,26,8.815295815295816,45,40
"['100', '0000110', '000']",1,3,10,3,2,13,1.6666666666666665,10,15
"['11011', '010', '001', '00111', '1010001', '0001011', '1011']",1,7,16,18,6,34,13.307720057720058,61,65
"['0101', '01111', '10', '1110']",1,4,5,10,2,15,3.452380952380952,15,16
"['101100', '0011', '11101', '100101', '101110', '0100']",1,6,14,17,5,31,9.222222222222221,38,40
"['1', '0000100', '110001', '0110', '110011', '0100']",1,6,16,12,4,28,7.954412254412254,53,33
"['10101', '0101', '00011']",1,3,7,7,2,14,2.1555555555555554,6,9
"['001111', '101', '1000010', '1101', '011010']",1,5,12,14,2,26,6.057298257298257,31,24
"['101', '1100', '010010', '1111', '0000101', '110']",1,6,13,14,4,27,8.345709845709845,45,38
"['001111', '1111', '10', '0100001', '0101']",1,5,10,13,2,23,5.146891996891997,34,29
"['1010110', '1111101', '011', '111', '00000', '0001100']",1,6,15,17,5,32,6.988095238095238,58,39
"['1100001', '011', '01110', '0100']",1,4,10,9,0,19,3.4335497835497835,20,15
"['10111', '10010', '111']",1,3,4,9,2,13,1.85,7,13
"['0010', '01', '010000', '1111', '101110']",1,5,11,11,4,22,4.75,33,21
"['00011', '10111', '0011', '00', '000100']",1,5,13,9,2,22,5.87027417027417,27,38
"['10100', '011', '011000']",1,3,8,6,0,14,1.893939393939394,9,9
"['1100111', '11100', '0000']",1,3,8,8,0,16,1.4747474747474747,12,9
"['01', '1111101', '00', '1011', '1101']",1,5,6,13,4,19,5.1893939393939394,31,28
"['100010', '10010', '00001']",1,3,11,5,2,16,2.2363636363636363,6,11
"['0', '01011', '01010']",1,3,6,5,2,11,1.4666666666666668,9,11
"['100', '100110', '00', '10011', '0111']",1,5,10,10,0,20,6.082900432900432,25,29
"['0', '11110', '0001']",1,3,5,5,0,10,0.9555555555555555,11,6
"['0101101', '00', '000001']",1,3,10,5,0,15,1.2521367521367521,12,9
"['11001', '10', '000']",1,3,6,4,0,10,1.4714285714285715,8,4
"['0110000', '1101110', '0100']",1,3,10,8,2,18,1.844155844155844,11,10
"['01', '00', '10011', '000010', '1000011']",1,5,14,8,2,22,5.67976467976468,32,23
"['0011011', '1', '101011']",1,3,5,9,0,14,1.304945054945055,13,11
"['11001', '001', '010', '10110', '00']",1,5,10,8,4,18,6.5095238095238095,23,23
"['101', '100100', '1101100', '10', '111000', '01011', '101001']",1,7,17,18,3,35,12.746681096681096,64,59
"['1000001', '1010', '00', '1']",1,4,9,5,0,14,2.3065656565656565,22,11
"['11001', '1000100', '0100010', '1010011', '010011', '000100', '1110']",1,7,24,18,5,42,13.564735264735265,62,59
"['1111011', '100000', '001000']",1,3,11,8,2,19,1.282051282051282,12,7
"['1101000', '110011', '10', '1011', '11100']",1,5,10,14,0,24,5.981762681762682,31,35
"['11010', '0111010', '101010', '0101011', '10110', '10011', '000111', '1110']",1,8,19,26,7,45,18.222910422910424,70,89
"['101', '0011', '000101', '111011', '00', '0011111']",1,6,12,16,2,28,8.577761127761129,49,48
"['10100', '110111', '011100']",1,3,7,10,2,17,1.9393939393939394,9,6
"['1110011', '111100', '0110']",1,3,6,11,0,17,1.9146853146853147,10,7
"['0', '11110', '11011', '101101', '111101', '011000']",1,6,10,19,5,29,8.305627705627705,46,37
"['0101', '1110', '11']",1,3,3,7,2,10,1.8333333333333333,7,8
"['1', '011100', '1101011', '111110', '010101']",1,5,9,17,3,26,4.466117216117216,38,21
"['0010', '0100000', '10101', '111']",1,4,11,8,0,19,2.9478354978354977,21,9
"['101000', '100', '0011000', '0101']",1,4,13,7,0,20,3.7527805527805524,18,20
"['01', '1111', '00', '100111', '10']",1,5,6,10,3,16,4.266666666666667,28,23
"['101110', '0011011', '01011', '000']",1,4,10,11,0,21,3.7204351204351207,19,17
"['00100', '1101', '1011', '0010010', '000111', '110', '01000']",1,7,19,15,4,34,12.264663114663115,62,59
"['110000', '101101', '11', '0001', '010111', '0001011', '01110']",1,7,17,19,3,36,11.587590187590187,71,58
"['0', '101100', '00111', '10101', '110001', '00010', '111101']",1,7,16,18,6,34,10.58138528138528,67,51
"['00000', '0011110', '10100', '000111', '1010000', '0101']",1,6,21,13,4,34,8.103785103785103,48,57
"['110', '011', '0100']",1,3,5,5,2,10,1.8095238095238093,6,8
"['00000', '101011', '1101100', '1000', '110']",1,5,14,11,0,25,5.144194694194694,32,30
"['00', '1101101', '0111']",1,3,5,8,0,13,1.505050505050505,11,5
"['1101101', '110001', '00110', '00', '1111011']",1,5,11,16,2,27,5.549117549117549,36,25
"['11110', '1000110', '110', '1110']",1,4,7,12,0,19,4.48997113997114,14,29
"['01101', '1', '01011', '0111']",1,4,5,10,2,15,3.2222222222222223,15,17
"['10111', '0101', '1111101', '1110']",1,4,5,15,2,20,3.606060606060606,17,22
"['110110', '011', '00101', '11000', '10', '01010', '01000']",1,7,17,14,4,31,13.097835497835497,56,60
"['11001', '0010111', '11', '1011', '1101']",1,5,7,15,2,22,6.205266955266955,28,48
"['11100', '01000', '011000']",1,3,10,6,2,16,2.2363636363636363,5,14
"['011011', '11000', '11']",1,3,5,8,0,13,1.6168831168831168,10,11
"['1000', '1001', '1']",1,3,5,4,2,9,1.55,7,10
"['011010', '1', '000001']",1,3,8,5,2,13,0.9047619047619047,14,4
"['0', '1011010', '0100']",1,3,7,5,0,12,1.1954545454545453,12,8
"['010000', '001', '011110']",1,3,9,6,2,15,1.3888888888888888,11,10
"['1100111', '010', '110', '111']",1,4,5,11,3,16,3.2666666666666666,17,22
"['100', '10000', '110111', '011010', '01100']",1,5,13,12,4,25,6.2414141414141415,29,27
"['001001', '11100', '0111', '1001']",1,4,9,10,2,19,3.778787878787879,17,18
"['1110111', '1011010', '10', '111']",1,4,5,14,2,19,3.2031746031746033,23,24
"['1000001', '11110', '0110111', '0011110', '010010', '100010', '1110']",1,7,20,22,5,42,11.816261516261516,70,69
"['1', '1010100', '1001000', '10', '001001', '0000110']",1,6,19,11,3,30,7.403846153846153,60,39
"['011101', '0110', '00011']",1,3,7,8,0,15,2.012121212121212,8,8
"['0010001', '0010', '111', '1010', '1001100', '011010']",1,6,17,14,4,31,9.49998334998335,44,41
"['111', '10001', '00', '100000', '0011011']",1,5,13,10,0,23,4.373060273060273,38,28
"['1011010', '01', '01100', '00110', '1000', '0000111', '0100101']",1,7,21,16,5,37,12.657142857142857,70,57
"['0111001', '00100', '1100001', '101', '1111000', '1111', '1011100', '11100', '001011']",1,9,23,28,6,51,21.538073038073037,113,120
"['010', '000111', '111']",1,3,5,7,2,12,1.4444444444444444,9,8
"['1010100', '10011', '101001']",1,3,9,9,0,18,1.9965034965034967,7,13
"['01', '111111', '0111', '1110']",1,4,3,13,2,16,3.1999999999999997,18,23
"['011101', '0010', '010', '110111']",1,4,8,11,2,19,3.634920634920635,18,13
"['1', '0100110', '100010', '0000', '110101']",1,5,14,10,2,24,4.310472860472861,38,17
"['11110', '100', '0010100', '1111', '01100']",1,5,11,13,2,24,5.599350649350649,29,32
"['000100', '111100', '00011', '1100001', '000111', '0111110']",1,6,19,18,5,37,8.954212454212454,50,52
"['1001001', '11011', '010101', '10']",1,4,9,11,0,20,3.679043179043179,20,16
"['01', '000010', '000', '110', '0101001']",1,5,14,7,2,21,4.758119658119658,33,29
"['1000000', '00100', '11']",1,3,10,4,0,14,1.007936507936508,13,6
"['101', '11000', '100', '0011110', '000', '0000111']",1,6,16,12,5,28,8.18095238095238,51,49
"['11011', '1010', '100']",1,3,5,7,0,12,2.0238095238095237,6,7
"['11', '1010', '00', '0101', '0101001']",1,5,10,9,4,19,5.76010101010101,28,22
"['1101001', '1001', '100111']",1,3,7,10,0,17,2.1426573426573428,8,19
"['010100', '0', '1101111', '00111', '1000110', '10010', '10011', '01011']",1,8,19,22,6,41,15.734332334332334,91,75
"['1011', '001', '0000100']",1,3,9,5,0,14,1.535064935064935,11,6
"['0011101', '1000101', '00011', '0101101', '100', '0000', '001100', '1101', '1001011']",1,9,27,23,6,50,23.1479242979243,107,117
"['0011101', '10000', '10010', '010110', '1011000', '0101', '1110']",1,7,20,18,6,38,13.328071928071928,60,59
"['0011', '01', '00', '0000011']",1,4,10,5,2,15,3.4494949494949494,18,20
"['1111100', '0101110', '100', '110', '110101']",1,5,10,16,4,26,6.345054945054945,32,26
"['010', '0011', '100100', '111011', '00', '01011']",1,6,13,13,2,26,9.082251082251082,43,44
"['000', '1110', '00011']",1,3,7,5,0,12,1.4801587301587302,9,11
"['00101', '00100', '10001', '1001100', '01110']",1,5,16,11,4,27,6.433333333333334,26,29
"['01', '101101', '0110', '1111', '0111', '1100', '1110']",1,7,9,19,5,28,13.183333333333334,44,61
"['01', '11000', '00', '10010', '10011', '11100']",1,6,13,11,6,24,8.7,41,39
"['1000010', '10001', '1', '001011']",1,4,11,8,0,19,2.8632201132201134,23,17
"['0011', '00110', '1', '00101']",1,4,8,7,2,15,3.6444444444444444,15,17
"['1', '0100010', '1010', '1000', '110', '0100']",1,6,14,9,3,23,8.314285714285715,40,37
"['0001010', '01111', '101000']",1,3,10,8,0,18,1.4790209790209792,11,8
"['0', '1101111', '1001', '011000', '01110', '111001']",1,6,12,17,2,29,7.809462759462759,54,32
"['11011', '000011', '100', '1101011', '0101011', '11101']",1,6,13,20,4,33,9.42862692862693,42,69
"['100011', '0101011', '01011']",1,3,8,10,0,18,2.3298368298368297,6,17
"['001', '10', '011010']",1,3,6,5,0,11,1.3444444444444446,9,7
"['11011', '0001', '1101110', '1010000', '010011']",1,5,14,15,2,29,6.016339216339216,32,31
"['1', '1000', '00010', '1010010', '0100']",1,5,14,7,2,21,5.754545454545455,30,26
"['101100', '01', '10']",1,3,5,5,2,10,1.5,10,7
"['01', '11010', '001000', '0110000', '00', '1111111', '111001']",1,7,17,18,6,35,10.132922632922632,81,56
"['1100100', '000', '01110', '010011', '01100']",1,5,15,11,2,26,5.899222999222999,29,37
"['0010', '001', '0001110', '011', '00000', '1100100', '0001111', '010111', '1101']",1,9,25,21,7,46,20.77857142857143,115,116
"['1011', '00', '010']",1,3,5,4,0,9,1.7047619047619047,6,4
"['1110011', '00', '000100']",1,3,9,6,0,15,1.4059829059829059,14,8
"['1001', '1100', '00001']",1,3,8,5,2,13,1.8611111111111112,7,9
"['011111', '1', '00101']",1,3,4,8,0,12,1.1645021645021645,12,6
"['00', '1', '0111110']",1,3,4,6,0,10,0.6944444444444444,13,4
"['110010', '001', '11', '101011', '0000001', '010010', '0101001']",1,7,21,16,5,37,12.117704517704517,70,58
"['0', '1100001', '0010010', '010011']",1,4,13,8,2,21,2.741758241758242,26,11
"['0011', '010', '0111']",1,3,5,6,2,11,1.8928571428571428,5,8
"['1011011', '110', '000101']",1,3,7,9,0,16,1.505982905982906,11,7
"['11001', '1110000', '00100', '00', '1101', '110']",1,6,14,12,2,26,8.673232323232323,44,44
"['01', '1001', '100', '0100']",1,4,8,5,2,13,4.197619047619048,10,16
"['11001', '001', '1001000', '0000']",1,4,13,6,0,19,3.577994227994228,17,19
"['1011', '1101101', '001111']",1,3,5,12,0,17,1.9426573426573426,9,11
"['11110', '010000', '1', '111010', '0110110', '0000100', '110001', '01100']",1,8,23,20,7,43,14.872394272394272,94,75
"['101100', '01', '00', '10110']",1,4,8,7,2,15,3.551948051948052,16,18
"['1111010', '010', '000']",1,3,7,6,2,13,1.6666666666666665,10,10
"['1000', '1001111', '000010']",1,3,10,7,0,17,1.606993006993007,11,8
"['010000', '00100', '110001', '1010', '110']",1,5,15,9,2,24,5.9886002886002885,27,23
"['1', '01101', '0000110', '1110']",1,4,8,9,0,17,2.862121212121212,23,12
"['1', '0011111', '001000']",1,3,7,7,0,14,0.9972527472527473,15,7
"['0011', '01001', '00']",1,3,7,4,0,11,1.9047619047619047,7,8
"['0101', '11101', '10010', '011']",1,4,7,10,2,17,3.7904761904761903,15,16
"['010', '1000', '1100101', '101001', '1110']",1,5,12,12,2,24,5.9514818514818515,27,22
"['11000', '101011', '1101101', '1101100', '0101', '0101001', '1110']",1,7,17,23,5,40,13.040881340881342,58,68
"['00111', '00', '110101']",1,3,6,7,0,13,1.6168831168831168,10,7
"['01', '010', '111', '00001']",1,4,7,6,2,13,2.854761904761905,15,12
"['001111', '00101', '0011', '01010', '0010010']",1,5,15,12,2,27,7.437606837606838,22,39
"['0111000', '00101', '10001', '100', '01011']",1,5,14,11,3,25,6.016666666666667,31,25
"['0000111', '10101', '10010']",1,3,9,8,2,17,1.8,10,7
"['00001', '0110000', '11']",1,3,9,5,0,14,1.3968253968253967,12,7
"['00111', '01001', '010', '1001000']",1,4,12,8,2,20,3.6166666666666667,19,15
"['00100', '01', '101110']",1,3,7,6,0,13,1.6168831168831168,10,6
"['01', '011', '11000', '0001', '010010', '011111']",1,6,13,13,2,26,8.614718614718615,45,43
"['00', '1100', '110', '00101']",1,4,8,6,0,14,3.4396825396825395,14,19
"['10001', '0101', '000011']",1,3,9,6,0,15,1.993939393939394,7,7
"['0010111', '11', '101', '0011011', '110']",1,5,8,14,4,22,6.212698412698413,33,33
"['00010', '1111101', '00001']",1,3,9,8,2,17,1.4666666666666668,12,7
"['10001', '10110', '00', '10011', '1101']",1,5,10,11,3,21,6.247619047619048,25,26
"['0011', '0111011', '000', '001000']",1,4,12,8,0,20,3.245088245088245,20,27
"['010', '001', '10111', '1011', '01011', '0110011']",1,6,11,16,4,27,9.5494227994228,36,45
"['11000', '100', '110011', '1010', '001110', '1100']",1,6,14,14,4,28,10.22034632034632,37,48
"['0110101', '01', '1001', '100010', '1000000', '1100111', '0011011', '01110']",1,8,23,22,4,45,15.484648684648684,103,72
"['00111', '1101101', '110', '1111']",1,4,5,14,0,19,3.732034632034632,17,26
"['0101010', '1', '10110', '1010011']",1,4,9,11,2,20,3.0476190476190474,24,13
"['00001', '10101', '1111', '1001101', '100010']",1,5,13,14,2,27,5.458119658119658,26,34
"['110110', '0010', '1', '1010010', '111001']",1,5,11,13,2,24,5.153829503829504,36,24
"['1110110', '10001', '1100', '0111']",1,4,8,12,2,20,3.3838383838383836,19,16
"['00101', '101010', '110100', '00', '1000011', '0001000']",1,6,21,12,4,33,8.77883227883228,51,43
"['0', '001', '0001110']",1,3,7,4,0,11,1.35,12,9
"['00', '0101', '110', '0111']",1,4,6,7,2,13,3.2928571428571427,12,14
"['011100', '11', '00', '1100110', '011010']",1,5,11,12,4,23,4.952991452991453,37,27
"['1001110', '1', '110100']",1,3,6,8,0,14,0.9972527472527473,14,6
"['00010', '0101', '1']",1,3,6,4,0,10,1.4,9,4
"['11', '0001', '10000', '00', '0101']",1,5,11,6,4,17,4.801587301587301,24,25
"['1000100', '110010', '001', '111', '1001']",1,5,12,11,2,23,6.391741591741591,27,29
"['00', '000111', '1001101']",1,3,8,7,0,15,1.7136752136752138,11,6
"['0110101', '01', '010', '1001111']",1,4,8,11,2,19,3.403174603174603,24,14
"['11001', '01', '0010', '00000', '0001', '1101100', '0000101']",1,7,22,12,6,34,11.83975468975469,67,70
"['00101', '1000', '0000', '00010', '01110']",1,5,16,7,5,23,6.527777777777778,22,41
"['0', '00100', '01011']",1,3,7,4,2,11,1.2666666666666666,11,8
"['01101', '001', '1', '000101', '01010', '0001000']",1,6,17,10,2,27,8.15949050949051,47,42
"['0100001', '001001', '1']",1,3,9,5,0,14,1.304945054945055,13,8
"['000001', '11100', '100001', '00000']",1,4,16,6,4,22,3.778787878787879,14,25
"['11100', '110', '0010100', '0100']",1,4,11,8,0,19,3.782034632034632,16,24
"['011101', '0101', '10']",1,3,5,7,0,12,1.9666666666666668,8,9
"['0110101', '101000', '100', '00110', '111110', '110', '101111', '0110011']",1,8,18,25,7,43,16.265107115107114,90,78
"['1001001', '11010', '11101', '100111']",1,4,9,14,2,23,3.8268065268065268,16,26
"['110010', '11011', '0111100', '1011000']",1,4,11,14,2,25,3.992840492840493,20,14
"['100', '1', '01000', '010000']",1,4,11,4,0,15,3.4448051948051948,17,18
"['11110', '0011', '0110', '001010', '0111', '000000', '0111110']",1,7,18,18,5,36,12.196309246309246,61,82
"['010000', '0101110', '011', '101', '1011100']",1,5,13,13,4,26,6.043467643467643,34,25
"['0001000', '10101', '000000']",1,3,14,4,0,18,1.7867132867132867,9,12
"['00101', '00111', '100110', '00', '010111', '0100']",1,6,15,13,4,28,9.678210678210679,39,47
"['0', '1000', '00111']",1,3,6,4,0,10,1.1777777777777778,11,7
"['010', '1100', '110101']",1,3,6,7,0,13,2.038095238095238,7,6
"['100110', '11101', '111110', '110', '101111']",1,5,7,19,3,26,6.709595959595959,25,39
"['0', '0010110', '1100010', '00110', '11111']",1,5,12,13,4,25,3.9714285714285715,41,29
"['00110', '00010', '1001', '1']",1,4,9,6,2,15,3.2,17,10
"['100', '110', '01010']",1,3,6,5,2,11,1.9166666666666665,5,7
"['0010', '00010', '1011001', '11']",1,4,10,8,0,18,3.1645021645021645,21,12
"['0010', '01', '1', '00111', '011000']",1,5,10,8,0,18,5.235930735930736,31,23
"['10', '0111110', '0111100', '00000']",1,4,11,10,2,21,2.698412698412698,24,25
"['0010', '00001', '11', '0000110', '0100']",1,5,15,7,2,22,5.182178932178932,30,30
"['011101', '1', '0110', '101001']",1,4,7,10,2,17,2.8714285714285714,21,13
"['00', '010111', '000010']",1,3,9,5,2,14,1.5,11,10
"['0', '1011011', '1001']",1,3,5,7,0,12,1.3772727272727274,12,5
"['01', '0111001', '110100', '100110', '1011000', '010011']",1,6,17,17,5,34,9.257020757020758,53,37
"['1010110', '011', '1001', '10000', '111111', '00', '1100111']",1,7,14,20,2,34,10.346070596070597,73,58
"['01', '001111', '11000', '100', '0111110', '0001000']",1,6,16,14,2,30,7.458691308691309,58,46
"['110010', '111100', '011', '00100', '000000', '1101', '01100']",1,7,20,15,5,35,11.761832611832611,62,68
"['001', '1001', '1010', '1000', '0101', '101001']",1,6,14,11,4,25,10.488095238095237,28,52
"['101000', '00010', '010']",1,3,10,4,0,14,1.962121212121212,8,12
"['001', '011', '000011', '00011', '10001', '010010']",1,6,17,11,6,28,10.64090909090909,34,43
"['0001001', '1101', '000010', '1101010']",1,4,14,10,2,24,3.293106893106893,21,18
"['1010110', '1001010', '00000', '100', '0100']",1,5,17,9,2,26,6.012409812409812,29,33
"['1000', '10001', '0010000']",1,3,12,4,0,16,2.282828282828283,7,10
"['1001110', '00100', '0101', '100000']",1,4,14,8,0,22,3.272960372960373,18,16
"['0110101', '1001110', '111111', '00110', '10', '000', '01000']",1,7,17,18,4,35,10.985076035076036,75,55
"['1100011', '01', '001', '1110']",1,4,7,9,0,16,3.008946608946609,20,15
"['110110', '0001', '1']",1,3,5,6,0,11,1.0857142857142859,12,6
"['1', '011110', '1001101']",1,3,5,9,0,14,1.151098901098901,15,4
"['010000', '100', '0110', '10011', '01110']",1,5,13,10,2,23,6.3345598845598845,26,29
"['0010111', '111', '10000', '110011', '10']",1,5,10,13,0,23,5.093378843378844,36,34
"['0000111', '010', '1001', '01011']",1,4,10,9,0,19,3.60021645021645,19,13
"['11001', '101', '01001', '100000']",1,4,11,8,2,19,3.8353535353535353,15,20
"['01', '0111001', '11', '10000', '1101100', '0000', '011010']",1,7,18,15,4,33,10.196903096903096,75,56
"['010', '0011', '1110101', '111101', '10', '1011011', '0110110']",1,7,13,23,3,36,12.4013209013209,68,53
"['010100', '01', '01111', '0101010', '111001']",1,5,12,14,2,26,5.852702852702853,33,30
"['001', '101101', '1111111', '1101', '00', '01001', '1110']",1,7,11,20,2,31,10.863847263847264,66,60
"['011011', '01', '1001000']",1,3,8,7,0,15,1.4059829059829059,13,7
"['1010101', '1', '101110']",1,3,5,9,0,14,1.304945054945055,13,10
"['1000001', '101011', '00', '10', '001100', '0111110']",1,6,16,14,6,30,7.384004884004884,61,34
"['1001000', '1010', '11101', '0000', '01100', '0100']",1,6,18,11,5,29,8.683333333333334,38,44
"['0111001', '0111111', '001110']",1,3,7,13,2,20,2.098901098901099,8,9
"['00010', '1110', '1111011']",1,3,6,10,0,16,1.505050505050505,11,8
"['01', '101', '0011', '110100', '1110']",1,5,8,11,2,19,5.609523809523809,26,25
"['0010001', '01', '0100111', '000011', '11', '0010100', '0000010']",1,7,24,14,6,38,11.47069597069597,76,60
"['1001', '001110', '000']",1,3,8,5,0,13,1.838095238095238,9,6
"['1011110', '0001010', '0111111', '11']",1,4,8,15,3,23,3.0476190476190474,25,13
"['0', '001011', '100010']",1,3,8,5,2,13,1.2380952380952381,13,6
"['01111', '10101', '1', '1110000']",1,4,7,11,2,18,2.5166666666666666,26,16
"['001', '011', '100', '11101', '010101']",1,5,9,11,3,20,5.48989898989899,26,27
"['0', '1100', '0000010']",1,3,9,3,0,12,1.0136363636363637,14,9
"['010', '0000', '010111', '1010011', '1101', '0101']",1,6,14,14,3,28,8.79044289044289,39,38
"['1111100', '110010', '001', '01', '111', '1101000', '0100001']",1,7,17,18,5,35,11.192063492063491,77,62
"['001', '1101000', '01111', '10010', '110']",1,5,11,12,4,23,5.15,34,26
"['010', '011', '001101', '00011', '100', '1111', '000100']",1,7,16,14,5,30,11.48073593073593,59,59
"['0010001', '1100001', '010111', '000010']",1,4,16,10,4,26,3.675824175824176,19,15
"['00', '1000', '011']",1,3,6,3,0,9,1.3523809523809525,7,8
"['1000100', '11', '00111', '1000', '0010010']",1,5,15,10,2,25,5.573593073593074,36,30
"['11001', '0011', '0010', '110']",1,4,8,8,2,16,3.9761904761904763,14,17
"['1101001', '1001110', '01', '10110', '1101011', '10100']",1,6,14,19,5,33,9.41904761904762,46,44
"['0100000', '111', '00', '1100', '101001']",1,5,13,9,0,22,5.01004551004551,34,23
"['101010', '1', '011101']",1,3,5,8,2,13,1.0714285714285714,13,6
"['0', '0010', '111110']",1,3,5,6,0,11,1.0857142857142859,12,9
"['01', '110100', '01110', '0100011', '101001']",1,5,13,13,2,26,5.824730824730825,36,23
"['11', '0000000', '0011111', '1001001', '110', '01110']",1,6,16,15,3,31,6.772222222222222,62,35
"['000110', '10', '0001111']",1,3,8,7,0,15,1.4914529914529915,12,11
"['1011', '100', '110']",1,3,4,6,2,10,1.8095238095238093,5,8
"['101', '0010', '111101']",1,3,5,8,0,13,1.638095238095238,9,6
"['110110', '00101', '00011', '100', '10000', '011010']",1,6,17,13,5,30,9.371212121212121,42,41
"['000110', '010', '0011101', '1101100', '010011']",1,5,15,14,4,29,6.553479853479853,33,29
"['11001', '11010', '001', '0011111', '000', '1100']",1,6,13,14,4,27,9.000937950937951,43,50
"['1100000', '0110', '00', '001110', '00010']",1,5,16,8,0,24,6.05013875013875,33,46
"['011011', '101000', '0']",1,3,7,6,2,13,1.0714285714285714,14,6
"['11000', '01', '01100', '00011']",1,4,10,7,3,17,3.4285714285714284,20,18
"['01', '00101', '1011101', '11111', '0000110']",1,5,11,15,4,26,4.884126984126984,37,23
"['10111', '00010', '10', '11']",1,4,6,8,4,14,2.9,17,14
"['01', '0011', '1011101', '0011110', '0101011', '100', '0110', '100111', '00010']",1,9,21,24,5,45,21.74124209124209,112,92
"['10001', '000101', '0011010', '110111', '1010010', '01100']",1,6,19,17,6,36,9.289144189144189,43,33
"['1001010', '00000', '100', '01111', '100011', '111101']",1,6,16,16,4,32,7.7123931623931625,51,41
"['1100011', '0110010', '011111']",1,3,8,12,2,20,1.7912087912087913,10,8
"['0011010', '011', '111', '00000']",1,4,10,8,2,18,2.783333333333333,21,14
"['000110', '01', '0001', '1110']",1,4,9,7,2,16,3.15,18,18
"['0010', '0101111', '1000', '000', '0110010']",1,5,15,10,4,25,6.2564935064935066,32,37
"['0101000', '1', '10011']",1,3,7,6,0,13,1.0833333333333333,14,4
"['0101000', '0111011', '100', '1111', '100110', '000', '1010011']",1,7,18,19,5,37,10.854545454545455,74,56
"['000111', '0110', '000', '011110']",1,4,10,9,2,19,3.749206349206349,17,26
"['1111101', '1', '00011']",1,3,4,9,0,13,0.9166666666666666,15,9
"['0010', '011', '100000', '0111', '1101', '01011']",1,6,13,13,3,26,8.035858585858586,40,40
"['100101', '100', '100111']",1,3,7,8,2,15,2.1666666666666665,7,15
"['11001', '1100001', '0000001', '01000', '0100100', '0011011', '01001', '11100', '01110']",1,9,31,22,9,53,22.37142857142857,107,116
"['101', '0010', '010']",1,3,6,4,2,10,2.095238095238095,5,6
"['0110101', '001111', '0100']",1,3,8,9,0,17,1.7146853146853147,10,8
"['011101', '100', '011']",1,3,5,7,2,12,1.4444444444444444,10,8
"['0', '001001', '1100100', '11']",1,4,9,7,0,16,2.2493894993894994,25,13
"['00001', '1001', '100100', '11111', '0101']",1,5,12,12,4,24,5.259090909090909,28,30
"['00011', '1011101', '1001101', '010101', '000', '0001010', '1111011']",1,7,20,22,4,42,13.174209124209124,66,60
"['0', '000110', '11011', '101', '1001']",1,5,9,10,0,19,5.382756132756133,29,18
"['01001', '10000', '111001']",1,3,9,7,2,16,1.8727272727272726,8,9
"['1011', '0101', '1111011', '11111']",1,4,4,16,2,20,3.744949494949495,16,32
"['1110000', '101', '011110', '11111', '110', '0001000']",1,6,14,17,4,31,7.62006882006882,58,39
"['001000', '10000', '110100', '1111', '010111', '10', '000000', '1101']",1,8,22,17,6,39,13.335064935064935,91,86
"['11110', '01101', '101011', '100', '10', '111001']",1,6,10,17,4,27,8.906493506493506,42,41
"['0000101', '00011', '0110100', '110101']",1,4,14,11,2,25,3.834831834831835,17,18
"['100', '0110', '1100000', '0001100', '0111111', '01000']",1,6,19,14,3,33,7.9919913419913415,57,54
"['0010110', '011', '00011', '101', '10000', '011001']",1,6,16,13,4,29,9.021445221445221,46,38
"['1011', '0001', '00010', '110']",1,4,9,7,2,16,3.1904761904761902,14,15
"['0', '010001', '100001', '0110100', '11101', '1011', '01110']",1,7,17,17,4,34,10.995321345321345,72,47
"['111100', '1000', '00', '11101', '1110']",1,5,9,12,2,21,5.7463203463203465,26,30
"['01101', '111', '00111', '10111', '100010', '00010', '01100']",1,7,16,18,5,34,12.935353535353535,55,60
"['01', '0011000', '10000', '100011', '000', '011111', '1101010']",1,7,20,16,4,36,11.024048174048174,79,60
"['101', '01110', '00000']",1,3,8,5,2,13,1.15,10,4
"['000110', '01', '10', '0000011']",1,4,11,6,2,17,2.935897435897436,24,15
"['0', '0111111', '0111']",1,3,3,9,0,12,1.3772727272727274,12,11
"['011001', '10', '110101']",1,3,6,8,2,14,1.8333333333333335,10,7
"['101010', '11010', '1100', '110']",1,4,8,10,0,18,4.267748917748918,10,23
"['0101111', '1101000', '100100', '0110000', '10100', '00', '1111011']",1,7,21,20,4,41,11.64047064047064,76,66
"['01', '00101', '1000000', '11111', '1011', '110', '0110011']",1,7,15,18,4,33,10.01067821067821,75,58
"['1011', '100', '1', '0000001']",1,4,9,6,0,15,2.485064935064935,23,16
"['1010', '0111', '11']",1,3,3,7,2,10,1.8333333333333333,7,8
"['010000', '101001', '110101']",1,3,10,8,3,18,2.0,8,5
"['11011', '1', '1000011', '11100', '1101010']",1,5,10,15,4,25,5.004761904761905,37,38
"['0', '110000', '011010']",1,3,8,5,2,13,1.2380952380952381,13,8
"['101100', '101', '1111001', '110100', '0100011']",1,5,13,16,4,29,6.553479853479853,32,30
"['1111010', '110', '011']",1,3,4,9,2,13,1.6666666666666665,11,10
"['01', '011', '000']",1,3,5,3,2,8,1.5333333333333334,5,7
"['0101101', '10101', '0110', '00110', '000000', '11111', '0100']",1,7,19,17,5,36,10.886285936285937,61,54
"['11100', '100111', '0011111']",1,3,6,12,0,18,1.8146853146853146,11,13
"['0', '000100', '011001']",1,3,9,4,2,13,1.2380952380952381,13,8
"['1111000', '110100', '111111', '0101', '0100']",1,5,11,16,4,27,5.543706293706294,32,34
"['1010000', '10', '11']",1,3,6,5,2,11,1.3888888888888888,11,7
"['0011', '0001', '01010', '1010011', '110']",1,5,12,11,2,23,5.73946608946609,26,25
"['1011001', '001101', '11', '0001010', '110', '0110001']",1,6,16,16,3,32,9.207692307692307,52,36
"['0000011', '0111', '1010001', '010011', '111000']",1,5,16,14,4,30,6.274425574425575,32,32
"['0110', '110111', '0111', '1000011', '1110110']",1,5,10,18,4,28,6.46968031968032,31,36
"['11110', '01', '00101', '011', '00111', '00']",1,6,10,12,5,22,8.357142857142858,39,42
"['0', '10000', '011', '111011']",1,4,7,8,0,15,2.3993506493506493,22,13
"['00001', '101', '0110', '00', '0101', '101111']",1,6,12,12,2,24,8.352525252525252,41,35
"['100110', '10', '111101']",1,3,5,9,2,14,1.6666666666666665,11,8
"['100110', '1001', '0100101']",1,3,9,8,0,17,2.2965034965034965,8,10
"['11001', '01', '0101001']",1,3,7,7,0,14,1.8492063492063493,10,12
"['100', '1101111', '1', '0100']",1,4,6,9,0,15,2.770779220779221,22,12
"['001', '1110000', '0011110', '0110', '00', '100011']",1,6,16,13,2,29,8.76857586857587,55,43
"['0111001', '1001', '1100', '00000']",1,4,12,8,2,20,3.426767676767677,18,15
"['10010', '0111011', '11']",1,3,5,9,0,14,1.5158730158730158,12,8
"['101', '11101', '10']",1,3,3,7,0,10,2.1214285714285714,6,11
"['111', '1100000', '01111', '01110', '0100']",1,5,11,13,2,24,5.475613275613275,33,31
"['100011', '1110011', '10110', '1']",1,4,7,12,0,19,3.0322177822177823,24,23
"['10101', '100100', '10', '0011111']",1,4,9,11,0,20,2.9824619824619827,24,16
"['0011', '10001', '0111']",1,3,6,7,2,13,1.8611111111111112,6,7
"['0101000', '111', '110100']",1,3,8,8,0,16,1.835897435897436,10,7
"['101', '1000', '0100100', '0111100']",1,4,12,9,2,21,3.4155844155844157,20,16
"['101', '11000', '1000000', '1101', '1010010', '1100', '01110']",1,7,19,16,6,35,12.587373737373737,60,58
"['11011', '1000', '01001', '10101']",1,4,9,10,3,19,3.977777777777778,13,16
"['0011001', '00110', '0010111', '1']",1,4,10,10,2,20,3.0476190476190474,24,18
"['0', '1010100', '1001']",1,3,7,5,0,12,1.1954545454545453,12,5
"['1000000', '010101', '0110111', '11']",1,4,11,11,2,22,2.6831501831501834,27,15
"['101010', '0011011', '111', '0111']",1,4,7,13,0,20,4.066466866466866,17,19
"['1111', '100', '001', '0000']",1,4,8,6,4,14,2.380952380952381,16,15
"['1101', '010001', '1001000', '100001']",1,4,14,9,2,23,3.963403263403263,17,21
"['11011', '010', '11', '1001000', '1010']",1,5,10,11,0,21,5.933621933621933,29,25
"['0', '1010101', '100111', '11']",1,4,6,10,0,16,2.2493894993894994,24,15
"['1011', '010011', '001', '1100']",1,4,8,9,2,17,3.7095238095238097,16,17
"['11011', '010', '001', '11', '100010', '00110']",1,6,12,12,4,24,8.815584415584416,40,36
"['10001', '0110', '10000', '0011111', '11100']",1,5,13,13,3,26,5.434343434343434,34,26
"['100', '110', '00011']",1,3,6,5,2,11,1.6666666666666665,8,8
"['01011', '01', '10']",1,3,4,5,2,9,1.6428571428571428,8,7
"['0011001', '101', '11010']",1,3,7,8,0,15,1.8166666666666667,10,7
"['010100', '0010', '10']",1,3,8,4,0,12,1.7666666666666666,8,10
"['10101', '1110011', '1101100', '0100101', '1110']",1,5,12,18,3,30,6.247474747474747,30,32
"['1011110', '1000000', '100', '011111']",1,4,11,12,2,23,2.773870573870574,25,17
"['010', '011', '0110', '0001111', '1100111', '001001', '110101']",1,7,16,20,6,36,13.181018981018982,66,56
"['01', '0010', '11', '100', '0000011', '111001']",1,6,13,11,2,24,7.433977133977134,50,37
"['101', '1011010', '11']",1,3,4,8,0,12,1.8444444444444446,10,10
"['10100', '00', '0101011']",1,3,8,6,0,14,1.6825396825396823,11,8
"['01', '100101', '110111']",1,3,5,9,2,14,1.6666666666666665,10,9
"['1101101', '01', '111000', '010110']",1,4,9,12,2,21,3.2457264957264957,23,13
"['1011', '100001', '01000']",1,3,9,6,0,15,1.7717171717171718,9,5
"['01101', '101011', '100', '1000', '001110', '11111', '1011111']",1,7,13,23,4,36,11.327811077811077,65,64
"['00110', '01101', '01100', '0000']",1,4,12,7,3,19,3.9555555555555557,12,26
"['00100', '110011', '00110', '10', '00010', '110']",1,6,15,11,3,26,9.649134199134199,39,46
"['1', '00101', '011100', '0100100', '011000']",1,5,15,10,2,25,4.948468198468198,34,31
"['1011010', '010', '0110111', '00111', '101', '1101000', '1000']",1,7,17,19,5,36,12.505483405483405,71,57
"['10', '1110', '111']",1,3,2,7,0,9,1.9238095238095236,5,11
"['1001', '10', '111', '0000']",1,4,7,6,2,13,2.4714285714285715,15,11
"['0010', '00', '111', '010']",1,4,7,5,2,12,2.9428571428571426,12,16
"['1', '110011', '0000011', '0000', '01001']",1,5,14,9,0,23,4.4500888000888,36,28
"['0001101', '100', '0111100', '0']",1,4,10,8,2,18,2.571428571428571,26,18
"['110', '0001101', '00010', '111000', '11100']",1,5,14,12,2,26,6.166083916083916,32,37
"['101', '01', '100111']",1,3,4,7,0,11,1.9666666666666668,8,10
"['001', '101', '0001', '000010', '0101']",1,5,13,7,4,20,6.534920634920635,19,30
"['111010', '110001', '00', '1100101', '01000']",1,5,14,12,2,26,6.314241314241314,30,24
"['000110', '010', '011', '0001', '1001', '100101', '100111', '110']",1,8,18,17,8,35,17.59285714285714,68,76
"['11110', '00000', '0011110', '10010', '10', '11100', '101110']",1,7,17,18,4,35,12.107614607614607,61,71
"['0011', '10', '0101', '1110', '0100']",1,5,9,9,4,18,5.833333333333333,23,25
"['101', '00010', '1011']",1,3,6,6,0,12,1.8015873015873014,7,6
"['0', '01001', '11011']",1,3,5,6,2,11,1.2666666666666666,10,4
"['0', '101', '1010110', '001011']",1,4,8,9,0,17,3.0716117216117214,22,12
"['100', '1100', '10', '1101110']",1,4,7,9,0,16,4.095526695526695,16,18
"['0', '011', '100', '010111', '001010']",1,5,10,9,4,19,5.015873015873016,33,25
"['10110', '101111', '1111']",1,3,3,12,0,15,1.9717171717171718,6,17
"['0010', '11111', '1011101', '1001', '01111', '0000101', '01010', '0000']",1,8,20,21,8,41,15.309379509379509,83,73
"['101', '001', '01110']",1,3,5,6,2,11,1.6666666666666665,7,5
"['1100', '1111001', '1110', '1111']",1,4,5,14,3,19,4.181818181818182,13,30
"['0', '010000', '011111', '1011011', '0000110', '01011', '1101010']",1,7,19,20,5,39,10.177905427905428,80,58
"['001', '011', '10111', '010111', '0001000']",1,5,12,12,2,24,5.731740481740482,31,27
"['0101000', '111', '1001']",1,3,7,7,0,14,1.516883116883117,11,4
"['11001', '111', '00100', '10101', '01110']",1,5,10,13,4,23,6.1,25,19
"['01', '1010100', '011001']",1,3,8,7,0,15,1.7136752136752138,12,8
"['11100', '111110', '1', '01110']",1,4,5,12,2,17,3.206926406926407,19,15
"['0001011', '1101', '001']",1,3,7,7,0,14,1.7168831168831167,10,9
"['1111100', '001', '11', '10010', '000']",1,5,10,10,2,20,4.882539682539683,33,25
"['010001', '100', '01111', '1111010', '1011111']",1,5,10,18,2,28,5.59948384948385,35,31
"['1', '0101101', '1000', '1110', '110101']",1,5,9,13,2,22,4.923826173826174,33,25
"['10111', '10', '10000']",1,3,6,6,2,12,1.5428571428571427,9,9
"['111', '1100010', '100100', '10100', '000010', '110']",1,6,17,13,4,30,8.748562548562548,45,46
"['0', '111100', '100100', '00010', '111000']",1,5,14,10,3,24,4.8268398268398265,35,32
"['0', '00010', '0110', '1001101']",1,4,10,7,0,17,3.043939393939394,21,13
"['10001', '111', '0011000']",1,3,8,7,0,15,1.5666666666666667,12,4
"['101', '00', '010', '1011']",1,4,6,6,2,12,3.6285714285714286,11,10
"['010', '0011101', '001011', '11']",1,4,8,10,0,18,3.3803418803418803,20,14
"['111', '001101', '101000', '0110000', '1110001', '110111', '1101']",1,7,17,22,5,39,13.027061827061827,66,75
"['010100', '111100', '00100', '1101000', '1010', '00', '010110', '01000']",1,8,25,16,5,41,18.50921300921301,71,118
"['10000', '1010110', '011', '10011']",1,4,10,10,2,20,3.7,17,18
"['00101', '11', '0111', '000', '01011']",1,5,9,10,2,19,5.478571428571429,24,26
"['001', '001000', '1000000', '10010', '1011100', '1101', '0110011']",1,7,23,16,3,39,11.915467865467866,71,57
"['11101', '1', '01011', '000']",1,4,6,8,2,14,2.0166666666666666,21,11
"['00110', '10', '0010010', '110', '0011100']",1,5,14,10,2,24,6.391269841269842,31,42
"['1010010', '0111010', '10', '1100000']",1,4,13,10,3,23,3.1904761904761902,25,17
"['0010', '1', '101', '1010', '010011']",1,5,9,9,2,18,5.6309523809523805,26,22
"['001', '11', '1000', '0010010', '0100']",1,5,13,7,2,20,5.458513708513708,29,25
"['011101', '0101010', '00', '110']",1,4,9,9,0,18,3.0264957264957264,20,16
"['0111001', '1001', '1100', '1011100']",1,4,10,12,4,22,4.334415584415584,17,19
"['0', '110110', '01', '1111010', '1101', '1100']",1,6,9,15,2,24,8.52060162060162,45,40
"['11001', '111', '00100', '110111', '1100', '0001000']",1,6,15,15,2,30,8.47104007104007,47,54
"['1011010', '001000', '101', '1111001', '1000', '0000']",1,6,18,13,4,31,8.624614274614274,48,45
"['0011', '0001111', '000001', '000', '1011000', '1110']",1,6,18,13,4,31,8.074758574758574,53,57
"['110001', '11101', '0100101']",1,3,8,10,0,18,2.163170163170163,7,13
"['01', '010000', '10010', '0111']",1,4,10,7,0,17,3.127994227994228,18,15
"['0', '001', '01010']",1,3,6,3,0,9,1.3333333333333333,8,8
"['0', '100', '1101111', '0111010']",1,4,7,11,2,18,2.571428571428571,27,10
"['0010110', '1', '1101101', '0001100', '00', '011111']",1,6,14,16,3,30,6.3003663003663,63,35
"['0110101', '10100', '1']",1,3,6,7,0,13,1.25,13,6
"['1011', '00110', '10']",1,3,5,6,0,11,1.9047619047619047,7,6
"['01', '1111101', '0001', '1011', '0000110']",1,5,11,13,4,24,5.332611832611833,37,24
"['11000', '10001', '00', '11011']",1,4,9,8,3,17,3.4285714285714284,16,15
"['100', '10110', '10', '001100', '00010', '0101001']",1,6,17,11,2,28,9.053385503385503,43,44
"['111010', '0011', '110100', '111011', '1000', '11111', '0100']",1,7,14,21,6,35,11.954040404040404,60,75
"['11011', '0100110', '0011', '1111010', '00', '01001', '110']",1,7,15,18,4,33,11.786940836940836,67,61
"['1000010', '00', '101110', '1101100']",1,4,12,10,2,22,3.2020757020757022,23,16
"['0010', '001', '0100']",1,3,8,3,2,11,2.1785714285714284,5,12
"['011111', '1100001', '110', '10']",1,4,7,11,0,18,2.8465811965811967,24,17
"['101', '01', '001010', '001101']",1,4,9,8,2,17,3.966666666666667,17,16
"['01', '1010', '1001', '1110000']",1,4,9,8,2,17,3.396464646464646,20,14
"['11', '110101', '0100']",1,3,5,7,0,12,1.4333333333333333,10,6
"['101010', '1100010', '1100100']",1,3,11,9,2,20,2.241758241758242,7,11
"['1010', '00', '1001', '011']",1,4,7,6,2,13,3.626190476190476,12,11
"['01', '11011', '1000101', '011', '100010', '000001', '1101']",1,7,17,16,2,33,12.68990453990454,62,69
"['10111', '00', '1001', '00001']",1,4,9,7,2,16,3.257142857142857,16,15
"['11001', '1', '001000', '1100010', '11101', '0001000']",1,6,18,13,4,31,7.747552447552447,56,41
"['1111100', '11110', '00111', '1010011', '1001100', '01001', '011000']",1,7,19,23,6,42,13.084848484848484,70,60
"['01', '0010000', '11', '101', '0010100', '0000', '001100']",1,7,21,10,4,31,11.523043623043623,67,74
"['10', '101110', '011000']",1,3,7,7,2,14,1.6666666666666665,11,8
"['1100101', '01011', '11']",1,3,5,9,0,14,1.6825396825396823,11,13
"['00101', '00011', '0000', '1001100', '1110110']",1,5,16,12,4,28,6.271861471861472,31,32
"['11001', '010001', '1001010', '0111', '0101']",1,5,13,13,2,26,6.765384615384615,26,29
"['11010', '001000', '100', '010111', '10']",1,5,12,10,2,22,5.823448773448773,31,25
"['00111', '10001', '0100011', '011']",1,4,10,10,2,20,3.95,17,17
"['011101', '0011', '101101']",1,3,6,10,2,16,2.033333333333333,8,9
"['1110001', '0110', '111', '0000']",1,4,9,9,2,18,2.762337662337662,20,12
"['011', '0001', '10110', '1010111', '100000', '0100']",1,6,16,13,2,29,8.108941058941058,46,38
"['001', '101111', '11']",1,3,3,8,0,11,1.3444444444444446,10,10
"['11010', '1', '000', '1101100']",1,4,8,8,0,16,2.316666666666667,22,15
"['0010', '001', '0011', '00100', '101', '0011010', '0011011', '0000110']",1,8,24,16,7,40,19.295382395382394,74,115
"['110110', '10101', '0010100', '0000000', '10', '000010']",1,6,22,11,4,33,7.723276723276723,53,46
"['11001', '0010', '0011', '100', '0110', '0000001', '0101', '1111111']",1,8,19,19,6,38,15.036147186147186,95,70
"['101000', '11100', '101100', '10011']",1,4,11,11,4,22,4.342424242424243,14,22
"['00', '10110', '1']",1,3,4,4,0,8,0.9047619047619047,9,4
"['01', '10111', '00', '11']",1,4,4,7,3,11,2.4285714285714284,14,12
"['0', '101100', '01001', '010011']",1,4,10,8,2,18,3.207792207792208,22,16
"['110000', '01', '00011', '10', '0100100']",1,5,14,8,2,22,4.977383727383727,37,26
"['1', '101000', '1110001', '101111', '0110110']",1,5,11,16,4,27,4.758241758241758,42,24
"['010', '111', '1101000', '01010', '00010']",1,5,13,10,4,23,5.55,29,32
"['01', '00', '011', '10']",1,4,5,4,3,9,3.1,9,13
"['001', '1000', '111111', '10', '0011111', '0101']",1,6,10,16,2,26,6.948956598956599,53,44
"['00110', '0101', '110']",1,3,6,6,0,12,1.9880952380952381,7,8
"['110010', '11011', '101101', '11', '1100001', '1010010']",1,6,14,19,4,33,9.706071706071706,46,66
"['110011', '1000', '1100110']",1,3,8,9,0,17,2.2503496503496505,7,12
"['10111', '0110', '1111', '00110', '000000', '011001', '110']",1,7,16,17,6,33,11.649278499278498,59,57
"['00100', '10010', '1', '1110']",1,4,8,7,2,15,2.7555555555555555,18,11
"['01111', '110', '01100', '01110']",1,4,7,11,3,18,4.2,11,24
"['01', '0111001', '10000', '10010', '1100']",1,5,13,10,2,23,5.662193362193362,31,25
"['1111100', '1001010', '101', '1000', '01010']",1,5,13,13,2,26,6.0227272727272725,32,27
"['1100010', '01', '010']",1,3,7,5,0,12,1.8444444444444446,10,9
"['010', '00001', '1101100', '1010', '01001']",1,5,14,10,2,24,6.345526695526695,29,27
"['10111', '00', '0111']",1,3,4,7,0,11,1.507936507936508,8,7
"['00110', '000000', '001000']",1,3,14,3,2,17,1.7727272727272727,6,23
"['0111010', '1', '1100110']",1,3,6,9,2,15,1.0714285714285714,15,5
"['0', '0001', '0011010', '0010011']",1,4,12,7,2,19,2.5623376623376624,23,18
"['001100', '100', '01011']",1,3,8,6,0,14,1.893939393939394,9,9
"['010', '011', '00000', '00111', '10010', '011110']",1,6,15,12,5,27,8.304545454545455,41,47
"['0100010', '1111100', '1100110']",1,3,10,11,3,21,1.7142857142857142,10,8
"['010', '1111', '10100', '00', '11101']",1,5,8,11,2,19,5.126190476190476,26,22
"['01', '1101111', '0100110']",1,3,6,10,2,16,1.3174603174603174,13,5
"['1010', '0001', '0111001']",1,3,8,7,2,15,1.7727272727272727,10,8
"['10101', '0010', '1111001']",1,3,7,9,0,16,1.8787878787878787,10,5
"['0100111', '1011101', '00', '010101', '100101', '10', '1010011']",1,7,17,20,7,37,12.426739926739927,71,59
"['101', '0001', '0110', '1111', '100101', '1001100', '01110']",1,7,15,18,3,33,11.966849816849816,59,52
"['11011', '10101', '1000']",1,3,6,8,2,14,1.911111111111111,7,9
"['01100', '00', '101001', '11']",1,4,8,7,2,15,2.87012987012987,19,10
"['1110111', '00100', '01001', '10011']",1,4,10,12,3,22,3.7,19,12
"['010', '0001110', '0110000', '1010', '1110110', '110']",1,6,16,15,5,31,9.227705627705628,50,54
"['1001100', '1101011', '11']",1,3,6,10,2,16,1.6031746031746033,14,12
"['011', '00000', '0110', '10', '1011111']",1,5,10,11,0,21,4.6605339105339105,35,23
"['110000', '011', '00', '1011011', '1001011', '1110']",1,6,13,16,2,29,7.677355977355977,53,45
"['00111', '0011', '1110010']",1,3,7,9,0,16,1.9343434343434343,10,13
"['0', '11111', '10100', '01110', '101001']",1,5,9,13,3,22,4.352380952380952,34,20
"['11110', '0101', '1110110']",1,3,5,11,0,16,1.6565656565656566,9,10
"['0101101', '00', '0110001']",1,3,9,7,2,16,1.6031746031746033,13,8
"['1001100', '00', '10']",1,3,7,4,2,11,1.3888888888888888,11,9
"['0', '11000', '010010', '111011', '1000011', '1010000']",1,6,18,14,4,32,7.853313353313354,54,35
"['11010', '1', '0100110', '00011', '000000', '101111', '0100101']",1,7,20,17,6,37,9.709523809523809,76,50
"['11101', '001001', '0111']",1,3,6,9,0,15,1.812121212121212,8,9
"['000110', '01', '1', '100001']",1,4,9,6,2,15,2.9047619047619047,22,11
"['00', '0101110', '011', '1']",1,4,6,7,0,13,2.1944444444444446,21,11
"['1011010', '1010', '1', '1100100']",1,4,9,10,2,19,3.068831168831169,24,17
"['1010', '11101', '100111', '011']",1,4,6,12,0,18,3.55021645021645,16,19
"['1011', '1', '1100100']",1,3,5,7,0,12,1.1954545454545453,13,9
"['1110111', '011', '0']",1,3,3,8,0,11,1.35,12,6
"['0000', '100110', '0110', '11']",1,4,9,7,2,16,3.0666666666666664,17,13
"['01', '100000', '1101']",1,3,7,5,0,12,1.3166666666666667,11,7
"['01000', '0110001', '0000']",1,3,12,4,0,16,2.0454545454545454,6,13
"['000110', '10', '000011', '011001']",1,4,12,8,3,20,3.4166666666666665,22,15
"['1001000', '1100', '0011100', '0000']",1,4,15,7,4,22,3.474025974025974,17,31
"['10001', '11011', '1100100', '1111']",1,4,8,13,2,21,3.812121212121212,16,27
"['0010', '010', '101101', '0110', '001011']",1,5,12,11,4,23,7.264285714285714,22,28
"['110110', '00101', '01100', '1011100']",1,4,11,12,2,23,3.7752913752913755,18,17
"['1001110', '0', '0010', '11000', '000101', '010101']",1,6,17,12,2,29,8.003712953712954,52,40
"['011011', '00', '10110', '1111011']",1,4,7,13,0,20,3.4568209568209567,21,15
"['110000', '1011', '100', '001']",1,4,9,7,2,16,3.3206349206349204,17,17
"['01', '001111', '101', '11101', '000001', '0100']",1,6,13,13,2,26,8.083766233766234,46,41
"['1110110', '1', '000']",1,3,5,6,0,11,0.65,14,4
"['00011', '0011110', '000101', '111011', '00', '10011']",1,6,15,16,4,31,9.11049506049506,47,46
"['0010110', '0100000', '0011', '10010', '10', '110']",1,6,17,11,2,28,8.160750360750361,51,45
"['0', '110110', '00110']",1,3,6,6,0,12,1.3463203463203464,11,11
"['00', '0101000', '10']",1,3,8,3,2,11,1.3888888888888888,11,10
"['010100', '01', '100001', '0111', '1100', '1101010']",1,6,15,14,4,29,8.501787101787102,48,38
"['11011', '0010111', '1000101', '1', '1010101', '00110', '000010']",1,7,19,19,5,38,11.048967698967699,71,51
"['11010', '11011', '111100', '0001101', '000', '1100']",1,6,14,16,2,30,9.134482184482184,44,54
"['0001', '110010', '01111', '01']",1,4,8,9,0,17,3.327994227994228,19,15
"['0', '0010', '00110', '100111', '10010', '01010']",1,6,15,11,3,26,8.93015873015873,40,49
"['0010110', '000011', '010111', '0101001', '0100']",1,5,17,13,4,30,6.758574758574759,26,33
"['01101', '0111010', '111']",1,3,5,10,0,15,2.1833333333333336,8,6
"['1001110', '00', '001', '11111']",1,4,7,10,0,17,2.5944444444444446,22,12
"['0100101', '101110', '000']",1,3,9,7,0,16,1.505982905982906,12,6
"['0111011', '00000', '100', '1111', '10011', '1110']",1,6,12,16,4,28,7.056132756132756,47,44
"['1010110', '100', '1111111']",1,3,5,12,2,17,1.0857142857142856,13,7
"['110001', '101110', '1110']",1,3,6,10,2,16,1.9,9,10
"['01', '1100001', '000']",1,3,8,4,0,12,1.4444444444444444,11,5
"['001', '00000', '10', '1101010']",1,4,11,6,0,17,2.53015873015873,22,15
"['1010000', '0111101', '1011001', '001100']",1,4,14,13,3,27,3.857142857142857,18,15
"['01', '001111', '10', '01100']",1,4,7,8,2,15,2.938311688311688,20,14
"['01', '00', '0100111', '1111']",1,4,6,9,2,15,2.2676767676767677,21,15
"['1110001', '0001', '100', '01110']",1,4,10,9,0,19,3.50981240981241,19,14
"['11', '000011', '1001101']",1,3,7,8,0,15,1.5598290598290598,12,10
"['1100111', '11010', '000101', '011']",1,4,9,12,0,21,3.594172494172494,19,18
"['101100', '000110', '001', '011', '1001', '1111', '010111', '11100']",1,8,16,21,7,37,16.54126984126984,77,80
"['010', '10', '110100']",1,3,6,5,0,11,1.9666666666666668,8,7
"['1011', '001010', '001111', '01110']",1,4,9,12,2,21,3.987878787878788,15,14
"['10100', '00', '1001']",1,3,7,4,0,11,1.9047619047619047,7,7
"['010', '0010111', '0011110', '00', '10']",1,5,11,10,4,21,5.792063492063492,33,35
"['0', '010', '1101101', '0010111']",1,4,8,10,2,18,2.914285714285714,25,11
"['1110111', '11001', '111', '00011', '0001', '1010']",1,6,11,17,4,28,8.5495670995671,45,58
"['011011', '01010', '0001111']",1,3,8,10,0,18,1.9965034965034967,9,8
"['001111', '001101', '00011', '00100', '10010', '110']",1,6,16,14,5,30,9.444444444444445,40,47
"['0', '10011', '1111']",1,3,3,7,0,10,0.7777777777777777,10,6
"['00', '001001', '110101', '0100']",1,4,11,7,2,18,3.7333333333333334,18,16
"['00011', '0011', '0101011', '1011100', '0101']",1,5,13,14,4,27,6.755772005772005,29,33
"['00101', '1000', '10', '0011011', '0000110', '111001']",1,6,17,14,2,31,8.485558885558886,53,40
"['0011', '0011101', '0110', '1']",1,4,7,9,2,16,3.254545454545455,20,13
"['0', '11011', '00111', '01011', '1001011']",1,5,9,14,3,23,5.95,30,34
"['110110', '11011', '01100']",1,3,6,10,2,16,2.2363636363636363,7,9
"['010000', '0001', '10100', '0000', '1001111']",1,5,17,9,2,26,5.636790986790987,31,35
"['1111010', '1010', '0100110']",1,3,8,10,2,18,1.844155844155844,10,11
"['011', '11', '10001', '000', '0111', '1001100']",1,6,12,12,2,24,8.065295815295816,43,39
"['10100', '1', '011', '0110011']",1,4,7,9,0,16,2.85,23,16
"['10', '1110100', '111101', '00011']",1,4,8,12,0,20,2.696359196359196,24,17
"['0100001', '1', '100101', '111101']",1,4,9,11,2,20,2.411172161172161,24,22
"['00', '1110', '001000']",1,3,8,4,0,12,1.2333333333333334,11,12
"['1', '101101', '1011101', '0001', '100', '00010']",1,6,13,13,0,26,7.379714729714729,48,45
